year_,changwat_id,changwat,ampur_id,ampur,male_thai,female_thai,total_thai,male,female,total,n_house
2563,10,กรุงเทพมหานคร,1001,เขตพระนคร,21211,22951,44162,21675,23248,44923,19137
2563,10,กรุงเทพมหานคร,1002,เขตดุสิต,44145,38183,82328,45038,38859,83897,31653
2563,10,กรุงเทพมหานคร,1003,เขตหนองจอก,86337,91265,177602,86564,91415,177979,66754
2563,10,กรุงเทพมหานคร,1004,เขตบางรัก,16611,20032,36643,21527,24230,45757,32371
2563,10,กรุงเทพมหานคร,1005,เขตบางเขน,87517,99025,186542,87998,99379,187377,114661
2563,10,กรุงเทพมหานคร,1006,เขตบางกะปิ,64808,78201,143009,65832,78900,144732,107103
2563,10,กรุงเทพมหานคร,1007,เขตปทุมวัน,18708,21734,40442,20310,23028,43338,32590
2563,10,กรุงเทพมหานคร,1008,เขตป้อมปราบศัตรูพ่าย,18923,20194,39117,20197,21327,41524,19627
2563,10,กรุงเทพมหานคร,1009,เขตพระโขนง,39205,47927,87132,39613,48243,87856,60007
2563,10,กรุงเทพมหานคร,1010,เขตมีนบุรี,66649,74790,141439,67100,75097,142197,61665
2563,10,กรุงเทพมหานคร,1011,เขตลาดกระบัง,84697,93524,178221,85131,93840,178971,98260
2563,10,กรุงเทพมหานคร,1012,เขตยานนาวา,34573,40226,74799,35644,40920,76564,53614
2563,10,กรุงเทพมหานคร,1013,เขตสัมพันธวงศ์,9940,10681,20621,10367,10957,21324,13197
2563,10,กรุงเทพมหานคร,1014,เขตพญาไท,32494,33845,66339,33116,34272,67388,44727
2563,10,กรุงเทพมหานคร,1015,เขตธนบุรี,47619,54296,101915,48394,54983,103377,57707
2563,10,กรุงเทพมหานคร,1016,เขตบางกอกใหญ่,29708,33600,63308,29987,33874,63861,32258
2563,10,กรุงเทพมหานคร,1017,เขตห้วยขวาง,36415,45521,81936,37714,46519,84233,85046
2563,10,กรุงเทพมหานคร,1018,เขตคลองสาน,29587,35017,64604,31969,37170,69139,39924
2563,10,กรุงเทพมหานคร,1019,เขตตลิ่งชัน,48112,54976,103088,48391,55226,103617,42898
2563,10,กรุงเทพมหานคร,1020,เขตบางกอกน้อย,47807,53466,101273,49100,54691,103791,50652
2563,10,กรุงเทพมหานคร,1021,เขตบางขุนเทียน,87174,97898,185072,87744,98400,186144,91013
2563,10,กรุงเทพมหานคร,1022,เขตภาษีเจริญ,57460,65954,123414,57946,66372,124318,65843
2563,10,กรุงเทพมหานคร,1023,เขตหนองแขม,72353,82857,155210,72884,83319,156203,62675
2563,10,กรุงเทพมหานคร,1024,เขตราษฎร์บูรณะ,37111,40901,78012,37487,41200,78687,37664
2563,10,กรุงเทพมหานคร,1025,เขตบางพลัด,40391,48431,88822,40709,48708,89417,55838
2563,10,กรุงเทพมหานคร,1026,เขตดินแดง,52767,61962,114729,53188,62320,115508,63821
2563,10,กรุงเทพมหานคร,1027,เขตบึงกุ่ม,63839,76285,140124,64199,76618,140817,75943
2563,10,กรุงเทพมหานคร,1028,เขตสาทร,34202,38764,72966,35828,39907,75735,43459
2563,10,กรุงเทพมหานคร,1029,เขตบางซื่อ,56438,65103,121541,56939,65471,122410,76116
2563,10,กรุงเทพมหานคร,1030,เขตจตุจักร,71139,83046,154185,71794,83503,155297,126570
2563,10,กรุงเทพมหานคร,1031,เขตบางคอแหลม,38059,42805,80864,39084,43649,82733,39812
2563,10,กรุงเทพมหานคร,1032,เขตประเวศ,83936,95388,179324,85343,96478,181821,92009
2563,10,กรุงเทพมหานคร,1033,เขตคลองเตย,42940,48323,91263,44156,49037,93193,77502
2563,10,กรุงเทพมหานคร,1034,เขตสวนหลวง,55445,66365,121810,56499,67110,123609,81116
2563,10,กรุงเทพมหานคร,1035,เขตจอมทอง,68402,76458,144860,70265,78025,148290,73778
2563,10,กรุงเทพมหานคร,1036,เขตดอนเมือง,85441,84773,170214,85823,84968,170791,77410
2563,10,กรุงเทพมหานคร,1037,เขตราชเทวี,28771,32262,61033,33137,36127,69264,52494
2563,10,กรุงเทพมหานคร,1038,เขตลาดพร้าว,52911,63584,116495,53232,63876,117108,57916
2563,10,กรุงเทพมหานคร,1039,เขตวัฒนา,30902,37508,68410,37972,43651,81623,82407
2563,10,กรุงเทพมหานคร,1040,เขตบางแค,89012,102836,191848,89776,103527,193303,94020
2563,10,กรุงเทพมหานคร,1041,เขตหลักสี่,48668,53610,102278,48897,53807,102704,57833
2563,10,กรุงเทพมหานคร,1042,เขตสายไหม,96336,109309,205645,97252,110020,207272,106139
2563,10,กรุงเทพมหานคร,1043,เขตคันนายาว,40694,47481,88175,44940,51390,96330,45864
2563,10,กรุงเทพมหานคร,1044,เขตสะพานสูง,43727,51805,95532,44058,52034,96092,41308
2563,10,กรุงเทพมหานคร,1045,เขตวังทองหลาง,48601,58054,106655,49053,58405,107458,62673
2563,10,กรุงเทพมหานคร,1046,เขตคลองสามวา,96319,107984,204303,96669,108231,204900,86477
2563,10,กรุงเทพมหานคร,1047,เขตบางนา,40229,47023,87252,40980,47555,88535,72092
2563,10,กรุงเทพมหานคร,1048,เขตทวีวัฒนา,36233,42033,78266,36493,42256,78749,34420
2563,10,กรุงเทพมหานคร,1049,เขตทุ่งครุ,57616,65358,122974,58027,65673,123700,54595
2563,10,กรุงเทพมหานคร,1050,เขตบางบอน,48690,53390,102080,49897,54469,104366,50825
2563,11,สมุทรปราการ,1101,อำเภอเมืองสมุทรปราการ,59866,66387,126253,59997,66480,126477,58292
2563,11,สมุทรปราการ,1102,อำเภอบางบ่อ,44351,47016,91367,44979,47569,92548,45054
2563,11,สมุทรปราการ,1103,อำเภอบางพลี,122819,138742,261561,123636,139290,262926,165989
2563,11,สมุทรปราการ,1104,อำเภอพระประแดง,18586,20164,38750,18613,20191,38804,13440
2563,11,สมุทรปราการ,1105,อำเภอพระสมุทรเจดีย์,55113,59278,114391,55233,59376,114609,53227
2563,11,สมุทรปราการ,1106,อำเภอบางเสาธง,28490,30405,58895,28582,30461,59043,43802
2563,11,สมุทรปราการ,1183,ท้องถิ่นเทศบาลเมืองปากน้ำสมุทรปราการ,16996,19323,36319,17058,19367,36425,15418
2563,11,สมุทรปราการ,1184,ท้องถิ่นเทศบาลตำบลบางเสาธง,10375,11326,21701,10405,11349,21754,17089
2563,11,สมุทรปราการ,1185,ท้องถิ่นเทศบาลตำบลแหลมฟ้าผ่า,10330,10930,21260,10349,10960,21309,9008
2563,11,สมุทรปราการ,1186,ท้องถิ่นเทศบาลตำบลพระสมุทรเจดีย์,5641,5863,11504,5931,6150,12081,5697
2563,11,สมุทรปราการ,1187,ท้องถิ่นเทศบาลตำบลบางพลี,3407,3613,7020,5903,5934,11837,2197
2563,11,สมุทรปราการ,1188,ท้องถิ่นเทศบาลตำบลบางบ่อ,3064,3353,6417,3083,3362,6445,2331
2563,11,สมุทรปราการ,1189,ท้องถิ่นเทศบาลตำบลคลองสวน,1459,1539,2998,1461,1539,3000,851
2563,11,สมุทรปราการ,1190,ท้องถิ่นเทศบาลตำบลคลองด่าน,5590,5764,11354,5609,5781,11390,3174
2563,11,สมุทรปราการ,1191,ท้องถิ่นเทศบาลตำบลบางปู,57430,61768,119198,57602,61898,119500,59612
2563,11,สมุทรปราการ,1192,ท้องถิ่นเทศบาลตำบลแพรกษา,12557,14205,26762,12597,14243,26840,15544
2563,11,สมุทรปราการ,1193,ท้องถิ่นเทศบาลตำบลบางเมือง,46429,52969,99398,46603,53123,99726,50039
2563,11,สมุทรปราการ,1194,ท้องถิ่นเทศบาลตำบลด่านสำโรง,25581,29143,54724,25688,29230,54918,25203
2563,11,สมุทรปราการ,1195,ท้องถิ่นเทศบาลเมืองปู่เจ้าสมิงพราย,34609,36795,71404,34740,36903,71643,35651
2563,11,สมุทรปราการ,1196,ท้องถิ่นเทศบาลตำบลสำโรงเหนือ,13873,16523,30396,14022,16611,30633,29943
2563,11,สมุทรปราการ,1197,ท้องถิ่นเทศบาลเมืองลัดหลวง,33167,36166,69333,33959,36937,70896,37404
2563,11,สมุทรปราการ,1198,ท้องถิ่นเทศบาลเมืองพระประแดง,4318,4645,8963,4372,4699,9071,2182
2563,11,สมุทรปราการ,1199,ท้องถิ่นเทศบาลนครสมุทรปราการ,20532,22183,42715,24094,25510,49604,20657
2563,12,นนทบุรี,1201,อำเภอเมืองนนทบุรี,26620,30754,57374,26695,30820,57515,30511
2563,12,นนทบุรี,1202,อำเภอบางกรวย,15416,18122,33538,15472,18175,33647,19019
2563,12,นนทบุรี,1203,อำเภอบางใหญ่,47208,54798,102006,47495,55017,102512,51485
2563,12,นนทบุรี,1204,อำเภอบางบัวทอง,86751,99116,185867,87017,99366,186383,96585
2563,12,นนทบุรี,1205,อำเภอไทรน้อย,32324,35509,67833,32561,35734,68295,32063
2563,12,นนทบุรี,1206,อำเภอปากเกร็ด,23232,25833,49065,23495,26245,49740,23589
2563,12,นนทบุรี,1286,ท้องถิ่นเทศบาลเมืองเสาธงหิน,17904,21518,39422,17988,21586,39574,26509
2563,12,นนทบุรี,1287,ท้องถิ่นเทศบาลเมืองบางพลับ,5040,5817,10857,5068,5831,10899,5979
2563,12,นนทบุรี,1288,ท้องถิ่นเทศบาลเมืองพิมลราช,22081,25702,47783,22127,25747,47874,23331
2563,12,นนทบุรี,1289,ท้องถิ่นเทศบาลเมืองศาลากลาง,9255,10768,20023,9276,10781,20057,10742
2563,12,นนทบุรี,1290,ท้องถิ่นเทศบาลเมืองไทรม้า,10893,12763,23656,10950,12792,23742,15710
2563,12,นนทบุรี,1291,ท้องถิ่นเทศบาลตำบลไทรน้อย,1260,1235,2495,1273,1238,2511,1055
2563,12,นนทบุรี,1292,ท้องถิ่นเทศบาลเมืองบางใหญ่,5798,6240,12038,5824,6259,12083,5813
2563,12,นนทบุรี,1293,ท้องถิ่นเทศบาลตำบลบางม่วง,2977,3101,6078,2994,3107,6101,2753
2563,12,นนทบุรี,1294,ท้องถิ่นเทศบาลเมืองปลายบาง,21262,24966,46228,21338,25017,46355,23299
2563,12,นนทบุรี,1295,ท้องถิ่นเทศบาลเมืองบางศรีเมือง,15248,17707,32955,15279,17726,33005,13190
2563,12,นนทบุรี,1296,ท้องถิ่นเทศบาลเมืองบางกรวย,20272,23861,44133,20473,24054,44527,22035
2563,12,นนทบุรี,1297,ท้องถิ่นเทศบาลนครปากเกร็ด,86563,101050,187613,87602,101856,189458,131416
2563,12,นนทบุรี,1298,ท้องถิ่นเทศบาลนครบางบัวทอง,23360,27532,50892,23663,27778,51441,25771
2563,12,นนทบุรี,1299,ท้องถิ่นเทศบาลนครนนทบุรี,115410,131464,246874,117718,133308,251026,157944
2563,13,ปทุมธานี,1301,อำเภอเมืองปทุมธานี,60734,67010,127744,60902,67126,128028,66691
2563,13,ปทุมธานี,1302,อำเภอคลองหลวง,69571,76914,146485,69797,77063,146860,68683
2563,13,ปทุมธานี,1303,อำเภอธัญบุรี,0,0,0,0,0,0,0
2563,13,ปทุมธานี,1304,อำเภอหนองเสือ,25553,25980,51533,25626,26046,51672,16437
2563,13,ปทุมธานี,1305,อำเภอลาดหลุมแก้ว,28743,30076,58819,28778,30107,58885,29565
2563,13,ปทุมธานี,1306,อำเภอลำลูกกา,41159,43915,85074,41296,44025,85321,41769
2563,13,ปทุมธานี,1307,อำเภอสามโคก,21653,23108,44761,21709,23140,44849,19446
2563,13,ปทุมธานี,1379,ท้องถิ่นเทศบาลเมืองลาดสวาย,31358,35699,67057,31482,35774,67256,39485
2563,13,ปทุมธานี,1380,ท้องถิ่นเทศบาลตำบลบางพูน,12141,13599,25740,12168,13615,25783,19879
2563,13,ปทุมธานี,1381,ท้องถิ่นเทศบาลตำบลบ้านกลาง,5831,6518,12349,5863,6538,12401,6357
2563,13,ปทุมธานี,1382,ท้องถิ่นเทศบาลเมืองลำสามแก้ว,30600,35435,66035,30685,35491,66176,33373
2563,13,ปทุมธานี,1384,ท้องถิ่นเทศบาลเมืองบึงยี่โถ,15014,17877,32891,15079,17909,32988,15387
2563,13,ปทุมธานี,1386,ท้องถิ่นเทศบาลเมืองบางกะดี,6769,7539,14308,6801,7556,14357,7072
2563,13,ปทุมธานี,1387,ท้องถิ่นเทศบาลตำบลบางเตย,5325,5622,10947,5342,5631,10973,4494
2563,13,ปทุมธานี,1388,ท้องถิ่นเทศบาลตำบลลำลูกกา,9059,10013,19072,9079,10030,19109,10044
2563,13,ปทุมธานี,1389,ท้องถิ่นเทศบาลตำบลลำไทร,1239,1282,2521,1288,1328,2616,1043
2563,13,ปทุมธานี,1390,ท้องถิ่นเทศบาลตำบลระแหง,4964,5407,10371,4986,5429,10415,5245
2563,13,ปทุมธานี,1391,ท้องถิ่นเทศบาลตำบลหนองเสือ,1460,1562,3022,1465,1571,3036,1870
2563,13,ปทุมธานี,1392,ท้องถิ่นเทศบาลเมืองสนั่นรักษ์,14974,16784,31758,15029,16826,31855,17377
2563,13,ปทุมธานี,1393,ท้องถิ่นเทศบาลตำบลธัญบุรี,29188,32631,61819,29962,33108,63070,33989
2563,13,ปทุมธานี,1394,ท้องถิ่นเทศบาลเมืองคลองหลวง,30354,34011,64365,30516,34133,64649,51658
2563,13,ปทุมธานี,1395,ท้องถิ่นเทศบาลตำบลบางหลวง,3397,3718,7115,3404,3729,7133,4485
2563,13,ปทุมธานี,1396,ท้องถิ่นเทศบาลเมืองท่าโขลง,33661,40818,74479,35077,42166,77243,56320
2563,13,ปทุมธานี,1397,ท้องถิ่นเทศบาลเมืองคูคต,21072,22576,43648,21233,22708,43941,26172
2563,13,ปทุมธานี,1398,ท้องถิ่นเทศบาลนครรังสิต,38871,44961,83832,39105,45163,84268,56127
2563,13,ปทุมธานี,1399,ท้องถิ่นเทศบาลเมืองปทุมธานี,9928,11306,21234,11080,12448,23528,9506
2563,14,พระนครศรีอยุธยา,1401,อำเภอพระนครศรีอยุธยา,33634,36772,70406,33680,36800,70480,24750
2563,14,พระนครศรีอยุธยา,1402,อำเภอท่าเรือ,14861,16293,31154,14879,16307,31186,11162
2563,14,พระนครศรีอยุธยา,1403,อำเภอนครหลวง,10451,11453,21904,10474,11469,21943,11363
2563,14,พระนครศรีอยุธยา,1404,อำเภอบางไทร,15471,16281,31752,15491,16290,31781,10554
2563,14,พระนครศรีอยุธยา,1405,อำเภอบางบาล,6936,7507,14443,6938,7510,14448,5433
2563,14,พระนครศรีอยุธยา,1406,อำเภอบางปะอิน,24309,26685,50994,24351,26718,51069,26825
2563,14,พระนครศรีอยุธยา,1407,อำเภอบางปะหัน,17467,18748,36215,17576,18857,36433,12530
2563,14,พระนครศรีอยุธยา,1408,อำเภอผักไห่,10816,11559,22375,10822,11565,22387,7271
2563,14,พระนครศรีอยุธยา,1409,อำเภอภาชี,12438,13216,25654,12445,13225,25670,8149
2563,14,พระนครศรีอยุธยา,1410,อำเภอลาดบัวหลวง,14639,15034,29673,14664,15057,29721,9578
2563,14,พระนครศรีอยุธยา,1411,อำเภอวังน้อย,26928,28314,55242,26999,28382,55381,25227
2563,14,พระนครศรีอยุธยา,1412,อำเภอเสนา,15187,15983,31170,15200,15994,31194,9832
2563,14,พระนครศรีอยุธยา,1413,อำเภอบางซ้าย,6897,7037,13934,6919,7050,13969,4455
2563,14,พระนครศรีอยุธยา,1414,อำเภออุทัย,22214,24193,46407,22243,24224,46467,21498
2563,14,พระนครศรีอยุธยา,1415,อำเภอมหาราช,6395,7026,13421,6396,7028,13424,5023
2563,14,พระนครศรีอยุธยา,1416,อำเภอบ้านแพรก,3183,3661,6844,3189,3662,6851,2665
2563,14,พระนครศรีอยุธยา,1466,ท้องถิ่นเทศบาลตำบลสามเมือง,3614,3708,7322,3640,3742,7382,2819
2563,14,พระนครศรีอยุธยา,1467,ท้องถิ่นเทศบาลตำบลสามกอ,3311,3655,6966,3341,3683,7024,2904
2563,14,พระนครศรีอยุธยา,1468,ท้องถิ่นเทศบาลตำบลบางนมโค,3545,3944,7489,3550,3957,7507,4080
2563,14,พระนครศรีอยุธยา,1469,ท้องถิ่นเทศบาลตำบลบางกระสั้น,6155,6992,13147,6163,6999,13162,5629
2563,14,พระนครศรีอยุธยา,1470,ท้องถิ่นเทศบาลตำบลเชียงรากน้อย,4854,5203,10057,4895,5229,10124,4340
2563,14,พระนครศรีอยุธยา,1471,ท้องถิ่นเทศบาลตำบลคลองจิก,4396,4932,9328,4403,4936,9339,5310
2563,14,พระนครศรีอยุธยา,1472,ท้องถิ่นเทศบาลตำบลปราสาททอง,2178,2423,4601,2204,2438,4642,2996
2563,14,พระนครศรีอยุธยา,1473,ท้องถิ่นเทศบาลตำบลบ้านแพรก,964,1038,2002,964,1041,2005,875
2563,14,พระนครศรีอยุธยา,1474,ท้องถิ่นเทศบาลตำบลโรงช้าง,3011,3301,6312,3016,3304,6320,2466
2563,14,พระนครศรีอยุธยา,1475,ท้องถิ่นเทศบาลตำบลมหาราช,1564,1663,3227,1567,1664,3231,1437
2563,14,พระนครศรีอยุธยา,1476,ท้องถิ่นเทศบาลตำบลอุทัย,3095,3519,6614,3097,3523,6620,4077
2563,14,พระนครศรีอยุธยา,1477,ท้องถิ่นเทศบาลตำบลบางซ้าย,2567,2679,5246,2568,2680,5248,1831
2563,14,พระนครศรีอยุธยา,1478,ท้องถิ่นเทศบาลตำบลหัวเวียง,2871,3078,5949,2871,3078,5949,1800
2563,14,พระนครศรีอยุธยา,1479,ท้องถิ่นเทศบาลเมืองลำตาเสา,10383,10936,21319,10401,10956,21357,9689
2563,14,พระนครศรีอยุธยา,1480,ท้องถิ่นเทศบาลตำบลลาดบัวหลวง,1298,1344,2642,1300,1351,2651,1414
2563,14,พระนครศรีอยุธยา,1481,ท้องถิ่นเทศบาลตำบลภาชี,2505,2816,5321,2527,2838,5365,2543
2563,14,พระนครศรีอยุธยา,1482,ท้องถิ่นเทศบาลตำบลลาดชะโด,3697,3947,7644,3703,3947,7650,2754
2563,14,พระนครศรีอยุธยา,1483,ท้องถิ่นเทศบาลเมืองผักไห่,4610,4948,9558,4616,4957,9573,4375
2563,14,พระนครศรีอยุธยา,1484,ท้องถิ่นเทศบาลตำบลพระอินทราชา,4475,4935,9410,4490,4949,9439,6309
2563,14,พระนครศรีอยุธยา,1485,ท้องถิ่นเทศบาลเมืองบ้านสร้าง,5000,5754,10754,5007,5763,10770,7091
2563,14,พระนครศรีอยุธยา,1486,ท้องถิ่นเทศบาลตำบลบางปะอิน,3343,3449,6792,3353,3454,6807,2193
2563,14,พระนครศรีอยุธยา,1487,ท้องถิ่นเทศบาลตำบลบางปะหัน,2493,2793,5286,2495,2795,5290,2219
2563,14,พระนครศรีอยุธยา,1488,ท้องถิ่นเทศบาลตำบลมหาพราหมณ์,4076,4400,8476,4079,4405,8484,3254
2563,14,พระนครศรีอยุธยา,1489,ท้องถิ่นเทศบาลตำบลบางบาล,5218,5790,11008,5219,5793,11012,3713
2563,14,พระนครศรีอยุธยา,1490,ท้องถิ่นเทศบาลตำบลราชคราม,2988,3001,5989,3000,3010,6010,1804
2563,14,พระนครศรีอยุธยา,1491,ท้องถิ่นเทศบาลเมืองบางไทร,5007,5221,10228,5017,5230,10247,3779
2563,14,พระนครศรีอยุธยา,1492,ท้องถิ่นเทศบาลตำบลอรัญญิก,3742,4039,7781,3745,4040,7785,2810
2563,14,พระนครศรีอยุธยา,1493,ท้องถิ่นเทศบาลตำบลนครหลวง,3316,3650,6966,3319,3650,6969,3027
2563,14,พระนครศรีอยุธยา,1494,ท้องถิ่นเทศบาลตำบลท่าหลวง,3951,4460,8411,3959,4464,8423,4118
2563,14,พระนครศรีอยุธยา,1495,ท้องถิ่นเทศบาลเมืองอโยธยา,9314,10746,20060,9336,10765,20101,10266
2563,14,พระนครศรีอยุธยา,1496,ท้องถิ่นเทศบาลเมืองเจ้าเจ็ด,5135,5490,10625,5200,5548,10748,3165
2563,14,พระนครศรีอยุธยา,1497,ท้องถิ่นเทศบาลตำบลท่าเรือ,3046,3450,6496,3060,3468,6528,3174
2563,14,พระนครศรีอยุธยา,1498,ท้องถิ่นเทศบาลเมืองเสนา,1741,1951,3692,1757,1957,3714,1449
2563,14,พระนครศรีอยุธยา,1499,ท้องถิ่นเทศบาลนครพระนครศรีอยุธยา,23142,25533,48675,23423,25785,49208,20332
2563,15,อ่างทอง,1501,อำเภอเมืองอ่างทอง,20721,22968,43689,20742,22997,43739,16782
2563,15,อ่างทอง,1502,อำเภอไชโย,3422,3695,7117,3424,3697,7121,2387
2563,15,อ่างทอง,1503,อำเภอป่าโมก,8979,9892,18871,8989,9907,18896,6665
2563,15,อ่างทอง,1504,อำเภอโพธิ์ทอง,20846,22917,43763,20865,22935,43800,15385
2563,15,อ่างทอง,1505,อำเภอแสวงหา,15070,15833,30903,15077,15839,30916,9961
2563,15,อ่างทอง,1506,อำเภอวิเศษชัยชาญ,24484,26468,50952,24513,26492,51005,18066
2563,15,อ่างทอง,1507,อำเภอสามโก้,4071,4336,8407,4072,4340,8412,2833
2563,15,อ่างทอง,1590,ท้องถิ่นเทศบาลตำบลสามโก้,5077,5603,10680,5080,5606,10686,3504
2563,15,อ่างทอง,1591,ท้องถิ่นเทศบาลตำบลวิเศษไชยชาญ,2733,3224,5957,2749,3233,5982,2988
2563,15,อ่างทอง,1592,ท้องถิ่นเทศบาลตำบลบางจัก,3667,3996,7663,3670,3998,7668,2777
2563,15,อ่างทอง,1593,ท้องถิ่นเทศบาลตำบลแสวงหา,1591,1651,3242,1595,1655,3250,1258
2563,15,อ่างทอง,1594,ท้องถิ่นเทศบาลตำบลรำมะสัก,2008,2207,4215,2009,2210,4219,1561
2563,15,อ่างทอง,1595,ท้องถิ่นเทศบาลตำบลโพธิ์ทอง,2010,2260,4270,2012,2261,4273,1829
2563,15,อ่างทอง,1596,ท้องถิ่นเทศบาลตำบลไชโย,6113,6569,12682,6123,6577,12700,4156
2563,15,อ่างทอง,1597,ท้องถิ่นเทศบาลตำบลเกษไชโย,1377,1411,2788,1380,1413,2793,949
2563,15,อ่างทอง,1598,ท้องถิ่นเทศบาลตำบลป่าโมก,4249,4600,8849,4276,4622,8898,3593
2563,15,อ่างทอง,1599,ท้องถิ่นเทศบาลเมืองอ่างทอง,5772,6357,12129,5817,6409,12226,6597
2563,16,ลพบุรี,1601,อำเภอเมืองลพบุรี,52195,51413,103608,52238,51436,103674,41105
2563,16,ลพบุรี,1602,อำเภอพัฒนานิคม,26610,27368,53978,26635,27387,54022,23220
2563,16,ลพบุรี,1603,อำเภอโคกสำโรง,37865,38514,76379,37896,38536,76432,28633
2563,16,ลพบุรี,1604,อำเภอชัยบาดาล,36390,37167,73557,36423,37182,73605,27833
2563,16,ลพบุรี,1605,อำเภอท่าวุ้ง,21232,22887,44119,21244,22906,44150,15308
2563,16,ลพบุรี,1606,อำเภอบ้านหมี่,33508,36177,69685,33524,36195,69719,25041
2563,16,ลพบุรี,1607,อำเภอท่าหลวง,12744,13016,25760,12758,13027,25785,9324
2563,16,ลพบุรี,1608,อำเภอสระโบสถ์,7145,6956,14101,7148,6962,14110,5244
2563,16,ลพบุรี,1609,อำเภอโคกเจริญ,12182,12189,24371,12186,12198,24384,8472
2563,16,ลพบุรี,1610,อำเภอลำสนธิ,13570,13670,27240,13580,13671,27251,10329
2563,16,ลพบุรี,1611,อำเภอหนองม่วง,13638,14202,27840,13671,14238,27909,11480
2563,16,ลพบุรี,1681,ท้องถิ่นเทศบาลตำบลกกโก,4748,5548,10296,4754,5549,10303,5177
2563,16,ลพบุรี,1682,ท้องถิ่นเทศบาลตำบลถนนใหญ่,5989,5017,11006,5996,5022,11018,4730
2563,16,ลพบุรี,1683,ท้องถิ่นเทศบาลเมืองเขาสามยอด,16109,13160,29269,16305,13301,29606,12324
2563,16,ลพบุรี,1684,ท้องถิ่นเทศบาลตำบลท่าศาลา,6898,7780,14678,6913,7800,14713,7083
2563,16,ลพบุรี,1685,ท้องถิ่นเทศบาลตำบลดีลัง,3900,4181,8081,3905,4183,8088,3739
2563,16,ลพบุรี,1686,ท้องถิ่นเทศบาลตำบลเขาพระงาม,16024,9261,25285,16029,9267,25296,11806
2563,16,ลพบุรี,1688,ท้องถิ่นเทศบาลตำบลสระโบสถ์,3479,3794,7273,3479,3795,7274,3251
2563,16,ลพบุรี,1689,ท้องถิ่นเทศบาลตำบลบ้านท่าหลวง,1923,1952,3875,1930,1955,3885,2097
2563,16,ลพบุรี,1690,ท้องถิ่นเทศบาลตำบลท่าวุ้ง,1022,1125,2147,1023,1125,2148,910
2563,16,ลพบุรี,1691,ท้องถิ่นเทศบาลตำบลท่าโขลง,1052,1204,2256,1060,1217,2277,994
2563,16,ลพบุรี,1692,ท้องถิ่นเทศบาลตำบลลำนารายณ์,7527,8155,15682,7647,8236,15883,8564
2563,16,ลพบุรี,1693,ท้องถิ่นเทศบาลตำบลหนองม่วง,2436,2598,5034,2442,2600,5042,2134
2563,16,ลพบุรี,1694,ท้องถิ่นเทศบาลตำบลพัฒนานิคม,1471,1614,3085,1571,1723,3294,1436
2563,16,ลพบุรี,1695,ท้องถิ่นเทศบาลตำบลแก่งเสือเต้น,1289,1345,2634,1289,1346,2635,1050
2563,16,ลพบุรี,1696,ท้องถิ่นเทศบาลตำบลโคกตูม,14583,14969,29552,14596,14975,29571,11496
2563,16,ลพบุรี,1697,ท้องถิ่นเทศบาลตำบลโคกสำโรง,2789,3042,5831,2798,3047,5845,2434
2563,16,ลพบุรี,1698,ท้องถิ่นเทศบาลเมืองบ้านหมี่,1501,1676,3177,1534,1696,3230,1441
2563,16,ลพบุรี,1699,ท้องถิ่นเทศบาลเมืองลพบุรี,10549,11174,21723,10583,11196,21779,12683
2563,17,สิงห์บุรี,1701,อำเภอเมืองสิงห์บุรี,17015,19439,36454,17049,19462,36511,13204
2563,17,สิงห์บุรี,1702,อำเภอบางระจัน,9405,10027,19432,9412,10032,19444,7070
2563,17,สิงห์บุรี,1703,อำเภอค่ายบางระจัน,12431,13389,25820,12443,13403,25846,8821
2563,17,สิงห์บุรี,1704,อำเภอพรหมบุรี,7883,8742,16625,7894,8760,16654,5912
2563,17,สิงห์บุรี,1705,อำเภอท่าช้าง,2563,2893,5456,2567,2894,5461,1840
2563,17,สิงห์บุรี,1706,อำเภออินทร์บุรี,23546,25452,48998,23564,25472,49036,17555
2563,17,สิงห์บุรี,1793,ท้องถิ่นเทศบาลตำบลอินทร์บุรี,2164,2385,4549,2169,2388,4557,2278
2563,17,สิงห์บุรี,1794,ท้องถิ่นเทศบาลตำบลถอนสมอ,4175,4564,8739,4180,4568,8748,3405
2563,17,สิงห์บุรี,1795,ท้องถิ่นเทศบาลตำบลพรหมบุรี,1524,1643,3167,1528,1645,3173,1301
2563,17,สิงห์บุรี,1796,ท้องถิ่นเทศบาลตำบลบางน้ำเชี่ยว,1614,1773,3387,1625,1781,3406,1362
2563,17,สิงห์บุรี,1797,ท้องถิ่นเทศบาลตำบลโพสังโฆ,965,1078,2043,966,1080,2046,837
2563,17,สิงห์บุรี,1798,ท้องถิ่นเทศบาลเมืองบางระจัน,6534,7384,13918,6546,7391,13937,5624
2563,17,สิงห์บุรี,1799,ท้องถิ่นเทศบาลเมืองสิงห์บุรี,7915,9099,17014,7954,9125,17079,9201
2563,18,ชัยนาท,1801,อำเภอเมืองชัยนาท,11015,11808,22823,11029,11814,22843,8632
2563,18,ชัยนาท,1802,อำเภอมโนรมย์,11405,12421,23826,11421,12440,23861,8792
2563,18,ชัยนาท,1803,อำเภอวัดสิงห์,10656,11414,22070,10658,11418,22076,8976
2563,18,ชัยนาท,1804,อำเภอสรรพยา,15018,15914,30932,15020,15918,30938,11652
2563,18,ชัยนาท,1805,อำเภอสรรคบุรี,29427,31925,61352,29454,31943,61397,22100
2563,18,ชัยนาท,1806,อำเภอหันคา,19920,21244,41164,19938,21262,41200,14492
2563,18,ชัยนาท,1807,อำเภอหนองมะโมง,6322,6499,12821,6326,6503,12829,5093
2563,18,ชัยนาท,1808,อำเภอเนินขาม,5318,5547,10865,5319,5547,10866,3938
2563,18,ชัยนาท,1880,ท้องถิ่นเทศบาลตำบลบางหลวง,2537,2842,5379,2537,2844,5381,2610
2563,18,ชัยนาท,1881,ท้องถิ่นเทศบาลตำบลนางลือ,3595,3975,7570,3597,3982,7579,2570
2563,18,ชัยนาท,1882,ท้องถิ่นเทศบาลตำบลเสือโฮก,3643,3872,7515,3646,3873,7519,2430
2563,18,ชัยนาท,1883,ท้องถิ่นเทศบาลตำบลหาดท่าเสา,2460,2591,5051,2461,2591,5052,1782
2563,18,ชัยนาท,1884,ท้องถิ่นเทศบาลตำบลชัยนาท,3631,4357,7988,3633,4357,7990,2671
2563,18,ชัยนาท,1885,ท้องถิ่นเทศบาลตำบลบ้านกล้วย,3287,3659,6946,3296,3661,6957,3493
2563,18,ชัยนาท,1887,ท้องถิ่นเทศบาลตำบลหนองแซง,3799,3959,7758,3801,3963,7764,2733
2563,18,ชัยนาท,1889,ท้องถิ่นเทศบาลตำบลวังตะเคียน,3272,3414,6686,3273,3415,6688,2458
2563,18,ชัยนาท,1890,ท้องถิ่นเทศบาลตำบลเนินขาม,2851,3133,5984,2851,3133,5984,2622
2563,18,ชัยนาท,1891,ท้องถิ่นเทศบาลตำบลหันคา,1930,2182,4112,1934,2185,4119,2413
2563,18,ชัยนาท,1892,ท้องถิ่นเทศบาลตำบลสามง่ามท่าโบสถ์,648,699,1347,649,699,1348,471
2563,18,ชัยนาท,1893,ท้องถิ่นเทศบาลตำบลแพรกศรีราชา,1159,1341,2500,1162,1346,2508,1353
2563,18,ชัยนาท,1894,ท้องถิ่นเทศบาลตำบลสรรพยา,1498,1619,3117,1498,1619,3117,1355
2563,18,ชัยนาท,1895,ท้องถิ่นเทศบาลตำบลโพธิ์พิทักษ์,756,827,1583,757,828,1585,571
2563,18,ชัยนาท,1896,ท้องถิ่นเทศบาลตำบลหางน้ำสาคร,2938,3164,6102,2952,3170,6122,3069
2563,18,ชัยนาท,1897,ท้องถิ่นเทศบาลตำบลคุ้งสำเภา,905,950,1855,911,954,1865,988
2563,18,ชัยนาท,1898,ท้องถิ่นเทศบาลตำบลวัดสิงห์,1513,1695,3208,1516,1698,3214,1968
2563,18,ชัยนาท,1899,ท้องถิ่นเทศบาลเมืองชัยนาท,5328,6251,11579,5374,6301,11675,7441
2563,19,สระบุรี,1901,อำเภอเมืองสระบุรี,25258,21897,47155,25302,21946,47248,19624
2563,19,สระบุรี,1902,อำเภอแก่งคอย,34462,35340,69802,34590,35415,70005,30672
2563,19,สระบุรี,1903,อำเภอหนองแค,32845,34633,67478,32902,34696,67598,33527
2563,19,สระบุรี,1904,อำเภอวิหารแดง,16194,16868,33062,16229,16910,33139,11969
2563,19,สระบุรี,1905,อำเภอหนองแซง,6189,6786,12975,6196,6795,12991,4335
2563,19,สระบุรี,1906,อำเภอบ้านหมอ,15317,16208,31525,15335,16221,31556,12275
2563,19,สระบุรี,1907,อำเภอดอนพุด,967,1024,1991,967,1025,1992,658
2563,19,สระบุรี,1908,อำเภอหนองโดน,5606,5910,11516,5614,5914,11528,4420
2563,19,สระบุรี,1909,อำเภอพระพุทธบาท,11869,12546,24415,11881,12560,24441,9739
2563,19,สระบุรี,1910,อำเภอเสาไห้,10562,11562,22124,10588,11591,22179,8227
2563,19,สระบุรี,1911,อำเภอมวกเหล็ก,24554,24778,49332,24640,24837,49477,21846
2563,19,สระบุรี,1912,อำเภอวังม่วง,5667,5915,11582,5678,5923,11601,4565
2563,19,สระบุรี,1913,อำเภอเฉลิมพระเกียรติ,14374,15156,29530,14398,15187,29585,12441
2563,19,สระบุรี,1974,ท้องถิ่นเทศบาลตำบลพุกร่าง,3305,3459,6764,3305,3463,6768,2396
2563,19,สระบุรี,1975,ท้องถิ่นเทศบาลตำบลคำพราน,2083,2116,4199,2087,2117,4204,2053
2563,19,สระบุรี,1976,ท้องถิ่นเทศบาลตำบลไผ่ต่ำ,1975,2031,4006,1980,2042,4022,2099
2563,19,สระบุรี,1977,ท้องถิ่นเทศบาลตำบลตะกุด,2345,2400,4745,2352,2405,4757,2189
2563,19,สระบุรี,1978,ท้องถิ่นเทศบาลตำบลกุดนกเปล้า,2859,3026,5885,2859,3028,5887,2566
2563,19,สระบุรี,1979,ท้องถิ่นเทศบาลตำบลหน้าพระลาน,3957,3916,7873,3977,3944,7921,3292
2563,19,สระบุรี,1980,ท้องถิ่นเทศบาลตำบลวังม่วง,2075,2186,4261,2091,2197,4288,2550
2563,19,สระบุรี,1981,ท้องถิ่นเทศบาลตำบลมวกเหล็ก,3305,3507,6812,3333,3537,6870,3761
2563,19,สระบุรี,1982,ท้องถิ่นเทศบาลตำบลเสาไห้,1493,1616,3109,1500,1622,3122,1441
2563,19,สระบุรี,1983,ท้องถิ่นเทศบาลตำบลสวนดอกไม้,3614,4022,7636,3616,4023,7639,3979
2563,19,สระบุรี,1984,ท้องถิ่นเทศบาลตำบลบ้านยาง,481,571,1052,483,572,1055,383
2563,19,สระบุรี,1985,ท้องถิ่นเทศบาลตำบลหนองโดน,1139,1274,2413,1140,1274,2414,1033
2563,19,สระบุรี,1986,ท้องถิ่นเทศบาลตำบลดอนพุด,2317,2377,4694,2318,2378,4696,1817
2563,19,สระบุรี,1987,ท้องถิ่นเทศบาลตำบลบ้านหมอ,1298,1377,2675,1301,1383,2684,1342
2563,19,สระบุรี,1988,ท้องถิ่นเทศบาลตำบลท่าลาน,3804,4089,7893,3809,4094,7903,3996
2563,19,สระบุรี,1989,ท้องถิ่นเทศบาลตำบลหนองแซง,1361,1483,2844,1366,1484,2850,1014
2563,19,สระบุรี,1990,ท้องถิ่นเทศบาลตำบลหนองหมู,816,856,1672,818,856,1674,494
2563,19,สระบุรี,1991,ท้องถิ่นเทศบาลตำบลวิหารแดง,1953,2189,4142,1964,2200,4164,1892
2563,19,สระบุรี,1992,ท้องถิ่นเทศบาลตำบลหินกอง,4410,4965,9375,4426,4981,9407,5566
2563,19,สระบุรี,1993,ท้องถิ่นเทศบาลตำบลคชสิทธิ์,652,691,1343,657,696,1353,652
2563,19,สระบุรี,1994,ท้องถิ่นเทศบาลเมืองทับกวาง,9791,9829,19620,9848,9866,19714,9568
2563,19,สระบุรี,1995,ท้องถิ่นเทศบาลตำบลป๊อกแป๊ก,333,385,718,335,386,721,412
2563,19,สระบุรี,1996,ท้องถิ่นเทศบาลเมืองพระพุทธบาท,13265,15504,28769,15713,17745,33458,13230
2563,19,สระบุรี,1997,ท้องถิ่นเทศบาลตำบลหนองแค,5913,6341,12254,5988,6413,12401,6325
2563,19,สระบุรี,1998,ท้องถิ่นเทศบาลเมืองแก่งคอย,5418,5803,11221,5438,5815,11253,6152
2563,19,สระบุรี,1999,ท้องถิ่นเทศบาลเมืองสระบุรี,29299,29645,58944,29481,29782,59263,28569
2563,20,ชลบุรี,2001,อำเภอเมืองชลบุรี,20000,21111,41111,20034,21136,41170,26137
2563,20,ชลบุรี,2002,อำเภอบ้านบึง,40265,41549,81814,40611,41793,82404,44781
2563,20,ชลบุรี,2003,อำเภอหนองใหญ่,7494,7506,15000,7705,7665,15370,6594
2563,20,ชลบุรี,2004,อำเภอบางละมุง,13198,14916,28114,13429,15075,28504,18127
2563,20,ชลบุรี,2005,อำเภอพานทอง,22889,23643,46532,22913,23667,46580,36276
2563,20,ชลบุรี,2006,อำเภอพนัสนิคม,48673,51686,100359,48967,51971,100938,36074
2563,20,ชลบุรี,2007,อำเภอศรีราชา,27794,27804,55598,27915,27877,55792,46958
2563,20,ชลบุรี,2008,อำเภอเกาะสีชัง,0,0,0,0,0,0,0
2563,20,ชลบุรี,2009,อำเภอสัตหีบ,25688,25814,51502,26086,26156,52242,29194
2563,20,ชลบุรี,2010,อำเภอบ่อทอง,18870,18615,37485,18978,18691,37669,13367
2563,20,ชลบุรี,2011,อำเภอเกาะจันทร์,13112,12537,25649,13539,12870,26409,8383
2563,20,ชลบุรี,2060,ท้องถิ่นเทศบาลตำบลเกล็ดแก้ว,7345,5302,12647,7486,5316,12802,6346
2563,20,ชลบุรี,2061,ท้องถิ่นเทศบาลตำบลเขตรอุดมศักดิ์,33036,21817,54853,33130,21854,54984,26594
2563,20,ชลบุรี,2063,ท้องถิ่นเทศบาลตำบลหมอนนาง,6562,7033,13595,6594,7049,13643,4432
2563,20,ชลบุรี,2064,ท้องถิ่นเทศบาลตำบลตะเคียนเตี้ย,11591,12516,24107,11647,12544,24191,12241
2563,20,ชลบุรี,2065,ท้องถิ่นเทศบาลตำบลเสม็ด,10139,12359,22498,10174,12377,22551,17440
2563,20,ชลบุรี,2066,ท้องถิ่นเทศบาลเมืองดอนหัวฬ่อ,6484,6612,13096,6493,6615,13108,14699
2563,20,ชลบุรี,2067,ท้องถิ่นเทศบาลตำบลห้วยกะปิ,7681,8693,16374,7696,8699,16395,10120
2563,20,ชลบุรี,2068,ท้องถิ่นเทศบาลตำบลนาป่า,20275,21034,41309,20301,21052,41353,25817
2563,20,ชลบุรี,2069,ท้องถิ่นเทศบาลตำบลหนองไม้แดง,6768,6348,13116,6776,6351,13127,11074
2563,20,ชลบุรี,2070,ท้องถิ่นเทศบาลตำบลธาตุทอง,3824,3956,7780,3869,4000,7869,2721
2563,20,ชลบุรี,2071,ท้องถิ่นเทศบาลตำบลโป่ง,4922,5473,10395,5044,5488,10532,6330
2563,20,ชลบุรี,2072,ท้องถิ่นเทศบาลเมืองหนองปรือ,37725,47803,85528,39043,48011,87054,50694
2563,20,ชลบุรี,2073,ท้องถิ่นเทศบาลตำบลท่าบุญมี,3269,3465,6734,3281,3481,6762,4145
2563,20,ชลบุรี,2074,ท้องถิ่นเทศบาลตำบลเกาะจันทร์,3381,1837,5218,3387,1840,5227,1798
2563,20,ชลบุรี,2075,ท้องถิ่นเทศบาลตำบลบ่อทอง,1794,1882,3676,2090,2151,4241,2041
2563,20,ชลบุรี,2076,ท้องถิ่นเทศบาลเมืองสัตหีบ,10584,11587,22171,10634,11626,22260,12080
2563,20,ชลบุรี,2077,ท้องถิ่นเทศบาลตำบลบางเสร่,5181,6234,11415,5331,6257,11588,9206
2563,20,ชลบุรี,2078,ท้องถิ่นเทศบาลตำบลนาจอมเทียน,3632,4189,7821,3789,4237,8026,15653
2563,20,ชลบุรี,2079,ท้องถิ่นเทศบาลตำบลเกาะสีชัง,2221,2264,4485,2226,2268,4494,2187
2563,20,ชลบุรี,2080,ท้องถิ่นเทศบาลนครเจ้าพระยาสุรศักดิ์,71025,75009,146034,71314,75160,146474,101394
2563,20,ชลบุรี,2081,ท้องถิ่นเทศบาลตำบลบางพระ,6360,6973,13333,6394,6986,13380,7709
2563,20,ชลบุรี,2082,ท้องถิ่นเทศบาลตำบลหนองตำลึง,10424,10651,21075,10433,10661,21094,16219
2563,20,ชลบุรี,2083,ท้องถิ่นเทศบาลตำบลพานทอง,2845,3087,5932,3017,3257,6274,3745
2563,20,ชลบุรี,2084,ท้องถิ่นเทศบาลตำบลห้วยใหญ่,14265,16128,30393,14472,16181,30653,17569
2563,20,ชลบุรี,2085,ท้องถิ่นเทศบาลตำบลบางละมุง,5895,6436,12331,5960,6524,12484,8982
2563,20,ชลบุรี,2086,ท้องถิ่นเทศบาลตำบลหนองใหญ่,4135,3993,8128,4342,4167,8509,3367
2563,20,ชลบุรี,2087,ท้องถิ่นเทศบาลตำบลหัวกุญแจ,1792,1991,3783,1817,2009,3826,2080
2563,20,ชลบุรี,2088,ท้องถิ่นเทศบาลตำบลหนองไผ่แก้ว,1114,1203,2317,1115,1207,2322,1571
2563,20,ชลบุรี,2089,ท้องถิ่นเทศบาลเมืองอ่างศิลา,16871,19436,36307,16903,19462,36365,21585
2563,20,ชลบุรี,2090,ท้องถิ่นเทศบาลนครบ้านสวน,33005,33765,66770,34097,34693,68790,45512
2563,20,ชลบุรี,2091,ท้องถิ่นเทศบาลตำบลบางทราย,6406,5235,11641,6433,5246,11679,7448
2563,20,ชลบุรี,2092,ท้องถิ่นเทศบาลตำบลคลองตำหรุ,2214,2488,4702,2226,2496,4722,6486
2563,20,ชลบุรี,2093,ท้องถิ่นเทศบาลนครแหลมฉบัง,43477,45061,88538,43974,45483,89457,80380
2563,20,ชลบุรี,2094,ท้องถิ่นเทศบาลเมืองแสนสุข,21292,24337,45629,21585,24546,46131,37588
2563,20,ชลบุรี,2095,ท้องถิ่นเทศบาลเมืองบ้านบึง,9049,10284,19333,9854,11037,20891,10372
2563,20,ชลบุรี,2096,ท้องถิ่นเมืองพัทยา,50410,61492,111902,53710,63896,117606,170621
2563,20,ชลบุรี,2097,ท้องถิ่นเทศบาลเมืองศรีราชา,9757,12220,21977,10524,12910,23434,8520
2563,20,ชลบุรี,2098,ท้องถิ่นเทศบาลเมืองพนัสนิคม,4601,5451,10052,4620,5455,10075,4989
2563,20,ชลบุรี,2099,ท้องถิ่นเทศบาลเมืองชลบุรี,11961,13367,25328,12025,13409,25434,12563
2563,21,ระยอง,2101,อำเภอเมืองระยอง,49667,51372,101039,49968,51510,101478,64483
2563,21,ระยอง,2102,อำเภอบ้านฉาง,5550,4963,10513,5572,4977,10549,4621
2563,21,ระยอง,2103,อำเภอแกลง,32462,34888,67350,32540,34943,67483,30962
2563,21,ระยอง,2104,อำเภอวังจันทร์,11020,11215,22235,11067,11250,22317,10978
2563,21,ระยอง,2105,อำเภอบ้านค่าย,32240,33834,66074,32326,33887,66213,33972
2563,21,ระยอง,2106,อำเภอปลวกแดง,35250,33886,69136,35317,33947,69264,94541
2563,21,ระยอง,2107,อำเภอเขาชะเมา,11749,11865,23614,11776,11893,23669,11002
2563,21,ระยอง,2108,อำเภอนิคมพัฒนา,10046,10214,20260,10076,10246,20322,15638
2563,21,ระยอง,2177,ท้องถิ่นเทศบาลตำบลพลา,4464,4571,9035,4611,4607,9218,5885
2563,21,ระยอง,2178,ท้องถิ่นเทศบาลตำบลเนินฆ้อ,2231,2356,4587,2237,2362,4599,1925
2563,21,ระยอง,2179,ท้องถิ่นเทศบาลตำบลทับมา,12420,12544,24964,12460,12562,25022,16938
2563,21,ระยอง,2180,ท้องถิ่นเทศบาลตำบลบ้านนา,4120,4289,8409,4128,4305,8433,3329
2563,21,ระยอง,2181,ท้องถิ่นเทศบาลตำบลมาบข่าพัฒนา,4681,4749,9430,4688,4760,9448,6773
2563,21,ระยอง,2182,ท้องถิ่นเทศบาลตำบลบ้านฉาง,7001,7287,14288,7095,7320,14415,8481
2563,21,ระยอง,2183,ท้องถิ่นเทศบาลเมืองมะขามคู่,6699,6866,13565,6706,6872,13578,11623
2563,21,ระยอง,2184,ท้องถิ่นเทศบาลเมืองนิคมพัฒนา,5306,5307,10613,5309,5313,10622,8035
2563,21,ระยอง,2185,ท้องถิ่นเทศบาลตำบลบ้านปลวกแดง,2402,2744,5146,2629,2936,5565,4522
2563,21,ระยอง,2186,ท้องถิ่นเทศบาลตำบลจอมพลเจ้าพระยา,345,350,695,345,350,695,433
2563,21,ระยอง,2187,ท้องถิ่นเทศบาลตำบลบ้านค่าย,1487,1677,3164,1568,1756,3324,2022
2563,21,ระยอง,2188,ท้องถิ่นเทศบาลตำบลชุมแสง,1801,1844,3645,1855,1893,3748,2230
2563,21,ระยอง,2189,ท้องถิ่นเทศบาลตำบลสุนทรภู่,6936,7780,14716,7148,7838,14986,9995
2563,21,ระยอง,2190,ท้องถิ่นเทศบาลตำบลปากน้ำประแส,2302,2470,4772,2320,2489,4809,1978
2563,21,ระยอง,2191,ท้องถิ่นเทศบาลตำบลทุ่งควายกิน,3165,3439,6604,3188,3451,6639,3922
2563,21,ระยอง,2192,ท้องถิ่นเทศบาลตำบลกองดิน,2386,2437,4823,2391,2447,4838,1831
2563,21,ระยอง,2193,ท้องถิ่นเทศบาลตำบลสำนักท้อน,5511,5694,11205,5540,5711,11251,5898
2563,21,ระยอง,2194,ท้องถิ่นเทศบาลเมืองบ้านฉาง,14997,15828,30825,15243,15939,31182,20588
2563,21,ระยอง,2195,ท้องถิ่นเทศบาลตำบลบ้านเพ,8317,9281,17598,8461,9308,17769,11923
2563,21,ระยอง,2196,ท้องถิ่นเทศบาลตำบลแกลงกะเฉด,3391,3672,7063,3417,3683,7100,3279
2563,21,ระยอง,2197,ท้องถิ่นเทศบาลนครมาบตาพุด,35882,35656,71538,36084,35848,71932,59696
2563,21,ระยอง,2198,ท้องถิ่นเทศบาลตำบลเมืองแกลง,8256,9259,17515,8879,9793,18672,11600
2563,21,ระยอง,2199,ท้องถิ่นเทศบาลนครระยอง,27842,31832,59674,29256,33128,62384,37658
2563,22,จันทบุรี,2201,อำเภอเมืองจันทบุรี,22028,24318,46346,22092,24365,46457,21762
2563,22,จันทบุรี,2202,อำเภอขลุง,12516,12866,25382,12537,12883,25420,10040
2563,22,จันทบุรี,2203,อำเภอท่าใหม่,23284,24390,47674,23355,24439,47794,17881
2563,22,จันทบุรี,2204,อำเภอโป่งน้ำร้อน,10801,10177,20978,10880,10296,21176,8487
2563,22,จันทบุรี,2205,อำเภอมะขาม,15045,15375,30420,15127,15474,30601,13275
2563,22,จันทบุรี,2206,อำเภอแหลมสิงห์,6881,7253,14134,6929,7304,14233,5300
2563,22,จันทบุรี,2207,อำเภอสอยดาว,18825,18477,37302,18909,18548,37457,14953
2563,22,จันทบุรี,2208,อำเภอแก่งหางแมว,21178,20945,42123,21275,21052,42327,20687
2563,22,จันทบุรี,2209,อำเภอนายายอาม,14785,15736,30521,14917,15879,30796,11891
2563,22,จันทบุรี,2210,อำเภอเขาคิชฌกูฏ,6252,6451,12703,6267,6469,12736,5467
2563,22,จันทบุรี,2272,ท้องถิ่นเทศบาลตำบลเขาบายศรี,3073,3195,6268,3100,3209,6309,2504
2563,22,จันทบุรี,2273,ท้องถิ่นเทศบาลตำบลคลองใหญ่,2621,2625,5246,2652,2663,5315,2069
2563,22,จันทบุรี,2274,ท้องถิ่นเทศบาลตำบลหนองตาคง,5081,4811,9892,5114,4852,9966,3981
2563,22,จันทบุรี,2275,ท้องถิ่นเทศบาลตำบลตกพรม,1972,2130,4102,2006,2148,4154,1584
2563,22,จันทบุรี,2276,ท้องถิ่นเทศบาลตำบลเกวียนหัก,2092,2435,4527,2093,2437,4530,2149
2563,22,จันทบุรี,2277,ท้องถิ่นเทศบาลตำบลบ่อ,3524,3680,7204,3528,3687,7215,2623
2563,22,จันทบุรี,2278,ท้องถิ่นเทศบาลตำบลชากไทย,2094,2200,4294,2111,2220,4331,1867
2563,22,จันทบุรี,2279,ท้องถิ่นเทศบาลตำบลตะเคียนทอง,2316,2265,4581,2321,2269,4590,1814
2563,22,จันทบุรี,2280,ท้องถิ่นเทศบาลเมืองเกาะขวาง,7873,8680,16553,7930,8712,16642,7979
2563,22,จันทบุรี,2281,ท้องถิ่นเทศบาลตำบลบ่อเวฬุ,2279,2055,4334,2300,2074,4374,2511
2563,22,จันทบุรี,2282,ท้องถิ่นเทศบาลตำบลพลวง,3543,3819,7362,3620,3897,7517,4128
2563,22,จันทบุรี,2283,ท้องถิ่นเทศบาลตำบลทับช้าง,8248,8110,16358,8260,8113,16373,6030
2563,22,จันทบุรี,2284,ท้องถิ่นเทศบาลตำบลนายายอาม,1683,1834,3517,1686,1844,3530,1959
2563,22,จันทบุรี,2285,ท้องถิ่นเทศบาลตำบลสอยดาว,5568,5705,11273,5602,5724,11326,6318
2563,22,จันทบุรี,2286,ท้องถิ่นเทศบาลตำบลพลิ้ว,3314,3755,7069,3320,3756,7076,3086
2563,22,จันทบุรี,2287,ท้องถิ่นเทศบาลตำบลปากน้ำแหลมสิงห์,4272,4504,8776,4281,4515,8796,3406
2563,22,จันทบุรี,2288,ท้องถิ่นเทศบาลตำบลมะขาม,804,910,1714,808,914,1722,1025
2563,22,จันทบุรี,2289,ท้องถิ่นเทศบาลตำบลโป่งน้ำร้อน,4833,4136,8969,4908,4203,9111,4209
2563,22,จันทบุรี,2290,ท้องถิ่นเทศบาลตำบลหนองคล้า,1773,1979,3752,1783,1994,3777,2141
2563,22,จันทบุรี,2291,ท้องถิ่นเทศบาลตำบลเนินสูง,1440,1578,3018,1444,1585,3029,1646
2563,22,จันทบุรี,2292,ท้องถิ่นเทศบาลตำบลหนองบัว,1063,1211,2274,1064,1211,2275,971
2563,22,จันทบุรี,2293,ท้องถิ่นเทศบาลตำบลพลับพลานารายณ์,4912,5447,10359,4920,5466,10386,6199
2563,22,จันทบุรี,2294,ท้องถิ่นเทศบาลตำบลบางกะจะ,2467,2636,5103,2474,2638,5112,2164
2563,22,จันทบุรี,2295,ท้องถิ่นเทศบาลเมืองท่าช้าง,6312,7494,13806,6344,7507,13851,10442
2563,22,จันทบุรี,2296,ท้องถิ่นเทศบาลเมืองจันทนิมิต,5687,6377,12064,5784,6486,12270,7783
2563,22,จันทบุรี,2297,ท้องถิ่นเทศบาลเมืองขลุง,5015,5678,10693,5038,5697,10735,4271
2563,22,จันทบุรี,2298,ท้องถิ่นเทศบาลเมืองท่าใหม่,4699,5387,10086,4724,5406,10130,4549
2563,22,จันทบุรี,2299,ท้องถิ่นเทศบาลเมืองจันทบุรี,10042,11186,21228,10524,11596,22120,14576
2563,23,ตราด,2301,อำเภอเมืองตราด,34839,36950,71789,36133,38181,74314,35026
2563,23,ตราด,2302,อำเภอคลองใหญ่,5890,5725,11615,7360,7326,14686,5402
2563,23,ตราด,2303,อำเภอเขาสมิง,19766,19963,39729,19885,20050,39935,17646
2563,23,ตราด,2304,อำเภอบ่อไร่,9584,8873,18457,9697,8991,18688,7576
2563,23,ตราด,2305,อำเภอแหลมงอบ,6843,7012,13855,6918,7081,13999,5784
2563,23,ตราด,2306,อำเภอเกาะกูด,1322,1228,2550,1354,1255,2609,2020
2563,23,ตราด,2307,อำเภอเกาะช้าง,4125,4122,8247,4301,4295,8596,5978
2563,23,ตราด,2389,ท้องถิ่นเทศบาลตำบลตะกาง,1253,1316,2569,1273,1338,2611,1334
2563,23,ตราด,2390,ท้องถิ่นเทศบาลตำบลหนองบอน,3781,3669,7450,3801,3700,7501,3911
2563,23,ตราด,2391,ท้องถิ่นเทศบาลตำบลแหลมงอบ,878,913,1791,886,925,1811,718
2563,23,ตราด,2392,ท้องถิ่นเทศบาลตำบลน้ำเชี่ยว,1582,1693,3275,1589,1701,3290,1333
2563,23,ตราด,2393,ท้องถิ่นเทศบาลตำบลบ่อพลอย,4241,4271,8512,4367,4396,8763,5648
2563,23,ตราด,2394,ท้องถิ่นเทศบาลตำบลแสนตุ้ง,1571,1612,3183,1605,1640,3245,2354
2563,23,ตราด,2395,ท้องถิ่นเทศบาลตำบลเขาสมิง,717,703,1420,719,705,1424,614
2563,23,ตราด,2396,ท้องถิ่นเทศบาลตำบลหาดเล็ก,2547,2426,4973,2746,2605,5351,1967
2563,23,ตราด,2397,ท้องถิ่นเทศบาลตำบลคลองใหญ่,2396,2438,4834,2623,2710,5333,2440
2563,23,ตราด,2398,ท้องถิ่นเทศบาลตำบลท่าพริกเนินทราย,3109,3362,6471,3185,3449,6634,2996
2563,23,ตราด,2399,ท้องถิ่นเทศบาลเมืองตราด,3916,4371,8287,4689,5057,9746,5523
2563,24,ฉะเชิงเทรา,2401,อำเภอเมืองฉะเชิงเทรา,59775,62775,122550,59968,62936,122904,51158
2563,24,ฉะเชิงเทรา,2402,อำเภอบางคล้า,14792,15699,30491,14828,15735,30563,12527
2563,24,ฉะเชิงเทรา,2403,อำเภอบางน้ำเปรี้ยว,36050,36550,72600,36172,36647,72819,21667
2563,24,ฉะเชิงเทรา,2404,อำเภอบางปะกง,27170,28252,55422,27581,28576,56157,26333
2563,24,ฉะเชิงเทรา,2405,อำเภอบ้านโพธิ์,22081,23688,45769,22119,23719,45838,20602
2563,24,ฉะเชิงเทรา,2406,อำเภอพนมสารคาม,34456,36347,70803,34578,36471,71049,29929
2563,24,ฉะเชิงเทรา,2407,อำเภอราชสาส์น,6199,6447,12646,6205,6460,12665,4692
2563,24,ฉะเชิงเทรา,2408,อำเภอสนามชัยเขต,35335,35195,70530,35409,35268,70677,22715
2563,24,ฉะเชิงเทรา,2409,อำเภอแปลงยาว,10645,10356,21001,10686,10396,21082,10862
2563,24,ฉะเชิงเทรา,2410,อำเภอท่าตะเกียบ,23590,23174,46764,23625,23199,46824,17009
2563,24,ฉะเชิงเทรา,2411,อำเภอคลองเขื่อน,6215,6526,12741,6222,6537,12759,4399
2563,24,ฉะเชิงเทรา,2474,ท้องถิ่นเทศบาลตำบลบางวัวคณารักษ์,5286,5770,11056,5298,5783,11081,8208
2563,24,ฉะเชิงเทรา,2475,ท้องถิ่นเทศบาลตำบลพิมพา,1623,1744,3367,1628,1747,3375,3428
2563,24,ฉะเชิงเทรา,2476,ท้องถิ่นเทศบาลตำบลวังเย็น,4544,4668,9212,4551,4678,9229,3234
2563,24,ฉะเชิงเทรา,2477,ท้องถิ่นเทศบาลตำบลดอนเกาะกา,4381,4271,8652,4400,4285,8685,2356
2563,24,ฉะเชิงเทรา,2478,ท้องถิ่นเทศบาลตำบลหัวสำโรง,3272,3415,6687,3275,3426,6701,3884
2563,24,ฉะเชิงเทรา,2479,ท้องถิ่นเทศบาลตำบลแปลงยาว,2982,3137,6119,2985,3140,6125,3465
2563,24,ฉะเชิงเทรา,2480,ท้องถิ่นเทศบาลตำบลทุ่งสะเดา,2959,2210,5169,3063,2313,5376,3987
2563,24,ฉะเชิงเทรา,2481,ท้องถิ่นเทศบาลตำบลสนามชัยเขต,1982,2235,4217,2022,2287,4309,2900
2563,24,ฉะเชิงเทรา,2482,ท้องถิ่นเทศบาลตำบลพนมสารคาม,2982,3455,6437,2992,3465,6457,4216
2563,24,ฉะเชิงเทรา,2483,ท้องถิ่นเทศบาลตำบลเขาหินซ้อน,1727,1791,3518,1729,1793,3522,2587
2563,24,ฉะเชิงเทรา,2484,ท้องถิ่นเทศบาลตำบลเกาะขนุน,1036,1118,2154,1040,1123,2163,1090
2563,24,ฉะเชิงเทรา,2485,ท้องถิ่นเทศบาลตำบลบ้านโพธิ์,1332,1392,2724,1392,1441,2833,1409
2563,24,ฉะเชิงเทรา,2486,ท้องถิ่นเทศบาลตำบลเทพราช,2093,2175,4268,2095,2179,4274,1259
2563,24,ฉะเชิงเทรา,2487,ท้องถิ่นเทศบาลตำบลบางวัว,1417,1544,2961,1422,1550,2972,1956
2563,24,ฉะเชิงเทรา,2488,ท้องถิ่นเทศบาลตำบลบางปะกง,2915,3216,6131,2926,3232,6158,2903
2563,24,ฉะเชิงเทรา,2489,ท้องถิ่นเทศบาลตำบลหอมศีล,650,631,1281,650,632,1282,327
2563,24,ฉะเชิงเทรา,2490,ท้องถิ่นเทศบาลตำบลท่าสะอ้าน,1528,1665,3193,1533,1665,3198,2428
2563,24,ฉะเชิงเทรา,2491,ท้องถิ่นเทศบาลตำบลท่าข้าม,3660,3951,7611,3667,3963,7630,8858
2563,24,ฉะเชิงเทรา,2492,ท้องถิ่นเทศบาลตำบลศาลาแดง,708,757,1465,709,760,1469,522
2563,24,ฉะเชิงเทรา,2493,ท้องถิ่นเทศบาลตำบลบางน้ำเปรี้ยว,1142,1191,2333,1152,1203,2355,1188
2563,24,ฉะเชิงเทรา,2494,ท้องถิ่นเทศบาลตำบลบางขนาก,1036,1027,2063,1046,1038,2084,782
2563,24,ฉะเชิงเทรา,2495,ท้องถิ่นเทศบาลตำบลดอนฉิมพลี,763,828,1591,776,831,1607,730
2563,24,ฉะเชิงเทรา,2496,ท้องถิ่นเทศบาลตำบลปากน้ำ,2589,2815,5404,2660,2896,5556,2579
2563,24,ฉะเชิงเทรา,2497,ท้องถิ่นเทศบาลตำบลนครเนื่องเขต,691,776,1467,695,780,1475,496
2563,24,ฉะเชิงเทรา,2498,ท้องถิ่นเทศบาลตำบลบางคล้า,4266,4961,9227,4291,4990,9281,4853
2563,24,ฉะเชิงเทรา,2499,ท้องถิ่นเทศบาลเมืองฉะเชิงเทรา,17503,19624,37127,18052,20132,38184,22048
2563,25,ปราจีนบุรี,2501,อำเภอเมืองปราจีนบุรี,45452,42670,88122,45576,42743,88319,35262
2563,25,ปราจีนบุรี,2502,อำเภอกบินทร์บุรี,66701,68889,135590,66784,68945,135729,52464
2563,25,ปราจีนบุรี,2503,อำเภอนาดี,21779,22001,43780,21804,22021,43825,17467
2563,25,ปราจีนบุรี,2506,อำเภอบ้านสร้าง,13599,14107,27706,13616,14132,27748,9598
2563,25,ปราจีนบุรี,2507,อำเภอประจันตคาม,24318,25597,49915,24334,25618,49952,16945
2563,25,ปราจีนบุรี,2508,อำเภอศรีมหาโพธิ,35588,37095,72683,35644,37134,72778,50971
2563,25,ปราจีนบุรี,2509,อำเภอศรีมโหสถ,6505,6748,13253,6510,6755,13265,6358
2563,25,ปราจีนบุรี,2587,ท้องถิ่นเทศบาลตำบลโคกมะกอก,1037,1143,2180,1040,1145,2185,813
2563,25,ปราจีนบุรี,2588,ท้องถิ่นเทศบาลตำบลโคกปีบ,2790,3077,5867,2804,3088,5892,2308
2563,25,ปราจีนบุรี,2589,ท้องถิ่นเทศบาลตำบลศรีมหาโพธิ,1764,1871,3635,1766,1873,3639,2408
2563,25,ปราจีนบุรี,2590,ท้องถิ่นเทศบาลตำบลกรอกสมบูรณ์,1728,1753,3481,1728,1753,3481,1272
2563,25,ปราจีนบุรี,2591,ท้องถิ่นเทศบาลตำบลประจันตคาม,2147,2387,4534,2148,2388,4536,2367
2563,25,ปราจีนบุรี,2592,ท้องถิ่นเทศบาลตำบลบ้านสร้าง,1587,1646,3233,1595,1654,3249,1616
2563,25,ปราจีนบุรี,2593,ท้องถิ่นเทศบาลตำบลนาดี,3891,4005,7896,3900,4022,7922,3306
2563,25,ปราจีนบุรี,2594,ท้องถิ่นเทศบาลตำบลสระบัว,898,933,1831,901,938,1839,631
2563,25,ปราจีนบุรี,2595,ท้องถิ่นเทศบาลตำบลเมืองเก่า,3095,3256,6351,3232,3352,6584,4423
2563,25,ปราจีนบุรี,2596,ท้องถิ่นเทศบาลตำบลบ้านนาปรือ,1122,1115,2237,1124,1115,2239,783
2563,25,ปราจีนบุรี,2598,ท้องถิ่นเทศบาลตำบลกบินทร์,1768,2062,3830,1772,2065,3837,2193
2563,25,ปราจีนบุรี,2599,ท้องถิ่นเทศบาลเมืองปราจีนบุรี,7705,8889,16594,7740,8911,16651,8879
2563,26,นครนายก,2601,อำเภอเมืองนครนายก,42221,42201,84422,42248,42220,84468,33854
2563,26,นครนายก,2602,อำเภอปากพลี,10855,11547,22402,10858,11554,22412,8471
2563,26,นครนายก,2603,อำเภอบ้านนา,32184,32175,64359,32267,32244,64511,23901
2563,26,นครนายก,2604,อำเภอองครักษ์,30373,31340,61713,30701,31637,62338,21977
2563,26,นครนายก,2695,ท้องถิ่นเทศบาลตำบลองครักษ์,1215,1295,2510,1272,1366,2638,1296
2563,26,นครนายก,2696,ท้องถิ่นเทศบาลตำบลบ้านนา,2314,2600,4914,2336,2609,4945,2489
2563,26,นครนายก,2697,ท้องถิ่นเทศบาลตำบลเกาะหวาย,846,955,1801,850,956,1806,748
2563,26,นครนายก,2698,ท้องถิ่นเทศบาลตำบลท่าช้าง,483,485,968,483,485,968,332
2563,26,นครนายก,2699,ท้องถิ่นเทศบาลเมืองนครนายก,7392,8217,15609,7612,8383,15995,8479
2563,27,สระแก้ว,2701,อำเภอเมืองสระแก้ว,43448,42916,86364,43535,43005,86540,29275
2563,27,สระแก้ว,2702,อำเภอคลองหาด,19441,19366,38807,19475,19410,38885,13477
2563,27,สระแก้ว,2703,อำเภอตาพระยา,27208,26962,54170,27359,27226,54585,16009
2563,27,สระแก้ว,2704,อำเภอวังน้ำเย็น,20286,20163,40449,20356,20215,40571,14995
2563,27,สระแก้ว,2705,อำเภอวัฒนานคร,38391,37898,76289,38494,38006,76500,26653
2563,27,สระแก้ว,2706,อำเภออรัญประเทศ,36064,36933,72997,36420,37651,74071,35808
2563,27,สระแก้ว,2707,อำเภอเขาฉกรรจ์,25430,25337,50767,25487,25369,50856,16118
2563,27,สระแก้ว,2708,อำเภอโคกสูง,13413,13557,26970,13509,13727,27236,8277
2563,27,สระแก้ว,2709,อำเภอวังสมบูรณ์,12700,12622,25322,12721,12655,25376,10312
2563,27,สระแก้ว,2791,ท้องถิ่นเทศบาลตำบลวังสมบูรณ์,5276,5418,10694,5286,5434,10720,5020
2563,27,สระแก้ว,2792,ท้องถิ่นเทศบาลตำบลเขาฉกรรจ์,2356,2417,4773,2396,2446,4842,2309
2563,27,สระแก้ว,2793,ท้องถิ่นเทศบาลตำบลวัฒนานคร,2697,3098,5795,2700,3104,5804,3038
2563,27,สระแก้ว,2794,ท้องถิ่นเทศบาลเมืองวังน้ำเย็น,10026,10625,20651,10084,10662,20746,9717
2563,27,สระแก้ว,2795,ท้องถิ่นเทศบาลตำบลตาพระยา,1294,1328,2622,1307,1337,2644,1145
2563,27,สระแก้ว,2796,ท้องถิ่นเทศบาลตำบลศาลาลำดวน,1282,1321,2603,1286,1325,2611,1186
2563,27,สระแก้ว,2797,ท้องถิ่นเทศบาลตำบลท่าเกษม,1708,1898,3606,1710,1901,3611,1602
2563,27,สระแก้ว,2798,ท้องถิ่นเทศบาลเมืองอรัญญประเทศ,8537,7363,15900,9051,7913,16964,11256
2563,27,สระแก้ว,2799,ท้องถิ่นเทศบาลเมืองสระแก้ว,8709,9415,18124,8841,9522,18363,11424
2563,30,นครราชสีมา,3001,อำเภอเมืองนครราชสีมา,109902,120841,230743,110227,120949,231176,109748
2563,30,นครราชสีมา,3002,อำเภอครบุรี,39712,40668,80380,39761,40681,80442,30259
2563,30,นครราชสีมา,3003,อำเภอเสิงสาง,28206,28624,56830,28282,28676,56958,17130
2563,30,นครราชสีมา,3004,อำเภอคง,36707,37713,74420,36744,37734,74478,21133
2563,30,นครราชสีมา,3005,อำเภอบ้านเหลื่อม,8561,8688,17249,8569,8691,17260,5060
2563,30,นครราชสีมา,3006,อำเภอจักราช,33659,33843,67502,33687,33853,67540,19156
2563,30,นครราชสีมา,3007,อำเภอโชคชัย,24052,25546,49598,24083,25552,49635,18937
2563,30,นครราชสีมา,3008,อำเภอด่านขุนทด,54096,55406,109502,54124,55422,109546,34385
2563,30,นครราชสีมา,3009,อำเภอโนนไทย,26874,27901,54775,26888,27909,54797,16641
2563,30,นครราชสีมา,3010,อำเภอโนนสูง,41710,43419,85129,41749,43431,85180,24870
2563,30,นครราชสีมา,3011,อำเภอขามสะแกแสง,16618,16694,33312,16643,16697,33340,9774
2563,30,นครราชสีมา,3012,อำเภอบัวใหญ่,33850,33765,67615,33876,33784,67660,18938
2563,30,นครราชสีมา,3013,อำเภอประทาย,35493,35913,71406,35512,35927,71439,19243
2563,30,นครราชสีมา,3014,อำเภอปักธงชัย,45158,47361,92519,45193,47375,92568,32039
2563,30,นครราชสีมา,3015,อำเภอพิมาย,59199,61100,120299,59273,61133,120406,38785
2563,30,นครราชสีมา,3016,อำเภอห้วยแถลง,35311,34995,70306,35320,35007,70327,19280
2563,30,นครราชสีมา,3017,อำเภอชุมพวง,36816,37136,73952,36844,37152,73996,19968
2563,30,นครราชสีมา,3018,อำเภอสูงเนิน,35300,36985,72285,35331,37001,72332,29210
2563,30,นครราชสีมา,3019,อำเภอขามทะเลสอ,12644,13187,25831,12656,13191,25847,8360
2563,30,นครราชสีมา,3020,อำเภอสีคิ้ว,42915,43500,86415,42948,43524,86472,31766
2563,30,นครราชสีมา,3021,อำเภอปากช่อง,61438,62508,123946,61707,62712,124419,66800
2563,30,นครราชสีมา,3022,อำเภอหนองบุญมาก,30107,30632,60739,30150,30643,60793,18389
2563,30,นครราชสีมา,3023,อำเภอแก้งสนามนาง,18323,18499,36822,18330,18505,36835,10673
2563,30,นครราชสีมา,3024,อำเภอโนนแดง,10239,10670,20909,10243,10676,20919,5555
2563,30,นครราชสีมา,3025,อำเภอวังน้ำเขียว,21584,21705,43289,21619,21730,43349,19004
2563,30,นครราชสีมา,3026,อำเภอเทพารักษ์,12764,12530,25294,12771,12534,25305,8445
2563,30,นครราชสีมา,3027,อำเภอเมืองยาง,9947,9748,19695,9951,9755,19706,5457
2563,30,นครราชสีมา,3028,อำเภอพระทองคำ,18181,18442,36623,18198,18450,36648,12012
2563,30,นครราชสีมา,3029,อำเภอลำทะเมนชัย,13964,14102,28066,13971,14108,28079,7481
2563,30,นครราชสีมา,3030,อำเภอบัวลาย,10733,10821,21554,10742,10826,21568,6354
2563,30,นครราชสีมา,3031,อำเภอสีดา,10036,10093,20129,10043,10096,20139,5855
2563,30,นครราชสีมา,3032,อำเภอเฉลิมพระเกียรติ,15147,15831,30978,15156,15836,30992,9361
2563,30,นครราชสีมา,3037,ท้องถิ่นเทศบาลตำบลเมืองยาง,4035,4092,8127,4036,4095,8131,2287
2563,30,นครราชสีมา,3038,ท้องถิ่นเทศบาลตำบลหนองน้ำใส,6632,6626,13258,6638,6629,13267,4973
2563,30,นครราชสีมา,3039,ท้องถิ่นเทศบาลตำบลด่านคล้า,4192,4358,8550,4197,4358,8555,2567
2563,30,นครราชสีมา,3040,ท้องถิ่นเทศบาลตำบลใหม่,6317,6418,12735,6325,6421,12746,3472
2563,30,นครราชสีมา,3041,ท้องถิ่นเทศบาลตำบลหนองบัวตะเกียด,4268,4510,8778,4269,4512,8781,2640
2563,30,นครราชสีมา,3042,ท้องถิ่นเทศบาลตำบลบัลลังก์,3898,3916,7814,3903,3918,7821,2436
2563,30,นครราชสีมา,3043,ท้องถิ่นเทศบาลตำบลหนองไข่น้ำ,3091,3070,6161,3094,3070,6164,1802
2563,30,นครราชสีมา,3044,ท้องถิ่นเทศบาลตำบลท่าเยี่ยม,5528,5678,11206,5533,5678,11211,5332
2563,30,นครราชสีมา,3045,ท้องถิ่นเทศบาลตำบลสีมามงคล,4460,4491,8951,4471,4494,8965,4221
2563,30,นครราชสีมา,3046,ท้องถิ่นเทศบาลตำบลลำนางแก้ว,2364,2389,4753,2365,2391,4756,1373
2563,30,นครราชสีมา,3047,ท้องถิ่นเทศบาลตำบลดอนหวาย,1713,1891,3604,1714,1892,3606,1278
2563,30,นครราชสีมา,3048,ท้องถิ่นเทศบาลตำบลหมูสี,6561,6649,13210,6599,6676,13275,11414
2563,30,นครราชสีมา,3049,ท้องถิ่นเทศบาลตำบลโพธิ์กลาง,15374,13907,29281,15391,13917,29308,13214
2563,30,นครราชสีมา,3050,ท้องถิ่นเทศบาลตำบลหัวทะเล,13195,14485,27680,13232,14508,27740,13551
2563,30,นครราชสีมา,3051,ท้องถิ่นเทศบาลตำบลวังไทร,5613,5800,11413,5627,5804,11431,4986
2563,30,นครราชสีมา,3052,ท้องถิ่นเทศบาลตำบลปรุใหญ่,4695,5132,9827,4706,5134,9840,5106
2563,30,นครราชสีมา,3053,ท้องถิ่นเทศบาลตำบลหนองไผ่ล้อม,11242,4664,15906,11245,4668,15913,11289
2563,30,นครราชสีมา,3054,ท้องถิ่นเทศบาลตำบลท่าช้าง,2415,2603,5018,2418,2603,5021,2056
2563,30,นครราชสีมา,3055,ท้องถิ่นเทศบาลตำบลสีดา,1790,1833,3623,1791,1838,3629,1425
2563,30,นครราชสีมา,3056,ท้องถิ่นเทศบาลตำบลหนองบัวลาย,1227,1239,2466,1229,1241,2470,855
2563,30,นครราชสีมา,3057,ท้องถิ่นเทศบาลตำบลหนองบัววง,2286,2335,4621,2288,2335,4623,1814
2563,30,นครราชสีมา,3058,ท้องถิ่นเทศบาลตำบลพระทองคำ,1994,2083,4077,1999,2085,4084,1637
2563,30,นครราชสีมา,3059,ท้องถิ่นเทศบาลตำบลศาลเจ้าพ่อ,909,1022,1931,910,1023,1933,950
2563,30,นครราชสีมา,3060,ท้องถิ่นเทศบาลตำบลโนนแดง,2101,2210,4311,2104,2214,4318,1561
2563,30,นครราชสีมา,3061,ท้องถิ่นเทศบาลตำบลกลางดง,2459,2554,5013,2462,2559,5021,2665
2563,30,นครราชสีมา,3062,ท้องถิ่นเทศบาลเมืองสีคิ้ว,7846,8788,16634,7868,8818,16686,9365
2563,30,นครราชสีมา,3063,ท้องถิ่นเทศบาลตำบลลาดบัวขาว,1973,2180,4153,1975,2181,4156,2204
2563,30,นครราชสีมา,3064,ท้องถิ่นเทศบาลตำบลคลองไผ่,2005,1702,3707,2017,1712,3729,1738
2563,30,นครราชสีมา,3065,ท้องถิ่นเทศบาลตำบลขามทะเลสอ,2090,2137,4227,2097,2143,4240,2128
2563,30,นครราชสีมา,3066,ท้องถิ่นเทศบาลตำบลสูงเนิน,4542,5152,9694,4627,5234,9861,6217
2563,30,นครราชสีมา,3067,ท้องถิ่นเทศบาลตำบลกุดจิก,1253,1394,2647,1253,1394,2647,1257
2563,30,นครราชสีมา,3068,ท้องถิ่นเทศบาลตำบลชุมพวง,4324,4565,8889,4328,4567,8895,3799
2563,30,นครราชสีมา,3069,ท้องถิ่นเทศบาลตำบลหินดาด,1407,1388,2795,1410,1389,2799,765
2563,30,นครราชสีมา,3070,ท้องถิ่นเทศบาลตำบลห้วยแถลง,1510,1662,3172,1513,1664,3177,1605
2563,30,นครราชสีมา,3071,ท้องถิ่นเทศบาลตำบลพิมาย,3638,4230,7868,3645,4232,7877,2888
2563,30,นครราชสีมา,3072,ท้องถิ่นเทศบาลเมืองเมืองปัก,6369,7233,13602,6386,7254,13640,6932
2563,30,นครราชสีมา,3073,ท้องถิ่นเทศบาลตำบลตะขบ,2570,2686,5256,2571,2688,5259,1874
2563,30,นครราชสีมา,3074,ท้องถิ่นเทศบาลตำบลประทาย,2956,3137,6093,2960,3138,6098,3041
2563,30,นครราชสีมา,3075,ท้องถิ่นเทศบาลตำบลหนองหัวฟาน,2260,2284,4544,2263,2287,4550,1405
2563,30,นครราชสีมา,3076,ท้องถิ่นเทศบาลตำบลขามสะแกแสง,2441,2689,5130,2445,2689,5134,1892
2563,30,นครราชสีมา,3077,ท้องถิ่นเทศบาลตำบลมะค่า,956,981,1937,956,981,1937,586
2563,30,นครราชสีมา,3078,ท้องถิ่นเทศบาลตำบลตลาดแค,1579,1736,3315,1581,1738,3319,1313
2563,30,นครราชสีมา,3079,ท้องถิ่นเทศบาลตำบลโนนไทย,1447,1661,3108,1455,1664,3119,1374
2563,30,นครราชสีมา,3080,ท้องถิ่นเทศบาลตำบลโคกสวาย,2580,2715,5295,2582,2715,5297,1773
2563,30,นครราชสีมา,3081,ท้องถิ่นเทศบาลตำบลหนองกราด,1952,2116,4068,1957,2117,4074,1336
2563,30,นครราชสีมา,3082,ท้องถิ่นเทศบาลตำบลด่านขุนทด,2866,3227,6093,2873,3233,6106,3936
2563,30,นครราชสีมา,3083,ท้องถิ่นเทศบาลตำบลด่านเกวียน,4775,5004,9779,4776,5004,9780,4295
2563,30,นครราชสีมา,3084,ท้องถิ่นเทศบาลตำบลโชคชัย,5866,6480,12346,6037,6659,12696,5507
2563,30,นครราชสีมา,3085,ท้องถิ่นเทศบาลตำบลจักราช,1898,2172,4070,1902,2175,4077,1590
2563,30,นครราชสีมา,3086,ท้องถิ่นเทศบาลตำบลบ้านเหลื่อม,1616,1825,3441,1617,1825,3442,1204
2563,30,นครราชสีมา,3087,ท้องถิ่นเทศบาลตำบลเมืองคง,1063,1155,2218,1071,1157,2228,995
2563,30,นครราชสีมา,3088,ท้องถิ่นเทศบาลตำบลเทพาลัย,1347,1451,2798,1349,1453,2802,839
2563,30,นครราชสีมา,3089,ท้องถิ่นเทศบาลตำบลเสิงสาง,3675,3950,7625,3688,3961,7649,3158
2563,30,นครราชสีมา,3090,ท้องถิ่นเทศบาลตำบลโนนสมบูรณ์,2903,2935,5838,2911,2938,5849,1810
2563,30,นครราชสีมา,3091,ท้องถิ่นเทศบาลตำบลไทรโยง-ไชยวาล,1795,1853,3648,1801,1854,3655,1147
2563,30,นครราชสีมา,3092,ท้องถิ่นเทศบาลตำบลแชะ,2835,3245,6080,2845,3247,6092,3006
2563,30,นครราชสีมา,3093,ท้องถิ่นเทศบาลตำบลจระเข้หิน,2902,3245,6147,2905,3246,6151,2379
2563,30,นครราชสีมา,3094,ท้องถิ่นเทศบาลตำบลจอหอ,8249,8414,16663,8272,8428,16700,9676
2563,30,นครราชสีมา,3095,ท้องถิ่นเทศบาลตำบลโคกกรวด,3318,3767,7085,3350,3792,7142,4376
2563,30,นครราชสีมา,3096,ท้องถิ่นเทศบาลตำบลโนนสูง,4625,5013,9638,4633,5016,9649,3967
2563,30,นครราชสีมา,3097,ท้องถิ่นเทศบาลเมืองบัวใหญ่,6447,7023,13470,6474,7031,13505,7067
2563,30,นครราชสีมา,3098,ท้องถิ่นเทศบาลเมืองปากช่อง,15620,17555,33175,15887,17813,33700,18716
2563,30,นครราชสีมา,3099,ท้องถิ่นเทศบาลนครนครราชสีมา,56777,65151,121928,57205,65525,122730,72081
2563,31,บุรีรัมย์,3101,อำเภอเมืองบุรีรัมย์,86812,87130,173942,86985,87196,174181,52417
2563,31,บุรีรัมย์,3102,อำเภอคูเมือง,29662,29528,59190,29716,29555,59271,16135
2563,31,บุรีรัมย์,3103,อำเภอกระสัง,50148,51329,101477,50240,51370,101610,26184
2563,31,บุรีรัมย์,3104,อำเภอนางรอง,45863,47207,93070,45899,47231,93130,26187
2563,31,บุรีรัมย์,3105,อำเภอหนองกี่,28748,28433,57181,28778,28441,57219,15337
2563,31,บุรีรัมย์,3106,อำเภอละหานทราย,9759,9677,19436,9786,9684,19470,5707
2563,31,บุรีรัมย์,3107,อำเภอประโคนชัย,62318,62726,125044,62413,62784,125197,35969
2563,31,บุรีรัมย์,3108,อำเภอบ้านกรวด,20437,20628,41065,20533,20658,41191,11296
2563,31,บุรีรัมย์,3109,อำเภอพุทไธสง,20417,21326,41743,20427,21333,41760,12159
2563,31,บุรีรัมย์,3110,อำเภอลำปลายมาศ,57284,57446,114730,57352,57473,114825,30838
2563,31,บุรีรัมย์,3111,อำเภอสตึก,49326,49537,98863,49371,49549,98920,27026
2563,31,บุรีรัมย์,3112,อำเภอปะคำ,19237,19191,38428,19260,19197,38457,11766
2563,31,บุรีรัมย์,3113,อำเภอนาโพธิ์,14137,14456,28593,14153,14467,28620,7900
2563,31,บุรีรัมย์,3114,อำเภอหนองหงส์,17926,17592,35518,17933,17596,35529,9319
2563,31,บุรีรัมย์,3115,อำเภอพลับพลาชัย,14121,13614,27735,14162,13620,27782,7056
2563,31,บุรีรัมย์,3116,อำเภอห้วยราช,16076,16315,32391,16106,16319,32425,8164
2563,31,บุรีรัมย์,3117,อำเภอโนนสุวรรณ,10924,10934,21858,10931,10936,21867,6329
2563,31,บุรีรัมย์,3118,อำเภอชำนิ,17657,17704,35361,17680,17714,35394,9058
2563,31,บุรีรัมย์,3119,อำเภอบ้านใหม่ไชยพจน์,10969,11246,22215,10979,11254,22233,6043
2563,31,บุรีรัมย์,3120,อำเภอโนนดินแดง,9430,9247,18677,9458,9259,18717,5713
2563,31,บุรีรัมย์,3121,อำเภอบ้านด่าน,9275,9533,18808,9291,9536,18827,4555
2563,31,บุรีรัมย์,3122,อำเภอแคนดง,13336,13521,26857,13356,13529,26885,7327
2563,31,บุรีรัมย์,3123,อำเภอเฉลิมพระเกียรติ,6012,6042,12054,6019,6050,12069,3489
2563,31,บุรีรัมย์,3162,ท้องถิ่นเทศบาลตำบลจันดุม,5213,5309,10522,5224,5314,10538,2916
2563,31,บุรีรัมย์,3163,ท้องถิ่นเทศบาลตำบลห้วยหิน,4850,4890,9740,4852,4890,9742,2569
2563,31,บุรีรัมย์,3164,ท้องถิ่นเทศบาลตำบลสำโรงใหม่,6333,6328,12661,6343,6333,12676,3711
2563,31,บุรีรัมย์,3165,ท้องถิ่นเทศบาลตำบลจันทบเพชร,3891,3923,7814,3914,3928,7842,2377
2563,31,บุรีรัมย์,3166,ท้องถิ่นเทศบาลตำบลหนองแวง,8478,8316,16794,8485,8322,16807,4175
2563,31,บุรีรัมย์,3167,ท้องถิ่นเทศบาลตำบลหนองไม้งาม,5048,5034,10082,5064,5035,10099,2880
2563,31,บุรีรัมย์,3168,ท้องถิ่นเทศบาลตำบลบ้านกรวดปัญญาวัฒน์,4634,4664,9298,4658,4666,9324,2677
2563,31,บุรีรัมย์,3169,ท้องถิ่นเทศบาลตำบลบ้านด่าน,5869,6134,12003,5891,6134,12025,3271
2563,31,บุรีรัมย์,3170,ท้องถิ่นเทศบาลตำบลถาวร,3805,3839,7644,3812,3841,7653,2175
2563,31,บุรีรัมย์,3171,ท้องถิ่นเทศบาลตำบลยายแย้มวัฒนา,4337,4297,8634,4342,4300,8642,2316
2563,31,บุรีรัมย์,3172,ท้องถิ่นเทศบาลตำบลอิสาณ,10001,11063,21064,10046,11070,21116,12564
2563,31,บุรีรัมย์,3174,ท้องถิ่นเทศบาลตำบลศาลเจ้าพ่อขุนศรี,1667,1699,3366,1668,1700,3368,1273
2563,31,บุรีรัมย์,3175,ท้องถิ่นเทศบาลตำบลตาจง,8339,8218,16557,8355,8229,16584,4309
2563,31,บุรีรัมย์,3176,ท้องถิ่นเทศบาลตำบลพนมรุ้ง,5722,6105,11827,5729,6107,11836,3849
2563,31,บุรีรัมย์,3177,ท้องถิ่นเทศบาลตำบลแคนดง,2747,2763,5510,2753,2764,5517,1885
2563,31,บุรีรัมย์,3178,ท้องถิ่นเทศบาลตำบลโนนดินแดง,4657,4848,9505,4689,4856,9545,3576
2563,31,บุรีรัมย์,3179,ท้องถิ่นเทศบาลตำบลบ้านใหม่ไชยพจน์,2097,2196,4293,2105,2198,4303,1405
2563,31,บุรีรัมย์,3180,ท้องถิ่นเทศบาลตำบลโนนสุวรรณ,1626,1690,3316,1628,1691,3319,1065
2563,31,บุรีรัมย์,3181,ท้องถิ่นเทศบาลตำบลห้วยราช,2510,2576,5086,2515,2579,5094,1382
2563,31,บุรีรัมย์,3182,ท้องถิ่นเทศบาลตำบลพลับพลาชัย,3341,3275,6616,3350,3276,6626,1938
2563,31,บุรีรัมย์,3183,ท้องถิ่นเทศบาลตำบลหนองหงส์,2368,2375,4743,2372,2376,4748,1715
2563,31,บุรีรัมย์,3184,ท้องถิ่นเทศบาลตำบลนาโพธิ์,1767,1902,3669,1770,1903,3673,1636
2563,31,บุรีรัมย์,3185,ท้องถิ่นเทศบาลตำบลปะคำ,3514,3611,7125,3517,3613,7130,2730
2563,31,บุรีรัมย์,3186,ท้องถิ่นเทศบาลตำบลสตึก,5292,5686,10978,5319,5698,11017,5570
2563,31,บุรีรัมย์,3187,ท้องถิ่นเทศบาลเมืองลำปลายมาศ,6407,6927,13334,6420,6938,13358,6141
2563,31,บุรีรัมย์,3188,ท้องถิ่นเทศบาลตำบลทะเมนชัย,2174,2205,4379,2175,2206,4381,1247
2563,31,บุรีรัมย์,3189,ท้องถิ่นเทศบาลตำบลพุทไธสง,2025,2223,4248,2027,2225,4252,2239
2563,31,บุรีรัมย์,3190,ท้องถิ่นเทศบาลตำบลบ้านกรวด,1935,2002,3937,1952,2003,3955,1953
2563,31,บุรีรัมย์,3191,ท้องถิ่นเทศบาลตำบลตลาดนิคมปราสาท,2313,2455,4768,2328,2456,4784,1726
2563,31,บุรีรัมย์,3192,ท้องถิ่นเทศบาลเมืองประโคนชัย,4550,5089,9639,4558,5092,9650,4083
2563,31,บุรีรัมย์,3193,ท้องถิ่นเทศบาลตำบลละหานทราย,4155,4124,8279,4169,4131,8300,3379
2563,31,บุรีรัมย์,3194,ท้องถิ่นเทศบาลตำบลหนองกี่,4749,5073,9822,4753,5081,9834,4111
2563,31,บุรีรัมย์,3195,ท้องถิ่นเทศบาลตำบลกระสัง,1593,1778,3371,1611,1787,3398,1797
2563,31,บุรีรัมย์,3196,ท้องถิ่นเทศบาลตำบลหินเหล็กไฟ,2504,2549,5053,2506,2550,5056,1803
2563,31,บุรีรัมย์,3197,ท้องถิ่นเทศบาลตำบลคูเมือง,1801,1785,3586,1804,1788,3592,1939
2563,31,บุรีรัมย์,3198,ท้องถิ่นเทศบาลเมืองนางรอง,9743,10950,20693,9768,10966,20734,11298
2563,31,บุรีรัมย์,3199,ท้องถิ่นเทศบาลนครบุรีรัมย์,11871,13131,25002,11922,13165,25087,14464
2563,32,สุรินทร์,3201,อำเภอเมืองสุรินทร์,107611,109655,217266,107881,109736,217617,75576
2563,32,สุรินทร์,3202,อำเภอชุมพลบุรี,34541,34272,68813,34554,34287,68841,18659
2563,32,สุรินทร์,3203,อำเภอท่าตูม,45994,45738,91732,46021,45774,91795,23399
2563,32,สุรินทร์,3204,อำเภอจอมพระ,27407,27257,54664,27416,27268,54684,13851
2563,32,สุรินทร์,3205,อำเภอปราสาท,71218,72844,144062,71369,72881,144250,41680
2563,32,สุรินทร์,3206,อำเภอกาบเชิง,30071,29915,59986,30107,29930,60037,18484
2563,32,สุรินทร์,3207,อำเภอรัตนบุรี,43356,43580,86936,43378,43599,86977,22625
2563,32,สุรินทร์,3208,อำเภอสนม,19435,19192,38627,19450,19199,38649,10610
2563,32,สุรินทร์,3209,อำเภอศีขรภูมิ,64690,65552,130242,64719,65575,130294,32352
2563,32,สุรินทร์,3210,อำเภอสังขะ,63833,63141,126974,63891,63153,127044,34340
2563,32,สุรินทร์,3211,อำเภอลำดวน,13383,13418,26801,13395,13423,26818,7043
2563,32,สุรินทร์,3212,อำเภอสำโรงทาบ,25257,25088,50345,25262,25092,50354,11752
2563,32,สุรินทร์,3213,อำเภอบัวเชด,17778,17135,34913,17797,17143,34940,9695
2563,32,สุรินทร์,3214,อำเภอพนมดงรัก,19201,18735,37936,19254,18755,38009,12246
2563,32,สุรินทร์,3215,อำเภอศรีณรงค์,23580,23239,46819,23591,23244,46835,11511
2563,32,สุรินทร์,3216,อำเภอเขวาสินรินทร์,16991,17390,34381,17012,17401,34413,9954
2563,32,สุรินทร์,3217,อำเภอโนนนารายณ์,17405,17576,34981,17408,17580,34988,8548
2563,32,สุรินทร์,3286,ท้องถิ่นเทศบาลตำบลบัวเชด,3197,3290,6487,3199,3291,6490,2381
2563,32,สุรินทร์,3287,ท้องถิ่นเทศบาลตำบลสำโรงทาบ,1155,1197,2352,1159,1197,2356,1248
2563,32,สุรินทร์,3288,ท้องถิ่นเทศบาลตำบลลำดวนสุรพินท์,2079,2256,4335,2086,2259,4345,1852
2563,32,สุรินทร์,3289,ท้องถิ่นเทศบาลตำบลสังขะ,1784,2061,3845,1785,2065,3850,2274
2563,32,สุรินทร์,3290,ท้องถิ่นเทศบาลตำบลศีขรภูมิ,2236,2449,4685,2241,2454,4695,2782
2563,32,สุรินทร์,3291,ท้องถิ่นเทศบาลตำบลสนม,2448,2574,5022,2453,2576,5029,1589
2563,32,สุรินทร์,3292,ท้องถิ่นเทศบาลตำบลรัตนบุรี,2595,2795,5390,2598,2798,5396,2681
2563,32,สุรินทร์,3293,ท้องถิ่นเทศบาลตำบลนิคมปราสาท,1329,1353,2682,1331,1354,2685,849
2563,32,สุรินทร์,3294,ท้องถิ่นเทศบาลตำบลกังแอน,2678,3024,5702,2699,3028,5727,3380
2563,32,สุรินทร์,3295,ท้องถิ่นเทศบาลตำบลจอมพระ,1964,2179,4143,1970,2180,4150,1916
2563,32,สุรินทร์,3296,ท้องถิ่นเทศบาลตำบลท่าตูม,1982,2102,4084,1986,2105,4091,1797
2563,32,สุรินทร์,3297,ท้องถิ่นเทศบาลตำบลชุมพลบุรี,1104,1232,2336,1106,1234,2340,1085
2563,32,สุรินทร์,3298,ท้องถิ่นเทศบาลตำบลเมืองที,958,944,1902,960,945,1905,559
2563,32,สุรินทร์,3299,ท้องถิ่นเทศบาลเมืองสุรินทร์,17561,20772,38333,17722,20895,38617,17172
2563,33,ศรีสะเกษ,3301,อำเภอเมืองศรีสะเกษ,42743,44376,87119,42760,44397,87157,26287
2563,33,ศรีสะเกษ,3302,อำเภอยางชุมน้อย,14934,14764,29698,14937,14767,29704,7510
2563,33,ศรีสะเกษ,3303,อำเภอกันทรารมย์,46628,46868,93496,46643,46880,93523,24121
2563,33,ศรีสะเกษ,3304,อำเภอกันทรลักษ์,91842,91566,183408,91997,91708,183705,51006
2563,33,ศรีสะเกษ,3305,อำเภอขุขันธ์,72162,72958,145120,72242,73014,145256,35222
2563,33,ศรีสะเกษ,3306,อำเภอไพรบึง,18176,18476,36652,18179,18477,36656,9050
2563,33,ศรีสะเกษ,3307,อำเภอปรางค์กู่,31643,31877,63520,31663,31890,63553,15074
2563,33,ศรีสะเกษ,3308,อำเภอขุนหาญ,34307,34674,68981,34364,34709,69073,18032
2563,33,ศรีสะเกษ,3309,อำเภอราษีไศล,37806,38006,75812,37825,38018,75843,19997
2563,33,ศรีสะเกษ,3310,อำเภออุทุมพรพิสัย,50890,51528,102418,50923,51551,102474,26147
2563,33,ศรีสะเกษ,3311,อำเภอบึงบูรพ์,2185,2191,4376,2186,2191,4377,1080
2563,33,ศรีสะเกษ,3312,อำเภอห้วยทับทัน,19493,19388,38881,19508,19395,38903,8920
2563,33,ศรีสะเกษ,3313,อำเภอโนนคูณ,19828,19588,39416,19838,19595,39433,10878
2563,33,ศรีสะเกษ,3314,อำเภอศรีรัตนะ,24143,24388,48531,24158,24393,48551,11513
2563,33,ศรีสะเกษ,3315,อำเภอน้ำเกลี้ยง,22422,21880,44302,22441,21888,44329,11191
2563,33,ศรีสะเกษ,3316,อำเภอวังหิน,20195,19840,40035,20211,19857,40068,9432
2563,33,ศรีสะเกษ,3317,อำเภอภูสิงห์,27523,27114,54637,27536,27130,54666,15810
2563,33,ศรีสะเกษ,3318,อำเภอเมืองจันทร์,9016,8812,17828,9019,8818,17837,4356
2563,33,ศรีสะเกษ,3319,อำเภอเบญจลักษ์,18108,17847,35955,18112,17849,35961,9173
2563,33,ศรีสะเกษ,3320,อำเภอพยุห์,15464,15805,31269,15470,15809,31279,8184
2563,33,ศรีสะเกษ,3321,อำเภอโพธิ์ศรีสุวรรณ,11891,11820,23711,11897,11829,23726,5621
2563,33,ศรีสะเกษ,3322,อำเภอศิลาลาด,9977,9804,19781,9979,9809,19788,5297
2563,33,ศรีสะเกษ,3381,ท้องถิ่นเทศบาลตำบลบุสูง,5199,5072,10271,5206,5075,10281,2769
2563,33,ศรีสะเกษ,3382,ท้องถิ่นเทศบาลตำบลกันทรอม,4583,4425,9008,4585,4426,9011,2236
2563,33,ศรีสะเกษ,3383,ท้องถิ่นเทศบาลตำบลกระหวัน,4349,4463,8812,4352,4467,8819,2196
2563,33,ศรีสะเกษ,3384,ท้องถิ่นเทศบาลตำบลน้ำคำ,5176,5340,10516,5178,5341,10519,3000
2563,33,ศรีสะเกษ,3385,ท้องถิ่นเทศบาลตำบลโพธิ์กระสังข์,4623,4573,9196,4623,4575,9198,2048
2563,33,ศรีสะเกษ,3386,ท้องถิ่นเทศบาลตำบลพยุห์,1940,1973,3913,1941,1973,3914,1401
2563,33,ศรีสะเกษ,3387,ท้องถิ่นเทศบาลตำบลศรีรัตนะ,2324,2387,4711,2327,2387,4714,1454
2563,33,ศรีสะเกษ,3388,ท้องถิ่นเทศบาลตำบลห้วยทับทัน,1698,1630,3328,1698,1630,3328,1053
2563,33,ศรีสะเกษ,3389,ท้องถิ่นเทศบาลตำบลบึงบูรพ์,3002,3156,6158,3004,3157,6161,1803
2563,33,ศรีสะเกษ,3390,ท้องถิ่นเทศบาลตำบลกำแพง,1301,1393,2694,1306,1399,2705,1327
2563,33,ศรีสะเกษ,3391,ท้องถิ่นเทศบาลตำบลเมืองคง,1942,2037,3979,1946,2038,3984,2101
2563,33,ศรีสะเกษ,3392,ท้องถิ่นเทศบาลตำบลขุนหาญ,5343,5492,10835,5362,5494,10856,3718
2563,33,ศรีสะเกษ,3393,ท้องถิ่นเทศบาลตำบลปรางค์กู่,1338,1398,2736,1339,1399,2738,1204
2563,33,ศรีสะเกษ,3394,ท้องถิ่นเทศบาลตำบลไพรบึง,5451,5435,10886,5454,5436,10890,2883
2563,33,ศรีสะเกษ,3395,ท้องถิ่นเทศบาลตำบลเมืองขุขันธ์,2118,2246,4364,2122,2247,4369,2167
2563,33,ศรีสะเกษ,3396,ท้องถิ่นเทศบาลเมืองกันทรลักษ์,8554,9174,17728,8590,9193,17783,7510
2563,33,ศรีสะเกษ,3397,ท้องถิ่นเทศบาลตำบลกันทรารมย์,2929,3143,6072,2937,3145,6082,3182
2563,33,ศรีสะเกษ,3398,ท้องถิ่นเทศบาลตำบลยางชุมน้อย,3126,3204,6330,3127,3207,6334,2387
2563,33,ศรีสะเกษ,3399,ท้องถิ่นเทศบาลเมืองศรีสะเกษ,19234,21648,40882,19321,21711,41032,20750
2563,34,อุบลราชธานี,3401,อำเภอเมืองอุบลราชธานี,47054,48390,95444,47165,48438,95603,35139
2563,34,อุบลราชธานี,3402,อำเภอศรีเมืองใหม่,33490,32912,66402,33632,33137,66769,19181
2563,34,อุบลราชธานี,3403,อำเภอโขงเจียม,17645,16967,34612,17976,17532,35508,10010
2563,34,อุบลราชธานี,3404,อำเภอเขื่องใน,50950,51864,102814,50981,51887,102868,27748
2563,34,อุบลราชธานี,3405,อำเภอเขมราฐ,15681,15452,31133,15823,15783,31606,8945
2563,34,อุบลราชธานี,3407,อำเภอเดชอุดม,66161,65349,131510,66198,65369,131567,49666
2563,34,อุบลราชธานี,3408,อำเภอนาจะหลวย,25997,25363,51360,26029,25392,51421,17704
2563,34,อุบลราชธานี,3409,อำเภอน้ำยืน,31007,30162,61169,31034,30185,61219,20534
2563,34,อุบลราชธานี,3410,อำเภอบุณฑริก,39109,37908,77017,39413,38304,77717,24339
2563,34,อุบลราชธานี,3411,อำเภอตระการพืชผล,56586,56010,112596,56649,56087,112736,29495
2563,34,อุบลราชธานี,3412,อำเภอกุดข้าวปุ้น,18393,18394,36787,18400,18408,36808,9457
2563,34,อุบลราชธานี,3414,อำเภอม่วงสามสิบ,40822,40699,81521,40852,40729,81581,22566
2563,34,อุบลราชธานี,3415,อำเภอวารินชำราบ,45834,46400,92234,45916,46457,92373,30328
2563,34,อุบลราชธานี,3419,อำเภอพิบูลมังสาหาร,52454,51556,104010,52558,51696,104254,33966
2563,34,อุบลราชธานี,3420,อำเภอตาลสุม,15140,14708,29848,15152,14720,29872,8232
2563,34,อุบลราชธานี,3421,อำเภอโพธิ์ไทร,22312,21425,43737,22552,21820,44372,11799
2563,34,อุบลราชธานี,3422,อำเภอสำโรง,27116,27032,54148,27124,27035,54159,14544
2563,34,อุบลราชธานี,3424,อำเภอดอนมดแดง,13704,13515,27219,13717,13530,27247,7897
2563,34,อุบลราชธานี,3425,อำเภอสิรินธร,21849,20901,42750,22038,21230,43268,14327
2563,34,อุบลราชธานี,3426,อำเภอทุ่งศรีอุดม,14769,14422,29191,14774,14428,29202,8957
2563,34,อุบลราชธานี,3429,อำเภอนาเยีย,10801,10086,20887,10807,10090,20897,7056
2563,34,อุบลราชธานี,3430,อำเภอนาตาล,18984,18745,37729,19238,19180,38418,11183
2563,34,อุบลราชธานี,3431,อำเภอเหล่าเสือโก้ก,14041,13905,27946,14055,13909,27964,7797
2563,34,อุบลราชธานี,3432,อำเภอสว่างวีระวงศ์,15629,15510,31139,15646,15527,31173,9133
2563,34,อุบลราชธานี,3433,อำเภอน้ำขุ่น,16795,16456,33251,16812,16461,33273,10832
2563,34,อุบลราชธานี,3463,ท้องถิ่นเทศบาลตำบลกุดชมภู,5879,5799,11678,5903,5839,11742,4337
2563,34,อุบลราชธานี,3464,ท้องถิ่นเทศบาลตำบลคำน้ำแซบ,3967,4031,7998,3982,4037,8019,3144
2563,34,อุบลราชธานี,3465,ท้องถิ่นเทศบาลตำบลหัวนา,6561,6675,13236,6586,6698,13284,3512
2563,34,อุบลราชธานี,3466,ท้องถิ่นเทศบาลตำบลโพนงาม,4492,4582,9074,4495,4582,9077,3155
2563,34,อุบลราชธานี,3467,ท้องถิ่นเทศบาลตำบลเมืองศรีไค,3010,3145,6155,3015,3146,6161,3367
2563,34,อุบลราชธานี,3468,ท้องถิ่นเทศบาลตำบลหนองผือ,4860,5050,9910,4866,5070,9936,3348
2563,34,อุบลราชธานี,3469,ท้องถิ่นเทศบาลตำบลขามป้อม,4795,4661,9456,4828,4735,9563,3156
2563,34,อุบลราชธานี,3470,ท้องถิ่นเทศบาลเมืองเทพวงศา,5849,5644,11493,6007,5926,11933,4039
2563,34,อุบลราชธานี,3471,ท้องถิ่นเทศบาลตำบลปทุม,4969,5525,10494,4995,5540,10535,4099
2563,34,อุบลราชธานี,3472,ท้องถิ่นเทศบาลตำบลคอแลน,6613,6403,13016,6681,6534,13215,4084
2563,34,อุบลราชธานี,3473,ท้องถิ่น ทต.นิคมสร้างตนเองลำโดมน้อย,3869,3841,7710,3904,3892,7796,2865
2563,34,อุบลราชธานี,3474,ท้องถิ่นเทศบาลตำบลกุดประทาย,6905,6707,13612,6908,6714,13622,5015
2563,34,อุบลราชธานี,3475,ท้องถิ่นเทศบาลตำบลขามใหญ่,18499,20365,38864,18642,20404,39046,19877
2563,34,อุบลราชธานี,3476,ท้องถิ่นเทศบาลตำบลแสนสุข,13578,11092,24670,13626,11111,24737,10917
2563,34,อุบลราชธานี,3477,ท้องถิ่นเทศบาลตำบลนาเยีย,3208,3312,6520,3210,3313,6523,1833
2563,34,อุบลราชธานี,3478,ท้องถิ่นเทศบาลตำบลช่องเม็ก,1799,1773,3572,1822,1872,3694,1879
2563,34,อุบลราชธานี,3479,ท้องถิ่นเทศบาลตำบลโพธิ์ไทร,1504,1550,3054,1507,1551,3058,1169
2563,34,อุบลราชธานี,3480,ท้องถิ่นเทศบาลตำบลตาลสุม,1604,1633,3237,1604,1633,3237,1066
2563,34,อุบลราชธานี,3481,ท้องถิ่นเทศบาลตำบลอ่างศิลา,1490,1617,3107,1491,1618,3109,1006
2563,34,อุบลราชธานี,3482,ท้องถิ่นเทศบาลตำบลห้วยขะยุง,1547,1634,3181,1551,1634,3185,973
2563,34,อุบลราชธานี,3483,ท้องถิ่นเทศบาลตำบลม่วงสามสิบ,1491,1635,3126,1496,1637,3133,1586
2563,34,อุบลราชธานี,3484,ท้องถิ่นเทศบาลตำบลกุดข้าวปุ้น,2098,2034,4132,2100,2036,4136,1454
2563,34,อุบลราชธานี,3485,ท้องถิ่นเทศบาลตำบลตระการพืชผล,4414,4615,9029,4426,4627,9053,4307
2563,34,อุบลราชธานี,3486,ท้องถิ่นเทศบาลตำบลบุณฑริก,2192,2255,4447,2194,2261,4455,2064
2563,34,อุบลราชธานี,3487,ท้องถิ่นเทศบาลตำบลน้ำยืน,4488,4543,9031,4490,4546,9036,3378
2563,34,อุบลราชธานี,3488,ท้องถิ่นเทศบาลตำบลนาจะหลวย,3654,3634,7288,3668,3638,7306,2637
2563,34,อุบลราชธานี,3489,ท้องถิ่นเทศบาลเมืองเดชอุดม,6423,6948,13371,6435,6959,13394,6578
2563,34,อุบลราชธานี,3490,ท้องถิ่นเทศบาลตำบลบัวงาม,3381,3357,6738,3382,3358,6740,1854
2563,34,อุบลราชธานี,3491,ท้องถิ่นเทศบาลตำบลนาส่วง,1519,1627,3146,1520,1629,3149,985
2563,34,อุบลราชธานี,3492,ท้องถิ่นเทศบาลตำบลเขมราฐ,2851,3021,5872,2882,3103,5985,2486
2563,34,อุบลราชธานี,3493,ท้องถิ่นเทศบาลตำบลเขื่องใน,2215,2329,4544,2215,2332,4547,2053
2563,34,อุบลราชธานี,3494,ท้องถิ่นเทศบาลตำบลบ้านด่านโขงเจียม,1414,1325,2739,1469,1446,2915,1304
2563,34,อุบลราชธานี,3495,ท้องถิ่นเทศบาลตำบลศรีเมืองใหม่,2093,2095,4188,2097,2103,4200,1908
2563,34,อุบลราชธานี,3496,ท้องถิ่นเทศบาลตำบลอุบล,2634,3121,5755,2657,3123,5780,3098
2563,34,อุบลราชธานี,3497,ท้องถิ่นเทศบาลเมืองพิบูลมังสาหาร,5052,5421,10473,5066,5434,10500,4517
2563,34,อุบลราชธานี,3498,ท้องถิ่นเทศบาลเมืองวารินชำราบ,12292,13806,26098,12334,13832,26166,10885
2563,34,อุบลราชธานี,3499,ท้องถิ่นเทศบาลนครอุบลราชธานี,33447,38734,72181,33805,39050,72855,32040
2563,35,ยโสธร,3501,อำเภอเมืองยโสธร,54364,53660,108024,54417,53685,108102,38332
2563,35,ยโสธร,3502,อำเภอทรายมูล,12318,12289,24607,12329,12296,24625,7810
2563,35,ยโสธร,3503,อำเภอกุดชุม,30982,30467,61449,30996,30479,61475,19532
2563,35,ยโสธร,3504,อำเภอคำเขื่อนแก้ว,31050,30926,61976,31071,30941,62012,19019
2563,35,ยโสธร,3505,อำเภอป่าติ้ว,15961,15997,31958,15973,16002,31975,9993
2563,35,ยโสธร,3506,อำเภอมหาชนะชัย,25761,25728,51489,25769,25742,51511,14271
2563,35,ยโสธร,3507,อำเภอค้อวัง,10293,10415,20708,10296,10420,20716,5407
2563,35,ยโสธร,3508,อำเภอเลิงนกทา,44461,44742,89203,44491,44771,89262,28249
2563,35,ยโสธร,3509,อำเภอไทยเจริญ,15173,15246,30419,15181,15252,30433,10206
2563,35,ยโสธร,3591,ท้องถิ่นเทศบาลตำบลสามแยก,1898,1987,3885,1903,1987,3890,2204
2563,35,ยโสธร,3592,ท้องถิ่นเทศบาลตำบลเลิงนกทา,1434,1528,2962,1435,1529,2964,1083
2563,35,ยโสธร,3593,ท้องถิ่นเทศบาลตำบลค้อวัง,2204,2299,4503,2206,2299,4505,1608
2563,35,ยโสธร,3594,ท้องถิ่นเทศบาลตำบลฟ้าหยาด,2322,2424,4746,2322,2429,4751,1842
2563,35,ยโสธร,3595,ท้องถิ่นเทศบาลตำบลป่าติ้ว,1508,1563,3071,1511,1563,3074,1209
2563,35,ยโสธร,3596,ท้องถิ่นเทศบาลตำบลคำเขื่อนแก้ว,1899,1956,3855,1901,1956,3857,1547
2563,35,ยโสธร,3597,ท้องถิ่นเทศบาลตำบลกุดชุมพัฒนา,2367,2476,4843,2370,2476,4846,2162
2563,35,ยโสธร,3598,ท้องถิ่นเทศบาลตำบลทรายมูล,3046,3220,6266,3047,3223,6270,2094
2563,35,ยโสธร,3599,ท้องถิ่นเทศบาลเมืองยโสธร,9772,10421,20193,9798,10434,20232,9098
2563,36,ชัยภูมิ,3601,อำเภอเมืองชัยภูมิ,66883,69877,136760,66973,69912,136885,53889
2563,36,ชัยภูมิ,3602,อำเภอบ้านเขว้า,20897,21355,42252,20905,21365,42270,14558
2563,36,ชัยภูมิ,3603,อำเภอคอนสวรรค์,23912,24325,48237,23938,24336,48274,17836
2563,36,ชัยภูมิ,3604,อำเภอเกษตรสมบูรณ์,42516,42884,85400,42556,42899,85455,24976
2563,36,ชัยภูมิ,3605,อำเภอหนองบัวแดง,46567,46281,92848,46669,46333,93002,29387
2563,36,ชัยภูมิ,3606,อำเภอจัตุรัส,33155,35128,68283,33183,35138,68321,24667
2563,36,ชัยภูมิ,3607,อำเภอบำเหน็จณรงค์,20105,20563,40668,20128,20574,40702,13399
2563,36,ชัยภูมิ,3608,อำเภอหนองบัวระเหว,16414,16205,32619,16433,16210,32643,11481
2563,36,ชัยภูมิ,3609,อำเภอเทพสถิต,33011,32439,65450,33070,32451,65521,23676
2563,36,ชัยภูมิ,3610,อำเภอภูเขียว,53550,55099,108649,53664,55127,108791,35086
2563,36,ชัยภูมิ,3611,อำเภอบ้านแท่น,20379,20711,41090,20393,20716,41109,11591
2563,36,ชัยภูมิ,3612,อำเภอแก้งคร้อ,36338,36437,72775,36357,36448,72805,24951
2563,36,ชัยภูมิ,3613,อำเภอคอนสาร,20316,20587,40903,20337,20596,40933,13892
2563,36,ชัยภูมิ,3614,อำเภอภักดีชุมพล,15617,15243,30860,15655,15270,30925,11996
2563,36,ชัยภูมิ,3615,อำเภอเนินสง่า,12836,13129,25965,12842,13135,25977,8428
2563,36,ชัยภูมิ,3616,อำเภอซับใหญ่,7876,7645,15521,7886,7649,15535,5631
2563,36,ชัยภูมิ,3653,สาขาตำบลวังชมภู หนองบัวแดง,0,0,0,0,0,0,0
2563,36,ชัยภูมิ,3676,ท้องถิ่นเทศบาลตำบลห้วยยาง,7753,7696,15449,7760,7702,15462,4582
2563,36,ชัยภูมิ,3677,ท้องถิ่นเทศบาลตำบลบ้านเดื่อ,7695,7826,15521,7698,7827,15525,4496
2563,36,ชัยภูมิ,3680,ท้องถิ่นเทศบาลตำบลคอนสาร,2021,2217,4238,2024,2218,4242,1428
2563,36,ชัยภูมิ,3681,ท้องถิ่นเทศบาลตำบลแก้งคร้อ,4082,4534,8616,4088,4538,8626,4508
2563,36,ชัยภูมิ,3682,ท้องถิ่นเทศบาลตำบลนาหนองทุ่ม,5259,5629,10888,5263,5629,10892,3278
2563,36,ชัยภูมิ,3683,ท้องถิ่นเทศบาลตำบลบ้านแท่น,1989,2076,4065,1991,2076,4067,1614
2563,36,ชัยภูมิ,3684,ท้องถิ่นเทศบาลตำบลภูเขียว,2895,3339,6234,2909,3343,6252,3015
2563,36,ชัยภูมิ,3685,ท้องถิ่นเทศบาลตำบลบ้านเพชรภูเขียว,2775,2853,5628,2780,2855,5635,1733
2563,36,ชัยภูมิ,3686,ท้องถิ่นเทศบาลตำบลเทพสถิต,1910,1924,3834,1916,1926,3842,2261
2563,36,ชัยภูมิ,3687,ท้องถิ่นเทศบาลตำบลหนองบัวระเหว,2924,2977,5901,2931,2980,5911,2599
2563,36,ชัยภูมิ,3688,ท้องถิ่นเทศบาลตำบลบำเหน็จณรงค์,3346,3624,6970,3352,3625,6977,2964
2563,36,ชัยภูมิ,3689,ท้องถิ่นเทศบาลตำบลบ้านเพชร,2392,2514,4906,2397,2518,4915,2204
2563,36,ชัยภูมิ,3690,ท้องถิ่นเทศบาลตำบลหนองบัวโคก,985,1013,1998,986,1013,1999,782
2563,36,ชัยภูมิ,3691,ท้องถิ่นเทศบาลตำบลจัตุรัส,1957,2199,4156,1961,2201,4162,2187
2563,36,ชัยภูมิ,3692,ท้องถิ่นเทศบาลตำบลหนองบัวแดง,4345,4506,8851,4358,4514,8872,4207
2563,36,ชัยภูมิ,3693,ท้องถิ่นเทศบาลตำบลบ้านเป้า,3784,3935,7719,3786,3936,7722,2329
2563,36,ชัยภูมิ,3694,ท้องถิ่นเทศบาลตำบลเกษตรสมบูรณ์,1400,1548,2948,1404,1552,2956,1313
2563,36,ชัยภูมิ,3695,ท้องถิ่นเทศบาลตำบลคอนสวรรค์,1993,2251,4244,2005,2252,4257,1885
2563,36,ชัยภูมิ,3696,ท้องถิ่นเทศบาลตำบลบ้านเขว้า,3815,4210,8025,3818,4211,8029,3360
2563,36,ชัยภูมิ,3697,ท้องถิ่นเทศบาลตำบลลาดใหญ่,2163,2418,4581,2165,2419,4584,1736
2563,36,ชัยภูมิ,3698,ท้องถิ่นเทศบาลตำบลบ้านค่ายหมื่นแผ้ว,2405,2534,4939,2413,2535,4948,1894
2563,36,ชัยภูมิ,3699,ท้องถิ่นเทศบาลเมืองชัยภูมิ,16986,18826,35812,17051,18850,35901,20764
2563,37,อำนาจเจริญ,3701,อำเภอเมืองอำนาจเจริญ,48579,48412,96991,48644,48458,97102,30848
2563,37,อำนาจเจริญ,3702,อำเภอชานุมาน,19256,19043,38299,19386,19263,38649,11613
2563,37,อำนาจเจริญ,3703,อำเภอปทุมราชวงศา,22927,22575,45502,22937,22579,45516,13382
2563,37,อำนาจเจริญ,3704,อำเภอพนา,9657,9502,19159,9659,9503,19162,6545
2563,37,อำนาจเจริญ,3705,อำเภอเสนางคนิคม,17383,17642,35025,17402,17658,35060,10446
2563,37,อำนาจเจริญ,3706,อำเภอหัวตะพาน,21213,21095,42308,21221,21121,42342,10842
2563,37,อำนาจเจริญ,3707,อำเภอลืออำนาจ,16974,17247,34221,16980,17253,34233,9604
2563,37,อำนาจเจริญ,3790,ท้องถิ่นเทศบาลตำบลนายม,2591,2646,5237,2593,2650,5243,1542
2563,37,อำนาจเจริญ,3791,ท้องถิ่นเทศบาลตำบลพระเหลา,3016,3037,6053,3019,3037,6056,2144
2563,37,อำนาจเจริญ,3792,ท้องถิ่นเทศบาลตำบลอำนาจ,989,1137,2126,989,1138,2127,959
2563,37,อำนาจเจริญ,3793,ท้องถิ่นเทศบาลตำบลหัวตะพาน,3315,3459,6774,3318,3465,6783,2166
2563,37,อำนาจเจริญ,3794,ท้องถิ่นเทศบาลตำบลเสนางคนิคม,2791,2961,5752,2796,2967,5763,1950
2563,37,อำนาจเจริญ,3795,ท้องถิ่นเทศบาลตำบลพนา,1291,1441,2732,1293,1441,2734,1104
2563,37,อำนาจเจริญ,3796,ท้องถิ่นเทศบาลตำบลปทุมราชวงศา,1722,1759,3481,1722,1760,3482,1694
2563,37,อำนาจเจริญ,3797,ท้องถิ่นเทศบาลตำบลชานุมาน,1490,1594,3084,1535,1665,3200,1420
2563,37,อำนาจเจริญ,3798,ท้องถิ่นเทศบาลตำบลน้ำปลีก,1817,1957,3774,1823,1958,3781,1234
2563,37,อำนาจเจริญ,3799,ท้องถิ่นเทศบาลเมืองอำนาจเจริญ,11955,12944,24899,11992,12970,24962,12695
2563,38,บึงกาฬ,3801,อำเภอเมืองบึงกาฬ,29384,29108,58492,29466,29194,58660,18487
2563,38,บึงกาฬ,3802,อำเภอพรเจริญ,14527,14335,28862,14535,14337,28872,8037
2563,38,บึงกาฬ,3803,อำเภอโซ่พิสัย,32691,32276,64967,32715,32296,65011,19008
2563,38,บึงกาฬ,3804,อำเภอเซกา,36848,36247,73095,36919,36286,73205,22627
2563,38,บึงกาฬ,3805,อำเภอปากคาด,14059,13987,28046,14089,14008,28097,9535
2563,38,บึงกาฬ,3806,อำเภอบึงโขงหลง,13998,13821,27819,14043,13851,27894,8821
2563,38,บึงกาฬ,3807,อำเภอศรีวิไล,14553,14341,28894,14558,14347,28905,9469
2563,38,บึงกาฬ,3808,อำเภอบุ่งคล้า,6977,6937,13914,7001,7011,14012,4176
2563,38,บึงกาฬ,3887,ท้องถิ่นเทศบาลตำบลหอคำ,3634,3603,7237,3640,3606,7246,2304
2563,38,บึงกาฬ,3888,ท้องถิ่นเทศบาลตำบลโนนสว่าง,3412,3491,6903,3414,3492,6906,2342
2563,38,บึงกาฬ,3889,ท้องถิ่นเทศบาลตำบลวิศิษฐ์,0,0,0,0,0,0,0
2563,38,บึงกาฬ,3890,ท้องถิ่นเทศบาลตำบลศรีวิไล,5533,5550,11083,5539,5551,11090,3835
2563,38,บึงกาฬ,3891,ท้องถิ่นเทศบาลตำบลบึงโขงหลง,4823,4926,9749,4847,4930,9777,3335
2563,38,บึงกาฬ,3892,ท้องถิ่นเทศบาลตำบลปากคาด,3349,3341,6690,3355,3344,6699,2701
2563,38,บึงกาฬ,3893,ท้องถิ่นเทศบาลตำบลศรีพนา,3292,3328,6620,3305,3330,6635,2664
2563,38,บึงกาฬ,3894,ท้องถิ่นเทศบาลตำบลท่าสะอาด,3400,3488,6888,3402,3495,6897,1993
2563,38,บึงกาฬ,3895,ท้องถิ่นเทศบาลตำบลโซ่พิสัย,3295,3306,6601,3304,3311,6615,2558
2563,38,บึงกาฬ,3896,ท้องถิ่นเทศบาลตำบลพรเจริญ,5048,5268,10316,5056,5279,10335,3484
2563,38,บึงกาฬ,3897,ท้องถิ่นเทศบาลตำบลดอนหญ้านาง,2539,2582,5121,2541,2583,5124,1484
2563,38,บึงกาฬ,3898,ท้องถิ่นเทศบาลเมืองบึงกาฬ,9905,10077,19982,9944,10118,20062,11011
2563,39,หนองบัวลำภู,3901,อำเภอเมืองหนองบัวลำภู,51116,50874,101990,51202,50904,102106,30604
2563,39,หนองบัวลำภู,3902,อำเภอนากลาง,33596,33238,66834,33642,33247,66889,18437
2563,39,หนองบัวลำภู,3903,อำเภอโนนสัง,26863,27175,54038,26889,27184,54073,13567
2563,39,หนองบัวลำภู,3904,อำเภอศรีบุญเรือง,45557,44865,90422,45618,44876,90494,24946
2563,39,หนองบัวลำภู,3905,อำเภอสุวรรณคูหา,26918,26751,53669,26950,26763,53713,14997
2563,39,หนองบัวลำภู,3906,อำเภอนาวัง,15222,15215,30437,15246,15226,30472,8631
2563,39,หนองบัวลำภู,3986,ท้องถิ่นเทศบาลตำบลยางหล่อ,4599,4670,9269,4600,4673,9273,2557
2563,39,หนองบัวลำภู,3987,ท้องถิ่นเทศบาลตำบลนาเหล่า,3368,3551,6919,3378,3553,6931,2420
2563,39,หนองบัวลำภู,3988,ท้องถิ่นเทศบาลตำบลสุวรรณคูหา,3801,3974,7775,3813,3976,7789,2825
2563,39,หนองบัวลำภู,3989,ท้องถิ่นเทศบาลตำบลบ้านโคก,2996,3295,6291,3003,3297,6300,1865
2563,39,หนองบัวลำภู,3990,ท้องถิ่นเทศบาลตำบลโนนสูงเปลือย,2264,2469,4733,2274,2473,4747,2603
2563,39,หนองบัวลำภู,3991,ท้องถิ่นเทศบาลตำบลจอมทอง,2543,2468,5011,2548,2470,5018,1509
2563,39,หนองบัวลำภู,3992,ท้องถิ่นเทศบาลตำบลโนนสัง,4130,4274,8404,4145,4277,8422,2768
2563,39,หนองบัวลำภู,3993,ท้องถิ่นเทศบาลตำบลกุดดู่,1381,1381,2762,1386,1381,2767,739
2563,39,หนองบัวลำภู,3994,ท้องถิ่นเทศบาลตำบลนากลาง,9924,10262,20186,9947,10266,20213,6601
2563,39,หนองบัวลำภู,3995,ท้องถิ่นเทศบาลตำบลกุดดินจี่,2768,2866,5634,2775,2866,5641,1812
2563,39,หนองบัวลำภู,3996,ท้องถิ่นเทศบาลตำบลหัวนา,1831,1795,3626,1835,1795,3630,1031
2563,39,หนองบัวลำภู,3997,ท้องถิ่นเทศบาลตำบลนามะเฟือง,1996,2142,4138,2002,2143,4145,1081
2563,39,หนองบัวลำภู,3998,ท้องถิ่นเทศบาลตำบลนาคำไฮ,2470,2516,4986,2479,2518,4997,1427
2563,39,หนองบัวลำภู,3999,ท้องถิ่นเทศบาลเมืองหนองบัวลำภู,10453,11321,21774,10499,11351,21850,11941
2563,40,ขอนแก่น,4001,อำเภอเมืองขอนแก่น,72708,75529,148237,72947,75580,148527,65099
2563,40,ขอนแก่น,4002,อำเภอบ้านฝาง,25050,25290,50340,25087,25297,50384,16942
2563,40,ขอนแก่น,4003,อำเภอพระยืน,12154,12707,24861,12172,12710,24882,7547
2563,40,ขอนแก่น,4004,อำเภอหนองเรือ,41441,42381,83822,41471,42394,83865,22879
2563,40,ขอนแก่น,4005,อำเภอชุมแพ,41899,41763,83662,41978,41774,83752,25542
2563,40,ขอนแก่น,4006,อำเภอสีชมพู,36784,37310,74094,36840,37320,74160,22189
2563,40,ขอนแก่น,4007,อำเภอน้ำพอง,36553,37005,73558,36583,37026,73609,21950
2563,40,ขอนแก่น,4008,อำเภออุบลรัตน์,15539,15923,31462,15559,15932,31491,8186
2563,40,ขอนแก่น,4009,อำเภอกระนวน,33886,34281,68167,33935,34286,68221,20068
2563,40,ขอนแก่น,4010,อำเภอบ้านไผ่,35892,36430,72322,35928,36436,72364,22582
2563,40,ขอนแก่น,4011,อำเภอเปือยน้อย,7182,7019,14201,7187,7022,14209,3802
2563,40,ขอนแก่น,4012,อำเภอพล,37526,38307,75833,37553,38320,75873,22503
2563,40,ขอนแก่น,4013,อำเภอแวงใหญ่,11996,12203,24199,12002,12212,24214,6363
2563,40,ขอนแก่น,4014,อำเภอแวงน้อย,19328,19458,38786,19341,19463,38804,11268
2563,40,ขอนแก่น,4015,อำเภอหนองสองห้อง,35284,35727,71011,35319,35745,71064,20412
2563,40,ขอนแก่น,4016,อำเภอภูเวียง,34255,34641,68896,34289,34652,68941,20205
2563,40,ขอนแก่น,4017,อำเภอมัญจาคีรี,33174,33672,66846,33200,33679,66879,21379
2563,40,ขอนแก่น,4018,อำเภอชนบท,19607,20274,39881,19627,20279,39906,11520
2563,40,ขอนแก่น,4019,อำเภอเขาสวนกวาง,10690,10743,21433,10709,10744,21453,6333
2563,40,ขอนแก่น,4020,อำเภอภูผาม่าน,9864,9792,19656,9873,9796,19669,5806
2563,40,ขอนแก่น,4021,อำเภอซำสูง,8991,9230,18221,8996,9233,18229,5226
2563,40,ขอนแก่น,4022,อำเภอโคกโพธิ์ไชย,10575,10551,21126,10584,10558,21142,6523
2563,40,ขอนแก่น,4023,อำเภอหนองนาคำ,11798,11964,23762,11812,11968,23780,6631
2563,40,ขอนแก่น,4024,อำเภอบ้านแฮด,12903,13161,26064,12912,13169,26081,8231
2563,40,ขอนแก่น,4025,อำเภอโนนศิลา,10484,10532,21016,10486,10534,21020,6383
2563,40,ขอนแก่น,4029,อำเภอเวียงเก่า,9903,10094,19997,9909,10095,20004,5597
2563,40,ขอนแก่น,4055,ท้องถิ่นเทศบาลตำบลโคกสูง,4515,4333,8848,4536,4338,8874,2418
2563,40,ขอนแก่น,4056,ท้องถิ่นเทศบาลตำบลสะอาด,4978,5012,9990,4983,5014,9997,2670
2563,40,ขอนแก่น,4057,ท้องถิ่นเทศบาลเมืองบ้านทุ่ม,8947,9613,18560,8981,9623,18604,8064
2563,40,ขอนแก่น,4058,ท้องถิ่นเทศบาลตำบลโนนสมบูรณ์,2946,2975,5921,2949,2976,5925,1759
2563,40,ขอนแก่น,4060,ท้องถิ่นเทศบาลตำบลม่วงหวาน,5052,5194,10246,5059,5195,10254,3491
2563,40,ขอนแก่น,4061,ท้องถิ่นเทศบาลตำบลหนองตูม,3728,3982,7710,3736,3984,7720,2191
2563,40,ขอนแก่น,4062,ท้องถิ่นเทศบาลตำบลเมืองเก่า,14322,16488,30810,14491,16505,30996,17037
2563,40,ขอนแก่น,4063,ท้องถิ่นเทศบาลตำบลโนนท่อน,4840,4975,9815,4842,4977,9819,3104
2563,40,ขอนแก่น,4064,ท้องถิ่นเทศบาลตำบลบ้านค้อ,8352,8559,16911,8364,8563,16927,6665
2563,40,ขอนแก่น,4065,ท้องถิ่นเทศบาลตำบลกุดน้ำใส,4155,4306,8461,4167,4316,8483,2551
2563,40,ขอนแก่น,4067,ท้องถิ่นเทศบาลตำบลสาวะถี,8931,9206,18137,8950,9217,18167,5624
2563,40,ขอนแก่น,4068,ท้องถิ่นเทศบาลเมืองบ้านเป็ด,20931,24070,45001,21162,24104,45266,26853
2563,40,ขอนแก่น,4069,ท้องถิ่นเทศบาลตำบลโนนศิลา,2825,2772,5597,2825,2775,5600,1781
2563,40,ขอนแก่น,4070,ท้องถิ่นเทศบาลตำบลบ้านแฮด,3308,3390,6698,3311,3392,6703,2234
2563,40,ขอนแก่น,4071,ท้องถิ่นเทศบาลตำบลบ้านโคก,1983,2142,4125,1984,2143,4127,1424
2563,40,ขอนแก่น,4072,ท้องถิ่นเทศบาลตำบลซำสูง,2576,2698,5274,2579,2700,5279,1907
2563,40,ขอนแก่น,4073,ท้องถิ่นเทศบาลตำบลภูผาม่าน,1700,1786,3486,1701,1787,3488,1276
2563,40,ขอนแก่น,4074,ท้องถิ่นเทศบาลตำบลเขาสวนกวาง,5370,5433,10803,5384,5441,10825,3633
2563,40,ขอนแก่น,4075,ท้องถิ่นเทศบาลตำบลชนบท,3789,4248,8037,3794,4249,8043,3299
2563,40,ขอนแก่น,4076,ท้องถิ่นเทศบาลตำบลมัญจาคีรี,1703,1903,3606,1708,1906,3614,1919
2563,40,ขอนแก่น,4077,ท้องถิ่นเทศบาลตำบลภูเวียง,1430,1562,2992,1435,1564,2999,1728
2563,40,ขอนแก่น,4078,ท้องถิ่นเทศบาลตำบลหนองสองห้อง,2905,2974,5879,2912,2978,5890,2737
2563,40,ขอนแก่น,4079,ท้องถิ่นเทศบาลตำบลแวงน้อย,1468,1603,3071,1468,1604,3072,1303
2563,40,ขอนแก่น,4080,ท้องถิ่นเทศบาลตำบลแวงใหญ่,2475,2661,5136,2481,2661,5142,1744
2563,40,ขอนแก่น,4081,ท้องถิ่นเทศบาลตำบลเปือยน้อย,2870,3026,5896,2875,3027,5902,1976
2563,40,ขอนแก่น,4082,ท้องถิ่นเทศบาลเมืองกระนวน,4794,5217,10011,4823,5223,10046,4505
2563,40,ขอนแก่น,4083,ท้องถิ่นเทศบาลตำบลเขื่อนอุบลรัตน์,2002,2078,4080,2010,2079,4089,2075
2563,40,ขอนแก่น,4084,ท้องถิ่นเทศบาลตำบลวังชัย,3101,3326,6427,3109,3327,6436,2871
2563,40,ขอนแก่น,4085,ท้องถิ่นเทศบาลตำบลน้ำพอง,2378,2561,4939,2386,2564,4950,2433
2563,40,ขอนแก่น,4086,ท้องถิ่นเทศบาลตำบลสีชมพู,1659,1724,3383,1668,1725,3393,1539
2563,40,ขอนแก่น,4087,ท้องถิ่นเทศบาลตำบลโนนหัน,2217,2455,4672,2224,2457,4681,1525
2563,40,ขอนแก่น,4088,ท้องถิ่นเทศบาลตำบลโคกสูงสัมพันธ์,2058,2306,4364,2071,2306,4377,1301
2563,40,ขอนแก่น,4089,ท้องถิ่นเทศบาลตำบลหนองเรือ,2149,2132,4281,2157,2136,4293,2133
2563,40,ขอนแก่น,4090,ท้องถิ่นเทศบาลตำบลหนองแก,716,716,1432,717,718,1435,690
2563,40,ขอนแก่น,4091,ท้องถิ่นเทศบาลตำบลดอนโมง,1699,1767,3466,1705,1769,3474,1804
2563,40,ขอนแก่น,4092,ท้องถิ่นเทศบาลตำบลพระยืน,1584,1726,3310,1586,1730,3316,1455
2563,40,ขอนแก่น,4093,ท้องถิ่นเทศบาลตำบลบ้านโต้น,3122,3379,6501,3130,3380,6510,2013
2563,40,ขอนแก่น,4094,ท้องถิ่นเทศบาลตำบลบ้านฝาง,2236,2358,4594,2258,2373,4631,1820
2563,40,ขอนแก่น,4095,ท้องถิ่นเทศบาลตำบลท่าพระ,4247,4679,8926,4269,4684,8953,4036
2563,40,ขอนแก่น,4096,ท้องถิ่นเทศบาลเมืองชุมแพ,14793,16002,30795,14946,16046,30992,15429
2563,40,ขอนแก่น,4097,ท้องถิ่นเทศบาลเมืองบ้านไผ่,13017,14170,27187,13224,14273,27497,12697
2563,40,ขอนแก่น,4098,ท้องถิ่นเทศบาลเมืองเมืองพล,5038,5547,10585,5047,5557,10604,5403
2563,40,ขอนแก่น,4099,ท้องถิ่นเทศบาลนครขอนแก่น,51557,58062,109619,52156,58459,110615,66498
2563,41,อุดรธานี,4101,อำเภอเมืองอุดรธานี,89637,93806,183443,90115,93893,184008,69678
2563,41,อุดรธานี,4102,อำเภอกุดจับ,21897,21755,43652,21977,21776,43753,13104
2563,41,อุดรธานี,4103,อำเภอหนองวัวซอ,22455,22388,44843,22508,22399,44907,11579
2563,41,อุดรธานี,4104,อำเภอกุมภวาปี,36857,37482,74339,36930,37506,74436,21462
2563,41,อุดรธานี,4105,อำเภอโนนสะอาด,22614,22702,45316,22648,22715,45363,11984
2563,41,อุดรธานี,4106,อำเภอหนองหาน,44369,44317,88686,44438,44349,88787,26880
2563,41,อุดรธานี,4107,อำเภอทุ่งฝน,12650,12359,25009,12686,12368,25054,7163
2563,41,อุดรธานี,4108,อำเภอไชยวาน,11997,11746,23743,12015,11750,23765,5985
2563,41,อุดรธานี,4109,อำเภอศรีธาตุ,11779,11912,23691,11788,11915,23703,6619
2563,41,อุดรธานี,4110,อำเภอวังสามหมอ,15844,15596,31440,15850,15606,31456,8641
2563,41,อุดรธานี,4111,อำเภอบ้านดุง,55823,55584,111407,55952,55624,111576,32445
2563,41,อุดรธานี,4117,อำเภอบ้านผือ,51098,51031,102129,51148,51062,102210,30683
2563,41,อุดรธานี,4118,อำเภอน้ำโสม,20827,20310,41137,20865,20335,41200,13191
2563,41,อุดรธานี,4119,อำเภอเพ็ญ,48125,48180,96305,48207,48210,96417,29169
2563,41,อุดรธานี,4120,อำเภอสร้างคอม,10951,10903,21854,10967,10911,21878,6482
2563,41,อุดรธานี,4121,อำเภอหนองแสง,11611,11656,23267,11655,11661,23316,6715
2563,41,อุดรธานี,4122,อำเภอนายูง,14469,14168,28637,14482,14174,28656,9643
2563,41,อุดรธานี,4123,อำเภอพิบูลย์รักษ์,12241,12380,24621,12257,12388,24645,8259
2563,41,อุดรธานี,4124,อำเภอกู่แก้ว,11105,10982,22087,11123,10987,22110,6778
2563,41,อุดรธานี,4125,อำเภอประจักษ์ศิลปาคม,12766,12757,25523,12804,12768,25572,7193
2563,41,อุดรธานี,4158,ท้องถิ่นเทศบาลตำบลหนองหว้า,4063,4102,8165,4072,4102,8174,2014
2563,41,อุดรธานี,4159,ท้องถิ่นเทศบาลตำบลหัวนาคำ,5773,5583,11356,5774,5585,11359,3153
2563,41,อุดรธานี,4160,ท้องถิ่นเทศบาลตำบลผาสุก,8061,7763,15824,8071,7770,15841,4714
2563,41,อุดรธานี,4161,ท้องถิ่นเทศบาลตำบลโพนสูง,3748,3654,7402,3748,3654,7402,1855
2563,41,อุดรธานี,4162,ท้องถิ่นเทศบาลตำบลจำปี,4158,4048,8206,4160,4050,8210,2172
2563,41,อุดรธานี,4163,ท้องถิ่นเทศบาลตำบลสร้างคอม,3628,3753,7381,3633,3756,7389,2597
2563,41,อุดรธานี,4164,ท้องถิ่นเทศบาลตำบลบ้านธาตุ,8302,8566,16868,8335,8585,16920,5103
2563,41,อุดรธานี,4165,ท้องถิ่นเทศบาลตำบลเวียงคำ,5200,5281,10481,5207,5283,10490,3190
2563,41,อุดรธานี,4166,ท้องถิ่นเทศบาลตำบลลำพันชาด,2819,2758,5577,2821,2758,5579,1984
2563,41,อุดรธานี,4167,ท้องถิ่นเทศบาลตำบลหนองไผ่,4644,4780,9424,4657,4786,9443,2713
2563,41,อุดรธานี,4168,ท้องถิ่นเทศบาลตำบลหนองไผ่,4079,4738,8817,4089,4742,8831,2687
2563,41,อุดรธานี,4169,ท้องถิ่นเทศบาลตำบลปะโค,5625,5648,11273,5637,5650,11287,3398
2563,41,อุดรธานี,4170,ท้องถิ่นเทศบาลตำบลแสงสว่าง,2000,2003,4003,2013,2003,4016,968
2563,41,อุดรธานี,4171,ท้องถิ่นเทศบาลตำบลเพ็ญ,1378,1402,2780,1382,1403,2785,1578
2563,41,อุดรธานี,4172,ท้องถิ่นเทศบาลตำบลน้ำโสม,4253,4416,8669,4254,4417,8671,2547
2563,41,อุดรธานี,4173,ท้องถิ่นเทศบาลตำบลนางัว,4483,4601,9084,4500,4605,9105,3410
2563,41,อุดรธานี,4174,ท้องถิ่นเทศบาลตำบลบ้านผือ,3665,3906,7571,3677,3921,7598,4025
2563,41,อุดรธานี,4175,ท้องถิ่นเทศบาลเมืองบ้านดุง,7380,7994,15374,7435,8016,15451,6278
2563,41,อุดรธานี,4176,ท้องถิ่นเทศบาลตำบลวังสามหมอ,2930,3070,6000,2933,3072,6005,2798
2563,41,อุดรธานี,4177,ท้องถิ่นเทศบาลตำบลศรีธาตุ,2681,2750,5431,2683,2750,5433,1880
2563,41,อุดรธานี,4178,ท้องถิ่นเทศบาลตำบลไชยวาน,4042,4246,8288,4049,4248,8297,2351
2563,41,อุดรธานี,4179,ท้องถิ่นเทศบาลตำบลทุ่งฝน,3436,3768,7204,3449,3772,7221,2180
2563,41,อุดรธานี,4180,ท้องถิ่นเทศบาลตำบลหนองหาน,2012,2223,4235,2020,2228,4248,1868
2563,41,อุดรธานี,4181,ท้องถิ่นเทศบาลตำบลหนองเม็ก,4092,4136,8228,4108,4139,8247,2230
2563,41,อุดรธานี,4182,ท้องถิ่นเทศบาลตำบลบ้านเชียง,2941,2983,5924,2962,2987,5949,1960
2563,41,อุดรธานี,4183,ท้องถิ่นเทศบาลตำบลโนนสะอาด,2202,2283,4485,2205,2284,4489,1738
2563,41,อุดรธานี,4184,ท้องถิ่นเทศบาลตำบลห้วยเกิ้ง,2597,2700,5297,2608,2700,5308,1684
2563,41,อุดรธานี,4185,ท้องถิ่นเทศบาลตำบลพันดอน,2628,2909,5537,2642,2925,5567,2599
2563,41,อุดรธานี,4186,ท้องถิ่นเทศบาลตำบลกุมภวาปี,3921,4243,8164,3955,4260,8215,4457
2563,41,อุดรธานี,4187,ท้องถิ่นเทศบาลตำบลภูผาแดง,3951,4163,8114,3974,4169,8143,2338
2563,41,อุดรธานี,4188,ท้องถิ่นเทศบาลตำบลหนองวัวซอ,4677,4939,9616,4705,4943,9648,2845
2563,41,อุดรธานี,4189,ท้องถิ่นเทศบาลตำบลสร้างก่อ,1992,1960,3952,1992,1960,3952,1074
2563,41,อุดรธานี,4190,ท้องถิ่นเทศบาลตำบลตาลเลียน,1878,1840,3718,1878,1840,3718,878
2563,41,อุดรธานี,4191,ท้องถิ่นเทศบาลตำบลเชียงเพ็ง,1990,2007,3997,1992,2007,3999,1162
2563,41,อุดรธานี,4192,ท้องถิ่นเทศบาลตำบลกุดจับ,4929,5297,10226,4954,5300,10254,3849
2563,41,อุดรธานี,4193,ท้องถิ่นเทศบาลตำบลหนองบัว,15527,17165,32692,15923,17220,33143,15723
2563,41,อุดรธานี,4194,ท้องถิ่นเทศบาลเมืองหนองสำโรง,13823,14772,28595,14005,14822,28827,14844
2563,41,อุดรธานี,4195,ท้องถิ่นเทศบาลตำบลบ้านจั่น,3209,3751,6960,3261,3759,7020,3324
2563,41,อุดรธานี,4196,ท้องถิ่นเทศบาลเมืองโนนสูง-น้ำคำ,4576,3969,8545,4604,3976,8580,3542
2563,41,อุดรธานี,4197,ท้องถิ่นเทศบาลตำบลนิคมสงเคราะห์,1788,1913,3701,1801,1913,3714,1296
2563,41,อุดรธานี,4198,ท้องถิ่นเทศบาลตำบลนาข่า,3116,3311,6427,3126,3315,6441,2565
2563,41,อุดรธานี,4199,ท้องถิ่นเทศบาลนครอุดรธานี,54997,60904,115901,57398,62804,120202,61123
2563,42,เลย,4201,อำเภอเมืองเลย,29915,28985,58900,29995,29078,59073,23494
2563,42,เลย,4202,อำเภอนาด้วง,4900,4823,9723,4935,4859,9794,3584
2563,42,เลย,4203,อำเภอเชียงคาน,18758,18614,37372,19028,19196,38224,13862
2563,42,เลย,4204,อำเภอปากชม,16879,16163,33042,17077,16437,33514,11152
2563,42,เลย,4205,อำเภอด่านซ้าย,24280,23541,47821,24346,23616,47962,15892
2563,42,เลย,4206,อำเภอนาแห้ว,4819,4778,9597,4848,4812,9660,3057
2563,42,เลย,4207,อำเภอภูเรือ,9970,9550,19520,10051,9678,19729,7198
2563,42,เลย,4208,อำเภอท่าลี่,12603,12318,24921,13044,13062,26106,9926
2563,42,เลย,4209,อำเภอวังสะพุง,49824,50396,100220,49878,50439,100317,33760
2563,42,เลย,4210,อำเภอภูกระดึง,13737,13507,27244,13748,13517,27265,8669
2563,42,เลย,4211,อำเภอภูหลวง,12654,12374,25028,12663,12382,25045,7690
2563,42,เลย,4212,อำเภอผาขาว,15577,15500,31077,15589,15507,31096,8428
2563,42,เลย,4213,อำเภอเอราวัณ,17027,17038,34065,17051,17048,34099,11420
2563,42,เลย,4214,อำเภอหนองหิน,10376,10137,20513,10394,10154,20548,5998
2563,42,เลย,4279,ท้องถิ่นเทศบาลตำบลโนนปอแดง,5574,5539,11113,5583,5542,11125,3460
2563,42,เลย,4280,ท้องถิ่นเทศบาลตำบลนาดอกคำ,5045,4899,9944,5069,4933,10002,3021
2563,42,เลย,4281,ท้องถิ่นเทศบาลตำบลธาตุ,4844,4866,9710,4868,4917,9785,3364
2563,42,เลย,4282,ท้องถิ่นเทศบาลตำบลนาดินดำ,5345,5284,10629,5354,5306,10660,3665
2563,42,เลย,4283,ท้องถิ่นเทศบาลตำบลนาโป่ง,5092,5162,10254,5096,5166,10262,3452
2563,42,เลย,4284,ท้องถิ่นเทศบาลตำบลนาอาน,6240,6435,12675,6261,6447,12708,5783
2563,42,เลย,4285,ท้องถิ่นเทศบาลตำบลเขาแก้ว,3919,3849,7768,3927,3862,7789,2148
2563,42,เลย,4286,ท้องถิ่นเทศบาลตำบลหนองหิน,2187,2258,4445,2190,2259,4449,2006
2563,42,เลย,4287,ท้องถิ่นเทศบาลตำบลภูกระดึง,3594,3640,7234,3597,3640,7237,2729
2563,42,เลย,4288,ท้องถิ่นเทศบาลเมืองวังสะพุง,5284,5721,11005,5296,5731,11027,4510
2563,42,เลย,4289,ท้องถิ่นเทศบาลตำบลท่าลี่,954,1033,1987,956,1042,1998,815
2563,42,เลย,4290,ท้องถิ่นเทศบาลตำบลภูเรือ,1439,1404,2843,1456,1413,2869,1573
2563,42,เลย,4291,ท้องถิ่นเทศบาลตำบลนาแห้ว,1024,961,1985,1031,984,2015,888
2563,42,เลย,4292,ท้องถิ่นเทศบาลตำบลด่านซ้าย,1676,1739,3415,1678,1740,3418,1932
2563,42,เลย,4293,ท้องถิ่นเทศบาลตำบลปากชม,1661,1731,3392,1687,1780,3467,1540
2563,42,เลย,4294,ท้องถิ่นเทศบาลตำบลเชียงกลม,2555,2580,5135,2567,2605,5172,1609
2563,42,เลย,4295,ท้องถิ่นเทศบาลตำบลเชียงคาน,2467,2652,5119,2486,2681,5167,2751
2563,42,เลย,4296,ท้องถิ่นเทศบาลตำบลนาด้วง,3319,3336,6655,3329,3344,6673,2355
2563,42,เลย,4297,ท้องถิ่นเทศบาลตำบลน้ำสวย,1767,1811,3578,1769,1815,3584,1215
2563,42,เลย,4298,ท้องถิ่นเทศบาลตำบลนาอ้อ,2963,3127,6090,2968,3131,6099,2231
2563,42,เลย,4299,ท้องถิ่นเทศบาลเมืองเลย,10299,10382,20681,10350,10448,20798,11715
2563,43,หนองคาย,4301,อำเภอเมืองหนองคาย,36980,37527,74507,37186,37789,74975,24063
2563,43,หนองคาย,4302,อำเภอท่าบ่อ,30132,30816,60948,30242,30967,61209,18399
2563,43,หนองคาย,4305,อำเภอโพนพิสัย,47472,47730,95202,47640,47992,95632,31376
2563,43,หนองคาย,4307,อำเภอศรีเชียงใหม่,11574,11805,23379,11696,11951,23647,7346
2563,43,หนองคาย,4308,อำเภอสังคม,11262,10902,22164,11288,10948,22236,7139
2563,43,หนองคาย,4314,อำเภอสระใคร,13354,13137,26491,13374,13167,26541,8200
2563,43,หนองคาย,4315,อำเภอเฝ้าไร่,19936,19999,39935,19963,20007,39970,11424
2563,43,หนองคาย,4316,อำเภอรัตนวาปี,19052,18910,37962,19064,18926,37990,12932
2563,43,หนองคาย,4317,อำเภอโพธิ์ตาก,7636,7566,15202,7659,7625,15284,5136
2563,43,หนองคาย,4378,ท้องถิ่นเทศบาลตำบลเฝ้าไร่,5457,5476,10933,5464,5478,10942,3989
2563,43,หนองคาย,4381,ท้องถิ่นเทศบาลตำบลโพธิ์ชัย,3702,3962,7664,3718,3982,7700,3710
2563,43,หนองคาย,4382,ท้องถิ่นเทศบาลตำบลหาดคำ,4495,4552,9047,4601,4754,9355,2931
2563,43,หนองคาย,4388,ท้องถิ่นเทศบาลตำบลสังคม,1620,1685,3305,1622,1690,3312,1421
2563,43,หนองคาย,4389,ท้องถิ่นเทศบาลตำบลศรีเชียงใหม่,3118,3226,6344,3158,3267,6425,2793
2563,43,หนองคาย,4391,ท้องถิ่นเทศบาลตำบลโพนพิสัย,1316,1308,2624,1326,1324,2650,1229
2563,43,หนองคาย,4395,ท้องถิ่นเทศบาลตำบลโพนสา,1761,1983,3744,1769,2000,3769,1135
2563,43,หนองคาย,4396,ท้องถิ่นเทศบาลเมืองท่าบ่อ,8388,8827,17215,8468,8922,17390,7235
2563,43,หนองคาย,4397,ท้องถิ่นเทศบาลตำบลหนองสองห้อง,2606,2661,5267,2648,2671,5319,2051
2563,43,หนองคาย,4398,ท้องถิ่นเทศบาลตำบลเวียงคุก,2855,3095,5950,2867,3111,5978,1888
2563,43,หนองคาย,4399,ท้องถิ่นเทศบาลเมืองหนองคาย,21862,22892,44754,23070,24041,47111,24351
2563,44,มหาสารคาม,4401,อำเภอเมืองมหาสารคาม,49787,51933,101720,49872,51951,101823,35596
2563,44,มหาสารคาม,4402,อำเภอแกดำ,12264,12122,24386,12271,12124,24395,6526
2563,44,มหาสารคาม,4403,อำเภอโกสุมพิสัย,54170,55622,109792,54222,55642,109864,31504
2563,44,มหาสารคาม,4404,อำเภอกันทรวิชัย,27439,28324,55763,27465,28331,55796,16208
2563,44,มหาสารคาม,4405,อำเภอเชียงยืน,27642,28400,56042,27671,28411,56082,17915
2563,44,มหาสารคาม,4406,อำเภอบรบือ,50691,50849,101540,50725,50868,101593,34018
2563,44,มหาสารคาม,4407,อำเภอนาเชือก,28527,28608,57135,28540,28620,57160,17121
2563,44,มหาสารคาม,4408,อำเภอพยัคฆภูมิพิสัย,39572,39999,79571,39583,40009,79592,21667
2563,44,มหาสารคาม,4409,อำเภอวาปีปทุม,53409,54043,107452,53444,54062,107506,30363
2563,44,มหาสารคาม,4410,อำเภอนาดูน,16298,16336,32634,16307,16349,32656,8589
2563,44,มหาสารคาม,4411,อำเภอยางสีสุราช,17473,17656,35129,17479,17664,35143,9676
2563,44,มหาสารคาม,4412,อำเภอกุดรัง,18632,18382,37014,18647,18388,37035,10579
2563,44,มหาสารคาม,4413,อำเภอชื่นชม,12102,12486,24588,12110,12494,24604,6905
2563,44,มหาสารคาม,4487,ท้องถิ่นเทศบาลตำบลขามเรียง,6649,9844,16493,6663,9848,16511,5518
2563,44,มหาสารคาม,4488,ท้องถิ่นเทศบาลตำบลท่าขอนยาง,4248,4597,8845,4257,4601,8858,6327
2563,44,มหาสารคาม,4489,ท้องถิ่นเทศบาลตำบลนาดูน,2386,2345,4731,2388,2346,4734,1773
2563,44,มหาสารคาม,4490,ท้องถิ่นเทศบาลตำบลวาปีปทุม,2263,2488,4751,2268,2492,4760,2352
2563,44,มหาสารคาม,4491,ท้องถิ่นเทศบาลตำบลพยัคฆภูมิพิสัย,3809,4215,8024,3820,4220,8040,4178
2563,44,มหาสารคาม,4492,ท้องถิ่นเทศบาลตำบลนาเชือก,1840,1941,3781,1843,1941,3784,2069
2563,44,มหาสารคาม,4493,ท้องถิ่นเทศบาลตำบลบรบือ,2611,3054,5665,2615,3056,5671,2320
2563,44,มหาสารคาม,4494,ท้องถิ่นเทศบาลตำบลเชียงยืน,2279,2401,4680,2283,2404,4687,2371
2563,44,มหาสารคาม,4495,ท้องถิ่นเทศบาลตำบลกันทรวิชัย,1622,1788,3410,1628,1788,3416,1459
2563,44,มหาสารคาม,4496,ท้องถิ่นเทศบาลตำบลโกสุมพิสัย,4392,4815,9207,4409,4817,9226,4204
2563,44,มหาสารคาม,4497,ท้องถิ่นเทศบาลตำบลแกดำ,2672,2670,5342,2674,2670,5344,1575
2563,44,มหาสารคาม,4498,ท้องถิ่นเทศบาลตำบลแวงน่าง,2701,2890,5591,2709,2891,5600,2178
2563,44,มหาสารคาม,4499,ท้องถิ่นเทศบาลเมืองมหาสารคาม,21529,28124,49653,21604,28176,49780,21442
2563,45,ร้อยเอ็ด,4501,อำเภอเมืองร้อยเอ็ด,54245,55907,110152,54417,55953,110370,40996
2563,45,ร้อยเอ็ด,4502,อำเภอเกษตรวิสัย,36738,36788,73526,36755,36798,73553,20769
2563,45,ร้อยเอ็ด,4503,อำเภอปทุมรัตต์,23473,23756,47229,23483,23762,47245,12769
2563,45,ร้อยเอ็ด,4504,อำเภอจตุรพักตรพิมาน,25378,25717,51095,25395,25731,51126,13753
2563,45,ร้อยเอ็ด,4505,อำเภอธวัชบุรี,18829,18751,37580,18846,18761,37607,11211
2563,45,ร้อยเอ็ด,4506,อำเภอพนมไพร,30142,30308,60450,30161,30314,60475,17566
2563,45,ร้อยเอ็ด,4507,อำเภอโพนทอง,48047,48687,96734,48096,48707,96803,28159
2563,45,ร้อยเอ็ด,4508,อำเภอโพธิ์ชัย,13433,13553,26986,13438,13557,26995,7375
2563,45,ร้อยเอ็ด,4509,อำเภอหนองพอก,30116,29883,59999,30143,29896,60039,16405
2563,45,ร้อยเอ็ด,4510,อำเภอเสลภูมิ,44942,45409,90351,44958,45431,90389,24931
2563,45,ร้อยเอ็ด,4511,อำเภอสุวรรณภูมิ,52460,53047,105507,52496,53069,105565,29543
2563,45,ร้อยเอ็ด,4512,อำเภอเมืองสรวง,6811,6828,13639,6818,6835,13653,3755
2563,45,ร้อยเอ็ด,4513,อำเภอโพนทราย,11210,11189,22399,11218,11192,22410,5099
2563,45,ร้อยเอ็ด,4514,อำเภออาจสามารถ,34830,34797,69627,34854,34812,69666,18768
2563,45,ร้อยเอ็ด,4515,อำเภอเมยวดี,11440,11757,23197,11446,11765,23211,6832
2563,45,ร้อยเอ็ด,4516,อำเภอศรีสมเด็จ,18890,17284,36174,18909,17292,36201,10992
2563,45,ร้อยเอ็ด,4517,อำเภอจังหาร,18961,19439,38400,18978,19449,38427,12059
2563,45,ร้อยเอ็ด,4518,อำเภอเชียงขวัญ,13413,13917,27330,13427,13925,27352,8117
2563,45,ร้อยเอ็ด,4519,อำเภอหนองฮี,12185,12183,24368,12190,12189,24379,6495
2563,45,ร้อยเอ็ด,4520,อำเภอทุ่งเขาหลวง,11508,11740,23248,11524,11744,23268,6372
2563,45,ร้อยเอ็ด,4565,ท้องถิ่นเทศบาลตำบลนิเวศน์,3318,3395,6713,3330,3399,6729,3013
2563,45,ร้อยเอ็ด,4566,ท้องถิ่นเทศบาลตำบลมะอึ,2581,2746,5327,2590,2747,5337,2120
2563,45,ร้อยเอ็ด,4569,ท้องถิ่นเทศบาลตำบลโพธิ์ชัย,3355,3385,6740,3356,3386,6742,1723
2563,45,ร้อยเอ็ด,4570,ท้องถิ่นเทศบาลตำบลดินดำ,3399,3494,6893,3402,3495,6897,1992
2563,45,ร้อยเอ็ด,4571,ท้องถิ่นเทศบาลตำบลเมืองไพร,3160,3087,6247,3163,3087,6250,1578
2563,45,ร้อยเอ็ด,4572,ท้องถิ่นเทศบาลตำบลขวาว,4432,4564,8996,4434,4566,9000,2200
2563,45,ร้อยเอ็ด,4573,ท้องถิ่นเทศบาลตำบลดงแดง,4284,4486,8770,4285,4489,8774,2407
2563,45,ร้อยเอ็ด,4574,ท้องถิ่นเทศบาลตำบลโคกล่าม,3673,3725,7398,3675,3728,7403,2063
2563,45,ร้อยเอ็ด,4575,ท้องถิ่นเทศบาลตำบลหัวช้าง,4004,4217,8221,4009,4221,8230,2604
2563,45,ร้อยเอ็ด,4576,ท้องถิ่นเทศบาลตำบลอุ่มเม้า,3589,3716,7305,3596,3720,7316,2013
2563,45,ร้อยเอ็ด,4577,ท้องถิ่นเทศบาลตำบลปอภาร,3475,3792,7267,3481,3793,7274,2421
2563,45,ร้อยเอ็ด,4578,ท้องถิ่นเทศบาลตำบลเมืองบัว,4124,4322,8446,4133,4325,8458,2766
2563,45,ร้อยเอ็ด,4579,ท้องถิ่นเทศบาลตำบลคำพอุง,4675,4600,9275,4687,4601,9288,2596
2563,45,ร้อยเอ็ด,4580,ท้องถิ่นเทศบาลตำบลอัคคะคำ,4099,4074,8173,4100,4075,8175,2105
2563,45,ร้อยเอ็ด,4581,ท้องถิ่นเทศบาลตำบลโนนตาล,2624,2600,5224,2624,2603,5227,1423
2563,45,ร้อยเอ็ด,4583,ท้องถิ่นเทศบาลตำบลอาจสามารถ,1958,2058,4016,1960,2059,4019,1769
2563,45,ร้อยเอ็ด,4584,ท้องถิ่นเทศบาลตำบลโพนทราย,2782,2804,5586,2782,2804,5586,1939
2563,45,ร้อยเอ็ด,4585,ท้องถิ่นเทศบาลตำบลเมืองสรวง,4701,4790,9491,4710,4792,9502,2827
2563,45,ร้อยเอ็ด,4586,ท้องถิ่นเทศบาลตำบลสุวรรณภูมิ,4286,4777,9063,4289,4782,9071,4199
2563,45,ร้อยเอ็ด,4587,ท้องถิ่นเทศบาลตำบลเสลภูมิ,6302,6726,13028,6315,6734,13049,4975
2563,45,ร้อยเอ็ด,4588,ท้องถิ่นเทศบาลตำบลหนองพอก,3158,3334,6492,3169,3335,6504,2623
2563,45,ร้อยเอ็ด,4589,ท้องถิ่นเทศบาลตำบลเชียงใหม่,4060,4159,8219,4063,4160,8223,2404
2563,45,ร้อยเอ็ด,4590,ท้องถิ่นเทศบาลตำบลชัยวารี,2598,2699,5297,2601,2699,5300,1657
2563,45,ร้อยเอ็ด,4591,ท้องถิ่นเทศบาลตำบลโพนทอง,5585,5792,11377,5604,5800,11404,4935
2563,45,ร้อยเอ็ด,4592,ท้องถิ่นเทศบาลตำบลพนมไพร,2036,2136,4172,2042,2139,4181,1770
2563,45,ร้อยเอ็ด,4593,ท้องถิ่นเทศบาลตำบลบ้านนิเวศน์,1202,1335,2537,1205,1335,2540,1172
2563,45,ร้อยเอ็ด,4594,ท้องถิ่นเทศบาลตำบลธงธานี,3746,4014,7760,3759,4015,7774,2490
2563,45,ร้อยเอ็ด,4595,ท้องถิ่นเทศบาลตำบลจตุรพักตรพิมาน,1784,2078,3862,1792,2083,3875,1571
2563,45,ร้อยเอ็ด,4596,ท้องถิ่นเทศบาลตำบลปทุมรัตต์,3071,3287,6358,3073,3288,6361,2116
2563,45,ร้อยเอ็ด,4597,ท้องถิ่นเทศบาลตำบลเกษตรวิสัย,5316,5651,10967,5320,5658,10978,4820
2563,45,ร้อยเอ็ด,4598,ท้องถิ่นเทศบาลตำบลกู่กาสิงห์,2270,2364,4634,2271,2365,4636,1578
2563,45,ร้อยเอ็ด,4599,ท้องถิ่นเทศบาลเมืองร้อยเอ็ด,16728,18904,35632,16846,18957,35803,16762
2563,46,กาฬสินธุ์,4601,อำเภอเมืองกาฬสินธุ์,39781,40956,80737,39872,40984,80856,25719
2563,46,กาฬสินธุ์,4602,อำเภอนามน,14637,14806,29443,14649,14807,29456,9305
2563,46,กาฬสินธุ์,4603,อำเภอกมลาไสย,22451,23306,45757,22467,23312,45779,12378
2563,46,กาฬสินธุ์,4604,อำเภอร่องคำ,5180,5291,10471,5183,5291,10474,3251
2563,46,กาฬสินธุ์,4605,อำเภอกุฉินารายณ์,30936,30853,61789,30974,30877,61851,20744
2563,46,กาฬสินธุ์,4606,อำเภอเขาวง,10434,10545,20979,10440,10550,20990,8460
2563,46,กาฬสินธุ์,4607,อำเภอยางตลาด,40166,41510,81676,40198,41523,81721,24056
2563,46,กาฬสินธุ์,4608,อำเภอห้วยเม็ก,20110,19923,40033,20133,19928,40061,11877
2563,46,กาฬสินธุ์,4609,อำเภอสหัสขันธ์,17180,17418,34598,17205,17426,34631,10211
2563,46,กาฬสินธุ์,4610,อำเภอคำม่วง,13463,13414,26877,13474,13415,26889,7348
2563,46,กาฬสินธุ์,4611,อำเภอท่าคันโท,14411,14456,28867,14428,14463,28891,8141
2563,46,กาฬสินธุ์,4612,อำเภอหนองกุงศรี,25585,25558,51143,25608,25569,51177,15185
2563,46,กาฬสินธุ์,4613,อำเภอสมเด็จ,27202,27729,54931,27249,27745,54994,17433
2563,46,กาฬสินธุ์,4614,อำเภอห้วยผึ้ง,6921,7096,14017,6933,7099,14032,3912
2563,46,กาฬสินธุ์,4615,อำเภอสามชัย,12900,12503,25403,12907,12505,25412,7510
2563,46,กาฬสินธุ์,4616,อำเภอนาคู,12885,12913,25798,12889,12915,25804,8096
2563,46,กาฬสินธุ์,4617,อำเภอดอนจาน,12982,13084,26066,12995,13090,26085,7550
2563,46,กาฬสินธุ์,4618,อำเภอฆ้องชัย,13203,13493,26696,13212,13497,26709,7449
2563,46,กาฬสินธุ์,4651,สาขาตำบลคำใหญ่ อำเภอห้วยเม็ก,0,0,0,0,0,0,0
2563,46,กาฬสินธุ์,4665,ท้องถิ่นเทศบาลตำบลจุมจัง,4769,4832,9601,4770,4832,9602,2463
2563,46,กาฬสินธุ์,4666,ท้องถิ่นเทศบาลตำบลนาทัน,7205,7045,14250,7205,7046,14251,3676
2563,46,กาฬสินธุ์,4667,ท้องถิ่นเทศบาลตำบลอิตื้อ,4330,4425,8755,4331,4430,8761,2495
2563,46,กาฬสินธุ์,4668,ท้องถิ่นเทศบาลตำบลภูสิงห์,1425,1366,2791,1425,1368,2793,819
2563,46,กาฬสินธุ์,4669,ท้องถิ่นเทศบาลตำบลหัวนาคำ,6249,6533,12782,6252,6536,12788,3710
2563,46,กาฬสินธุ์,4670,ท้องถิ่นเทศบาลตำบลบัวบาน,6326,6658,12984,6333,6660,12993,4429
2563,46,กาฬสินธุ์,4671,ท้องถิ่นเทศบาลตำบลนาขาม,6420,6540,12960,6422,6541,12963,3366
2563,46,กาฬสินธุ์,4672,ท้องถิ่นเทศบาลตำบลลำคลอง,2059,2202,4261,2062,2203,4265,1324
2563,46,กาฬสินธุ์,4673,ท้องถิ่นเทศบาลตำบลคำบง,5262,5190,10452,5265,5193,10458,2975
2563,46,กาฬสินธุ์,4674,ท้องถิ่นเทศบาลตำบลสระพังทอง,1409,1387,2796,1410,1388,2798,995
2563,46,กาฬสินธุ์,4675,ท้องถิ่นเทศบาลตำบลห้วยโพธิ์,5842,5944,11786,5857,5946,11803,3378
2563,46,กาฬสินธุ์,4676,ท้องถิ่นเทศบาลตำบลนาคู,2547,2770,5317,2551,2773,5324,1913
2563,46,กาฬสินธุ์,4677,ท้องถิ่นเทศบาลตำบลห้วยผึ้ง,2821,2939,5760,2827,2942,5769,2243
2563,46,กาฬสินธุ์,4678,ท้องถิ่นเทศบาลตำบลสมเด็จ,3329,3519,6848,3339,3523,6862,3306
2563,46,กาฬสินธุ์,4679,ท้องถิ่นเทศบาลตำบลหนองหิน,2643,2714,5357,2645,2714,5359,1596
2563,46,กาฬสินธุ์,4680,ท้องถิ่นเทศบาลตำบลหนองกุงศรี,4398,4509,8907,4406,4512,8918,3380
2563,46,กาฬสินธุ์,4681,ท้องถิ่นเทศบาลตำบลท่าคันโท,4531,4595,9126,4536,4598,9134,2898
2563,46,กาฬสินธุ์,4682,ท้องถิ่นเทศบาลตำบลโพน,1887,1926,3813,1887,1926,3813,1091
2563,46,กาฬสินธุ์,4683,ท้องถิ่นเทศบาลตำบลคำม่วง,1935,1997,3932,1938,1998,3936,1684
2563,46,กาฬสินธุ์,4684,ท้องถิ่นเทศบาลตำบลโนนบุรี,2488,2725,5213,2498,2725,5223,1976
2563,46,กาฬสินธุ์,4685,ท้องถิ่นเทศบาลตำบลห้วยเม็ก,2782,2910,5692,2789,2912,5701,2171
2563,46,กาฬสินธุ์,4686,ท้องถิ่นเทศบาลตำบลคำใหญ่,2466,2534,5000,2470,2535,5005,1601
2563,46,กาฬสินธุ์,4687,ท้องถิ่นเทศบาลตำบลยางตลาด,4065,4473,8538,4075,4478,8553,3780
2563,46,กาฬสินธุ์,4688,ท้องถิ่นเทศบาลตำบลโคกศรี,1552,1622,3174,1553,1622,3175,1261
2563,46,กาฬสินธุ์,4689,ท้องถิ่นเทศบาลตำบลกุดสิม,4980,5277,10257,4991,5283,10274,4467
2563,46,กาฬสินธุ์,4690,ท้องถิ่นเทศบาลเมืองกุฉินารายณ์,5513,5805,11318,5525,5808,11333,4893
2563,46,กาฬสินธุ์,4691,ท้องถิ่นเทศบาลตำบลกุดหว้า,2522,2721,5243,2526,2723,5249,2052
2563,46,กาฬสินธุ์,4692,ท้องถิ่นเทศบาลตำบลร่องคำ,2970,3100,6070,2972,3102,6074,2169
2563,46,กาฬสินธุ์,4693,ท้องถิ่นเทศบาลตำบลหนองแปน,3248,3521,6769,3250,3521,6771,2146
2563,46,กาฬสินธุ์,4694,ท้องถิ่นเทศบาลตำบลธัญญา,3110,3230,6340,3116,3232,6348,1699
2563,46,กาฬสินธุ์,4695,ท้องถิ่นเทศบาลตำบลกมลาไสย,4634,5161,9795,4651,5165,9816,3618
2563,46,กาฬสินธุ์,4696,ท้องถิ่นเทศบาลตำบลนามน,3495,3505,7000,3496,3506,7002,2335
2563,46,กาฬสินธุ์,4697,ท้องถิ่นเทศบาลตำบลหนองสอ,3504,3768,7272,3510,3770,7280,2240
2563,46,กาฬสินธุ์,4698,ท้องถิ่นเทศบาลตำบลนาจารย์,4222,4254,8476,4228,4259,8487,2493
2563,46,กาฬสินธุ์,4699,ท้องถิ่นเทศบาลเมืองกาฬสินธุ์,15440,16935,32375,15520,16962,32482,15878
2563,47,สกลนคร,4701,อำเภอเมืองสกลนคร,55847,57144,112991,55898,57161,113059,41103
2563,47,สกลนคร,4702,อำเภอกุสุมาลย์,21703,21816,43519,21727,21825,43552,13419
2563,47,สกลนคร,4703,อำเภอกุดบาก,14073,13735,27808,14077,13736,27813,8835
2563,47,สกลนคร,4704,อำเภอพรรณานิคม,38729,39217,77946,38756,39245,78001,26445
2563,47,สกลนคร,4705,อำเภอพังโคน,22720,23318,46038,22764,23347,46111,17283
2563,47,สกลนคร,4706,อำเภอวาริชภูมิ,17784,18241,36025,17800,18251,36051,12143
2563,47,สกลนคร,4707,อำเภอนิคมน้ำอูน,7445,7428,14873,7448,7432,14880,4578
2563,47,สกลนคร,4708,อำเภอวานรนิวาส,59909,60410,120319,59962,60437,120399,34039
2563,47,สกลนคร,4709,อำเภอคำตากล้า,16374,16409,32783,16388,16415,32803,11516
2563,47,สกลนคร,4710,อำเภอบ้านม่วง,33936,33336,67272,33983,33351,67334,19669
2563,47,สกลนคร,4711,อำเภออากาศอำนวย,27125,26876,54001,27135,26893,54028,18555
2563,47,สกลนคร,4712,อำเภอสว่างแดนดิน,63751,64445,128196,63787,64475,128262,37085
2563,47,สกลนคร,4713,อำเภอส่องดาว,15008,14495,29503,15017,14503,29520,7654
2563,47,สกลนคร,4714,อำเภอเต่างอย,12200,12160,24360,12208,12164,24372,8580
2563,47,สกลนคร,4715,อำเภอโคกศรีสุพรรณ,10842,10961,21803,10846,10964,21810,7534
2563,47,สกลนคร,4716,อำเภอเจริญศิลป์,19292,18981,38273,19305,18987,38292,10474
2563,47,สกลนคร,4717,อำเภอโพนนาแก้ว,18441,18395,36836,18453,18402,36855,13491
2563,47,สกลนคร,4718,อำเภอภูพาน,18131,17801,35932,18151,17809,35960,12338
2563,47,สกลนคร,4751,สาขาตำบลกุดเรือคำ อำเภอวานรนิวาส,0,0,0,0,0,0,0
2563,47,สกลนคร,4779,ท้องถิ่นเทศบาลตำบลคำบ่อ,6818,7015,13833,6819,7017,13836,4108
2563,47,สกลนคร,4780,ท้องถิ่นเทศบาลตำบลตองโขบ,6217,6386,12603,6223,6388,12611,5651
2563,47,สกลนคร,4781,ท้องถิ่นเทศบาลตำบลบงใต้,5131,5048,10179,5134,5049,10183,2955
2563,47,สกลนคร,4782,ท้องถิ่นเทศบาลตำบลสามัคคีพัฒนา,4466,4542,9008,4468,4542,9010,2369
2563,47,สกลนคร,4783,ท้องถิ่นเทศบาลตำบลเชียงเครือ,8304,8933,17237,8308,8935,17243,5974
2563,47,สกลนคร,4784,ท้องถิ่นเทศบาลตำบลเจริญศิลป์,3358,3498,6856,3360,3499,6859,2249
2563,47,สกลนคร,4785,ท้องถิ่นเทศบาลตำบลส่องดาว,2467,2466,4933,2468,2467,4935,1551
2563,47,สกลนคร,4786,ท้องถิ่นเทศบาลตำบลสว่างแดนดิน,3958,4304,8262,3966,4325,8291,4561
2563,47,สกลนคร,4787,ท้องถิ่นเทศบาลตำบลดอนเขือง,2085,2112,4197,2086,2113,4199,1241
2563,47,สกลนคร,4788,ท้องถิ่นเทศบาลตำบลอากาศอำนวย,4377,4605,8982,4379,4605,8984,3026
2563,47,สกลนคร,4789,ท้องถิ่นเทศบาลตำบลบ้านม่วง,1708,1844,3552,1714,1846,3560,1480
2563,47,สกลนคร,4790,ท้องถิ่นเทศบาลตำบลคำตากล้า,3587,3712,7299,3598,3716,7314,2274
2563,47,สกลนคร,4791,ท้องถิ่นเทศบาลตำบลวานรนิวาส,2770,3088,5858,2773,3091,5864,2370
2563,47,สกลนคร,4792,ท้องถิ่นเทศบาลตำบลวาริชภูมิ,1395,1462,2857,1396,1462,2858,1335
2563,47,สกลนคร,4793,ท้องถิ่นเทศบาลตำบลพังโคน,3173,3270,6443,3194,3280,6474,3935
2563,47,สกลนคร,4794,ท้องถิ่นเทศบาลตำบลพรรณานิคม,1145,1285,2430,1147,1286,2433,1448
2563,47,สกลนคร,4795,ท้องถิ่นเทศบาลตำบลกุดบาก,2478,2641,5119,2480,2643,5123,1845
2563,47,สกลนคร,4796,ท้องถิ่นเทศบาลตำบลกุสุมาลย์,1963,2097,4060,1968,2097,4065,1689
2563,47,สกลนคร,4797,ท้องถิ่นเทศบาลตำบลท่าแร่,3220,3479,6699,3230,3484,6714,2323
2563,47,สกลนคร,4798,ท้องถิ่นเทศบาลตำบลดงมะไฟ,2815,3126,5941,2817,3130,5947,2258
2563,47,สกลนคร,4799,ท้องถิ่นเทศบาลนครสกลนคร,24917,26144,51061,25052,26279,51331,28316
2563,48,นครพนม,4801,อำเภอเมืองนครพนม,59355,58383,117738,59490,58543,118033,35688
2563,48,นครพนม,4802,อำเภอปลาปาก,25342,25078,50420,25368,25097,50465,16217
2563,48,นครพนม,4803,อำเภอท่าอุเทน,27464,27129,54593,27535,27229,54764,15669
2563,48,นครพนม,4804,อำเภอบ้านแพง,13367,13063,26430,13399,13122,26521,7999
2563,48,นครพนม,4805,อำเภอธาตุพนม,35803,36274,72077,35912,36373,72285,21867
2563,48,นครพนม,4806,อำเภอเรณูนคร,20795,20657,41452,20826,20671,41497,12812
2563,48,นครพนม,4807,อำเภอนาแก,35887,36394,72281,35934,36418,72352,21390
2563,48,นครพนม,4808,อำเภอศรีสงคราม,32122,32332,64454,32152,32376,64528,19186
2563,48,นครพนม,4809,อำเภอนาหว้า,19923,19934,39857,19935,19950,39885,12958
2563,48,นครพนม,4810,อำเภอโพนสวรรค์,26236,26296,52532,26248,26302,52550,16797
2563,48,นครพนม,4811,อำเภอนาทม,11866,11732,23598,11879,11738,23617,7390
2563,48,นครพนม,4812,อำเภอวังยาง,7793,7693,15486,7796,7693,15489,4682
2563,48,นครพนม,4890,ท้องถิ่นเทศบาลตำบลปลาปาก,1908,2019,3927,1909,2020,3929,1566
2563,48,นครพนม,4891,ท้องถิ่นเทศบาลตำบลโพนสวรรค์,2685,2680,5365,2688,2681,5369,1820
2563,48,นครพนม,4892,ท้องถิ่นเทศบาลตำบลนาหว้า,6001,6170,12171,6019,6174,12193,4195
2563,48,นครพนม,4893,ท้องถิ่นเทศบาลตำบลศรีสงคราม,2467,2580,5047,2473,2588,5061,2477
2563,48,นครพนม,4894,ท้องถิ่นเทศบาลตำบลนาแก,2060,2320,4380,2064,2320,4384,2327
2563,48,นครพนม,4895,ท้องถิ่นเทศบาลตำบลเรณูนคร,2110,2378,4488,2117,2386,4503,1691
2563,48,นครพนม,4896,ท้องถิ่นเทศบาลตำบลธาตุพนม,4860,5148,10008,4874,5157,10031,4113
2563,48,นครพนม,4897,ท้องถิ่นเทศบาลตำบลบ้านแพง,4322,4415,8737,4345,4468,8813,3567
2563,48,นครพนม,4898,ท้องถิ่นเทศบาลตำบลท่าอุเทน,2323,2451,4774,2341,2498,4839,1947
2563,48,นครพนม,4899,ท้องถิ่นเทศบาลเมืองนครพนม,12141,13610,25751,12290,13803,26093,14957
2563,49,มุกดาหาร,4901,อำเภอเมืองมุกดาหาร,39915,39417,79332,40076,39598,79674,26572
2563,49,มุกดาหาร,4902,อำเภอนิคมคำสร้อย,17025,17017,34042,17053,17026,34079,10013
2563,49,มุกดาหาร,4903,อำเภอดอนตาล,19391,19150,38541,19479,19297,38776,11507
2563,49,มุกดาหาร,4904,อำเภอดงหลวง,19594,19317,38911,19603,19327,38930,12102
2563,49,มุกดาหาร,4905,อำเภอคำชะอี,22270,22327,44597,22294,22341,44635,14350
2563,49,มุกดาหาร,4906,อำเภอหว้านใหญ่,9861,9809,19670,9903,9856,19759,6166
2563,49,มุกดาหาร,4907,อำเภอหนองสูง,10363,10419,20782,10369,10424,20793,7137
2563,49,มุกดาหาร,4989,ท้องถิ่นเทศบาลตำบลร่มเกล้า,1704,1635,3339,1707,1636,3343,1059
2563,49,มุกดาหาร,4993,ท้องถิ่นเทศบาลตำบลบ้านแก้ง,1496,1521,3017,1526,1558,3084,929
2563,49,มุกดาหาร,4994,ท้องถิ่นเทศบาลตำบลคำอาฮวน,6417,6353,12770,6438,6363,12801,4615
2563,49,มุกดาหาร,4995,ท้องถิ่นเทศบาลตำบลดงเย็น,5441,5268,10709,5448,5279,10727,3039
2563,49,มุกดาหาร,4996,ท้องถิ่นเทศบาลตำบลคำชะอี,1180,1201,2381,1182,1203,2385,1126
2563,49,มุกดาหาร,4997,ท้องถิ่นเทศบาลตำบลดอนตาล,1163,1353,2516,1187,1381,2568,952
2563,49,มุกดาหาร,4998,ท้องถิ่นเทศบาลตำบลนิคมคำสร้อย,3051,3184,6235,3060,3186,6246,2305
2563,49,มุกดาหาร,4999,ท้องถิ่นเทศบาลเมืองมุกดาหาร,15097,16108,31205,16042,17069,33111,15869
2563,50,เชียงใหม่,5001,อำเภอเมืองเชียงใหม่,6490,7354,13844,6615,7426,14041,11264
2563,50,เชียงใหม่,5002,อำเภอจอมทอง,27873,28782,56655,28057,28919,56976,19855
2563,50,เชียงใหม่,5003,อำเภอแม่แจ่ม,28864,28082,56946,29072,28219,57291,17996
2563,50,เชียงใหม่,5004,อำเภอเชียงดาว,10977,11457,22434,13010,13579,26589,11389
2563,50,เชียงใหม่,5005,อำเภอดอยสะเก็ด,21833,23848,45681,22251,24119,46370,21860
2563,50,เชียงใหม่,5006,อำเภอแม่แตง,25152,25568,50720,29875,30135,60010,24369
2563,50,เชียงใหม่,5007,อำเภอแม่ริม,37530,39486,77016,41656,43154,84810,37559
2563,50,เชียงใหม่,5008,อำเภอสะเมิง,9178,8864,18042,9302,8967,18269,6038
2563,50,เชียงใหม่,5009,อำเภอฝาง,40301,42022,82323,55506,56609,112115,40555
2563,50,เชียงใหม่,5010,อำเภอแม่อาย,28387,28788,57175,33747,33732,67479,27851
2563,50,เชียงใหม่,5011,อำเภอพร้าว,18173,18608,36781,18434,18873,37307,15526
2563,50,เชียงใหม่,5012,อำเภอสันป่าตอง,27972,31451,59423,28172,31623,59795,25432
2563,50,เชียงใหม่,5013,อำเภอสันกำแพง,19892,22385,42277,20207,22577,42784,22383
2563,50,เชียงใหม่,5014,อำเภอสันทราย,8965,10224,19189,9462,10695,20157,10016
2563,50,เชียงใหม่,5015,อำเภอหางดง,34708,39475,74183,35444,39820,75264,43174
2563,50,เชียงใหม่,5016,อำเภอฮอด,12589,12894,25483,12631,12932,25563,9622
2563,50,เชียงใหม่,5017,อำเภอดอยเต่า,11491,11468,22959,11502,11484,22986,8684
2563,50,เชียงใหม่,5018,อำเภออมก๋อย,30550,30011,60561,30686,30145,60831,22382
2563,50,เชียงใหม่,5019,อำเภอสารภี,21321,24331,45652,21693,24611,46304,22364
2563,50,เชียงใหม่,5020,อำเภอเวียงแหง,9782,9184,18966,27193,26731,53924,9414
2563,50,เชียงใหม่,5021,อำเภอไชยปราการ,11732,11752,23484,17255,17280,34535,11531
2563,50,เชียงใหม่,5022,อำเภอแม่วาง,13408,13549,26957,13602,13738,27340,9783
2563,50,เชียงใหม่,5023,อำเภอแม่ออน,10351,10551,20902,10455,10635,21090,9411
2563,50,เชียงใหม่,5024,อำเภอดอยหล่อ,12063,12777,24840,12229,12931,25160,11522
2563,50,เชียงใหม่,5025,อำเภอกัลยาณิวัฒนา,6529,6138,12667,6552,6147,12699,4250
2563,50,เชียงใหม่,5040,ท้องถิ่นเทศบาลตำบลบวกค้าง,3987,4416,8403,4067,4470,8537,3874
2563,50,เชียงใหม่,5041,ท้องถิ่นเทศบาลตำบลบ่อหลวง,6067,5997,12064,6096,6030,12126,3829
2563,50,เชียงใหม่,5042,ท้องถิ่นเทศบาลตำบลป่าไผ่,6377,7121,13498,6473,7178,13651,6053
2563,50,เชียงใหม่,5043,ท้องถิ่นเทศบาลตำบลสันนาเม็ง,5686,6808,12494,5853,6921,12774,8138
2563,50,เชียงใหม่,5044,ท้องถิ่นเทศบาลตำบลสันพระเนตร,2763,3286,6049,2816,3323,6139,3322
2563,50,เชียงใหม่,5046,ท้องถิ่นเทศบาลตำบลสันปูเลย,7553,8851,16404,7689,8904,16593,9034
2563,50,เชียงใหม่,5049,ท้องถิ่นเทศบาลตำบลเชิงดอย,3603,3960,7563,3692,4028,7720,3617
2563,50,เชียงใหม่,5050,ท้องถิ่นเทศบาลตำบลเมืองนะ,11217,11097,22314,18324,19024,37348,9198
2563,50,เชียงใหม่,5054,ท้องถิ่นเทศบาลตำบลทุ่งข้าวพวง,3245,3216,6461,5454,5388,10842,3033
2563,50,เชียงใหม่,5055,ท้องถิ่นเทศบาลตำบลปิงโค้ง,6652,5564,12216,7555,6452,14007,4468
2563,50,เชียงใหม่,5056,ท้องถิ่นเทศบาลตำบลพระธาตุปู่ก่ำ,966,1006,1972,1157,1195,2352,1103
2563,50,เชียงใหม่,5057,ท้องถิ่นเทศบาลเมืองแม่เหียะ,8736,10629,19365,8934,10721,19655,13842
2563,50,เชียงใหม่,5058,ท้องถิ่นเทศบาลตำบลสารภี,2875,3291,6166,3367,3775,7142,2667
2563,50,เชียงใหม่,5059,ท้องถิ่นเทศบาลตำบลฟ้าฮ่าม,3162,3668,6830,3237,3728,6965,9486
2563,50,เชียงใหม่,5060,ท้องถิ่นเทศบาลตำบลหนองจ๊อม,7582,9158,16740,7792,9319,17111,9153
2563,50,เชียงใหม่,5061,ท้องถิ่นเทศบาลตำบลหนองหอย,3466,4220,7686,3544,4267,7811,5443
2563,50,เชียงใหม่,5062,ท้องถิ่นเทศบาลตำบลแม่แฝก,4220,4774,8994,4255,4806,9061,3889
2563,50,เชียงใหม่,5063,ท้องถิ่นเทศบาลตำบลท่าศาลา,3133,3711,6844,3251,3777,7028,5433
2563,50,เชียงใหม่,5064,ท้องถิ่นเทศบาลตำบลหนองผึ้ง,7102,8325,15427,7200,8380,15580,8718
2563,50,เชียงใหม่,5065,ท้องถิ่นเทศบาลตำบลเจดีย์แม่ครัว,3804,4205,8009,3839,4227,8066,3862
2563,50,เชียงใหม่,5066,ท้องถิ่นเทศบาลตำบลแม่ปั๋ง,3018,3053,6071,3046,3090,6136,2605
2563,50,เชียงใหม่,5067,ท้องถิ่นเทศบาลตำบลชมภู,3575,3893,7468,3602,3927,7529,3067
2563,50,เชียงใหม่,5068,ท้องถิ่นเทศบาลตำบลป่าแดด,7947,9378,17325,8096,9471,17567,10832
2563,50,เชียงใหม่,5069,ท้องถิ่นเทศบาลเมืองสุเทพ,8304,8503,16807,8477,8631,17108,11293
2563,50,เชียงใหม่,5070,ท้องถิ่นเทศบาลตำบลหนองป่าครั่ง,3246,3838,7084,3375,3948,7323,6035
2563,50,เชียงใหม่,5071,ท้องถิ่นเทศบาลตำบลแม่วาง,2132,2408,4540,2152,2427,4579,2186
2563,50,เชียงใหม่,5072,ท้องถิ่นเทศบาลตำบลไชยปราการ,7201,7949,15150,7545,8284,15829,6594
2563,50,เชียงใหม่,5073,ท้องถิ่นเทศบาลตำบลยางเนิ้ง,4688,5639,10327,4723,5658,10381,5388
2563,50,เชียงใหม่,5074,ท้องถิ่นเทศบาลตำบลอมก๋อย,547,524,1071,552,526,1078,825
2563,50,เชียงใหม่,5075,ท้องถิ่นเทศบาลตำบลท่าเดื่อ-มืดกา,2079,2194,4273,2091,2202,4293,1859
2563,50,เชียงใหม่,5076,ท้องถิ่นเทศบาลตำบลท่าข้าม,2745,2975,5720,2759,2989,5748,3461
2563,50,เชียงใหม่,5077,ท้องถิ่นเทศบาลตำบลหางดง,2644,3269,5913,3344,3925,7269,3813
2563,50,เชียงใหม่,5078,ท้องถิ่นเทศบาลตำบลหนองตองพัฒนา,3916,4495,8411,3932,4501,8433,3521
2563,50,เชียงใหม่,5079,ท้องถิ่นเทศบาลตำบลสันทรายหลวง,12574,15287,27861,12882,15455,28337,15144
2563,50,เชียงใหม่,5080,ท้องถิ่นเทศบาลเมืองแม่โจ้,9576,11667,21243,10691,12576,23267,13995
2563,50,เชียงใหม่,5081,ท้องถิ่นเทศบาลตำบลสันกำแพง,8054,9416,17470,8187,9463,17650,8989
2563,50,เชียงใหม่,5082,ท้องถิ่นเทศบาลเมืองต้นเปา,8631,10347,18978,8790,10473,19263,12944
2563,50,เชียงใหม่,5083,ท้องถิ่นเทศบาลตำบลสันป่าตอง,2041,2406,4447,2049,2412,4461,2745
2563,50,เชียงใหม่,5084,ท้องถิ่นเทศบาลตำบลบ้านกลาง,4812,5440,10252,4828,5456,10284,5320
2563,50,เชียงใหม่,5085,ท้องถิ่นเทศบาลตำบลเวียงพร้าว,2194,2554,4748,2234,2587,4821,2810
2563,50,เชียงใหม่,5086,ท้องถิ่นเทศบาลตำบลแม่อาย,4465,4784,9249,5153,5481,10634,4853
2563,50,เชียงใหม่,5087,ท้องถิ่นเทศบาลตำบลเวียงฝาง,2882,3245,6127,4098,4481,8579,3937
2563,50,เชียงใหม่,5088,ท้องถิ่นเทศบาลตำบลบ้านแม่ข่า,928,957,1885,942,971,1913,889
2563,50,เชียงใหม่,5089,ท้องถิ่นเทศบาลตำบลสะเมิงใต้,2533,2536,5069,2689,2683,5372,2531
2563,50,เชียงใหม่,5090,ท้องถิ่นเทศบาลตำบลแม่ริม,4363,5004,9367,4416,5032,9448,5752
2563,50,เชียงใหม่,5091,ท้องถิ่นเทศบาลตำบลสันมหาพน,3787,4242,8029,3962,4421,8383,4984
2563,50,เชียงใหม่,5092,ท้องถิ่นเทศบาลเมืองเมืองแกนพัฒนา,6182,6584,12766,6247,6632,12879,5691
2563,50,เชียงใหม่,5093,ท้องถิ่นเทศบาลตำบลดอยสะเก็ด,1859,2129,3988,2015,2282,4297,2128
2563,50,เชียงใหม่,5094,ท้องถิ่นเทศบาลตำบลเมืองงาย,1717,1967,3684,1795,2031,3826,1931
2563,50,เชียงใหม่,5095,ท้องถิ่นเทศบาลตำบลเชียงดาว,1851,2083,3934,1869,2105,3974,2300
2563,50,เชียงใหม่,5096,ท้องถิ่นเทศบาลตำบลแม่แจ่ม,1285,1325,2610,1296,1331,2627,1606
2563,50,เชียงใหม่,5097,ท้องถิ่นเทศบาลตำบลจอมทอง,4278,4965,9243,4294,4978,9272,4522
2563,50,เชียงใหม่,5098,ท้องถิ่นเทศบาลตำบลช้างเผือก,4064,4664,8728,4227,4759,8986,8888
2563,50,เชียงใหม่,5099,ท้องถิ่นเทศบาลนครเชียงใหม่,54406,62716,117122,57313,65314,122627,90147
2563,51,ลำพูน,5101,อำเภอเมืองลำพูน,27402,30516,57918,27929,30961,58890,27356
2563,51,ลำพูน,5102,อำเภอแม่ทา,12353,12659,25012,12388,12679,25067,10678
2563,51,ลำพูน,5103,อำเภอบ้านโฮ่ง,12667,13324,25991,12708,13350,26058,10201
2563,51,ลำพูน,5104,อำเภอลี้,30952,30523,61475,31028,30626,61654,21165
2563,51,ลำพูน,5105,อำเภอทุ่งหัวช้าง,8841,8793,17634,8842,8793,17635,6428
2563,51,ลำพูน,5106,อำเภอป่าซาง,13722,14624,28346,13912,14835,28747,12815
2563,51,ลำพูน,5107,อำเภอบ้านธิ,3787,4154,7941,3863,4212,8075,3355
2563,51,ลำพูน,5108,อำเภอเวียงหนองล่อง,0,0,0,0,0,0,0
2563,51,ลำพูน,5176,ท้องถิ่นเทศบาลตำบลศรีเตี้ย,2643,2846,5489,2648,2851,5499,2221
2563,51,ลำพูน,5177,ท้องถิ่นเทศบาลตำบลทาสบชัย,2401,2527,4928,2417,2541,4958,2261
2563,51,ลำพูน,5178,ท้องถิ่นเทศบาลตำบลหนองล่อง,2706,2895,5601,2714,2902,5616,2513
2563,51,ลำพูน,5179,ท้องถิ่นเทศบาลตำบลหนองยวง,1747,1909,3656,1766,1924,3690,1793
2563,51,ลำพูน,5180,ท้องถิ่นเทศบาลตำบลมะกอก,2446,2743,5189,2455,2745,5200,2342
2563,51,ลำพูน,5181,ท้องถิ่นเทศบาลตำบลมะเขือแจ้,7570,8271,15841,7632,8322,15954,8579
2563,51,ลำพูน,5182,ท้องถิ่นเทศบาลตำบลเวียงยอง,3102,3592,6694,3140,3616,6756,3329
2563,51,ลำพูน,5183,ท้องถิ่นเทศบาลตำบลบ้านกลาง,5231,6106,11337,5263,6131,11394,11061
2563,51,ลำพูน,5184,ท้องถิ่นเทศบาลตำบลเหมืองง่า,7204,8614,15818,7235,8631,15866,8194
2563,51,ลำพูน,5185,ท้องถิ่นเทศบาลตำบลแม่แรง,3395,3676,7071,3405,3681,7086,2886
2563,51,ลำพูน,5186,ท้องถิ่นเทศบาลตำบลบ้านธิ,4412,4852,9264,4525,4961,9486,4289
2563,51,ลำพูน,5187,ท้องถิ่นเทศบาลตำบลวังผาง,3619,4058,7677,3626,4062,7688,3237
2563,51,ลำพูน,5188,ท้องถิ่นเทศบาลตำบลม่วงน้อย,1961,2268,4229,1963,2269,4232,1984
2563,51,ลำพูน,5189,ท้องถิ่นเทศบาลตำบลป่าซาง,3886,4574,8460,3902,4585,8487,4141
2563,51,ลำพูน,5190,ท้องถิ่นเทศบาลตำบลทุ่งหัวช้าง,1262,1262,2524,1263,1264,2527,1217
2563,51,ลำพูน,5191,ท้องถิ่นเทศบาลตำบลวังดิน,2085,2235,4320,2093,2250,4343,2701
2563,51,ลำพูน,5192,ท้องถิ่นเทศบาลตำบลแม่ตืน,1622,1769,3391,1655,1803,3458,1349
2563,51,ลำพูน,5193,ท้องถิ่นเทศบาลตำบลบ้านโฮ่ง,3535,4122,7657,3558,4142,7700,3607
2563,51,ลำพูน,5194,ท้องถิ่นเทศบาลตำบลทาสบเส้า,2551,2731,5282,2581,2756,5337,2510
2563,51,ลำพูน,5195,ท้องถิ่นเทศบาลตำบลทากาศ,1408,1562,2970,1412,1565,2977,1394
2563,51,ลำพูน,5196,ท้องถิ่นเทศบาลตำบลอุโมงค์,5969,6803,12772,6027,6855,12882,5915
2563,51,ลำพูน,5197,ท้องถิ่นเทศบาลตำบลริมปิง,3161,3581,6742,3177,3602,6779,2898
2563,51,ลำพูน,5198,ท้องถิ่นเทศบาลตำบลบ้านแป้น,2881,3327,6208,2898,3344,6242,2733
2563,51,ลำพูน,5199,ท้องถิ่นเทศบาลเมืองลำพูน,5328,6352,11680,5356,6372,11728,7171
2563,52,ลำปาง,5201,อำเภอเมืองลำปาง,44459,45912,90371,44554,45973,90527,38173
2563,52,ลำปาง,5202,อำเภอแม่เมาะ,12155,12002,24157,12171,12016,24187,8965
2563,52,ลำปาง,5203,อำเภอเกาะคา,17491,18698,36189,17514,18716,36230,13158
2563,52,ลำปาง,5204,อำเภอเสริมงาม,11122,11050,22172,11146,11069,22215,7622
2563,52,ลำปาง,5205,อำเภองาว,24353,24416,48769,24528,24607,49135,17956
2563,52,ลำปาง,5206,อำเภอแจ้ห่ม,17273,17746,35019,17349,17802,35151,13142
2563,52,ลำปาง,5207,อำเภอวังเหนือ,18139,17929,36068,18568,18414,36982,13196
2563,52,ลำปาง,5208,อำเภอเถิน,16652,17035,33687,16664,17066,33730,11399
2563,52,ลำปาง,5209,อำเภอแม่พริก,4618,4785,9403,4618,4792,9410,3189
2563,52,ลำปาง,5210,อำเภอแม่ทะ,14031,14225,28256,14041,14235,28276,10681
2563,52,ลำปาง,5211,อำเภอสบปราบ,10500,10797,21297,10505,10807,21312,6604
2563,52,ลำปาง,5212,อำเภอห้างฉัตร,23093,24453,47546,23153,24490,47643,19312
2563,52,ลำปาง,5213,อำเภอเมืองปาน,16425,16378,32803,16436,16393,32829,11923
2563,52,ลำปาง,5275,ท้องถิ่นเทศบาลตำบลน้ำโจ้,4726,4892,9618,4732,4897,9629,3495
2563,52,ลำปาง,5276,ท้องถิ่นเทศบาลตำบลแม่ทะ,3250,3329,6579,3255,3332,6587,2955
2563,52,ลำปาง,5279,ท้องถิ่นเทศบาลตำบลนาแก้ว,4369,4556,8925,4373,4558,8931,3104
2563,52,ลำปาง,5280,ท้องถิ่นเทศบาลตำบลลำปางหลวง,4407,4829,9236,4412,4833,9245,3321
2563,52,ลำปาง,5281,ท้องถิ่นเทศบาลตำบลสิริราช,2348,2235,4583,2351,2236,4587,1580
2563,52,ลำปาง,5282,ท้องถิ่นเทศบาลตำบลแม่เมาะ,7555,7830,15385,7562,7837,15399,8627
2563,52,ลำปาง,5283,ท้องถิ่นเทศบาลตำบลเวียงมอก,5110,5157,10267,5114,5163,10277,3493
2563,52,ลำปาง,5284,ท้องถิ่นเทศบาลตำบลห้างฉัตร,1250,1530,2780,1251,1532,2783,1288
2563,52,ลำปาง,5285,ท้องถิ่นเทศบาลตำบลสบปราบ,2620,2894,5514,2621,2895,5516,2069
2563,52,ลำปาง,5286,ท้องถิ่นเทศบาลตำบลป่าตันนาครัว,3799,4063,7862,3802,4063,7865,2967
2563,52,ลำปาง,5287,ท้องถิ่นเทศบาลตำบลแม่พริก,1256,1349,2605,1256,1349,2605,1111
2563,52,ลำปาง,5288,ท้องถิ่นเทศบาลตำบลแม่ปุ,1841,2024,3865,1844,2025,3869,1333
2563,52,ลำปาง,5289,ท้องถิ่นเทศบาลเมืองล้อมแรด,6607,7622,14229,6637,7650,14287,7054
2563,52,ลำปาง,5290,ท้องถิ่นเทศบาลตำบลวังเหนือ,2025,2008,4033,2035,2013,4048,1958
2563,52,ลำปาง,5291,ท้องถิ่นเทศบาลตำบลบ้านใหม่,1281,1284,2565,1284,1286,2570,879
2563,52,ลำปาง,5292,ท้องถิ่นเทศบาลตำบลแจ้ห่ม,1671,1835,3506,1673,1835,3508,1670
2563,52,ลำปาง,5293,ท้องถิ่นเทศบาลตำบลเสริมงาม,4130,4196,8326,4133,4198,8331,2996
2563,52,ลำปาง,5294,ท้องถิ่นเทศบาลตำบลหลวงเหนือ,1968,2191,4159,1972,2193,4165,2320
2563,52,ลำปาง,5295,ท้องถิ่นเทศบาลตำบลเกาะคา,2092,2415,4507,2114,2432,4546,2337
2563,52,ลำปาง,5296,ท้องถิ่นเทศบาลเมืองพิชัย,6142,6989,13131,6165,6996,13161,6405
2563,52,ลำปาง,5297,ท้องถิ่นเทศบาลตำบลบ่อแฮ้ว,4278,4784,9062,4290,4793,9083,4123
2563,52,ลำปาง,5298,ท้องถิ่นเทศบาลเมืองเขลางค์นคร,28106,31169,59275,28171,31207,59378,25687
2563,52,ลำปาง,5299,ท้องถิ่นเทศบาลนครลำปาง,22728,27808,50536,22964,28003,50967,29304
2563,53,อุตรดิตถ์,5301,อำเภอเมืองอุตรดิตถ์,22449,23533,45982,22465,23551,46016,17719
2563,53,อุตรดิตถ์,5302,อำเภอตรอน,14486,15376,29862,14492,15382,29874,10153
2563,53,อุตรดิตถ์,5303,อำเภอท่าปลา,14415,14561,28976,14429,14576,29005,10161
2563,53,อุตรดิตถ์,5304,อำเภอน้ำปาด,16645,16539,33184,16683,16626,33309,11934
2563,53,อุตรดิตถ์,5305,อำเภอฟากท่า,6531,6871,13402,6536,6889,13425,5068
2563,53,อุตรดิตถ์,5306,อำเภอบ้านโคก,5216,4965,10181,5330,5173,10503,4457
2563,53,อุตรดิตถ์,5307,อำเภอพิชัย,34950,37012,71962,34974,37030,72004,25630
2563,53,อุตรดิตถ์,5308,อำเภอลับแล,18024,18362,36386,18032,18369,36401,14967
2563,53,อุตรดิตถ์,5309,อำเภอทองแสนขัน,13271,13502,26773,13275,13504,26779,9424
2563,53,อุตรดิตถ์,5377,ท้องถิ่นเทศบาลตำบลท่าเสา,7558,7120,14678,7568,7123,14691,7454
2563,53,อุตรดิตถ์,5378,ท้องถิ่นเทศบาลตำบลน้ำริด,3392,3503,6895,3394,3504,6898,2579
2563,53,อุตรดิตถ์,5379,ท้องถิ่นเทศบาลตำบลหาดกรวด,3652,3865,7517,3661,3868,7529,2626
2563,53,อุตรดิตถ์,5380,ท้องถิ่นเทศบาลตำบลจริม,4366,4152,8518,4368,4152,8520,2354
2563,53,อุตรดิตถ์,5381,ท้องถิ่นเทศบาลตำบลคุ้งตะเภา,4266,4562,8828,4273,4566,8839,3468
2563,53,อุตรดิตถ์,5382,ท้องถิ่นเทศบาลตำบลผาจุก,3926,4161,8087,3929,4164,8093,3029
2563,53,อุตรดิตถ์,5383,ท้องถิ่นเทศบาลตำบลบ้านเกาะ,4270,4843,9113,4283,4848,9131,3756
2563,53,อุตรดิตถ์,5384,ท้องถิ่นเทศบาลตำบลทองแสนขัน,2216,2349,4565,2218,2351,4569,1807
2563,53,อุตรดิตถ์,5385,ท้องถิ่นเทศบาลตำบลหัวดง,2688,2840,5528,2689,2840,5529,2133
2563,53,อุตรดิตถ์,5386,ท้องถิ่นเทศบาลตำบลทุ่งยั้ง,4574,5222,9796,4583,5224,9807,4080
2563,53,อุตรดิตถ์,5387,ท้องถิ่นเทศบาลตำบลในเมือง,846,996,1842,853,997,1850,1010
2563,53,อุตรดิตถ์,5388,ท้องถิ่นเทศบาลตำบลท่าสัก,572,626,1198,574,629,1203,567
2563,53,อุตรดิตถ์,5389,ท้องถิ่นเทศบาลตำบลบ้านโคก,1872,1747,3619,1948,1922,3870,1876
2563,53,อุตรดิตถ์,5390,ท้องถิ่นเทศบาลตำบลฟากท่า,376,349,725,376,349,725,425
2563,53,อุตรดิตถ์,5391,ท้องถิ่นเทศบาลตำบลน้ำปาด,1392,1548,2940,1394,1552,2946,1581
2563,53,อุตรดิตถ์,5392,ท้องถิ่นเทศบาลตำบลร่วมจิต,1598,1787,3385,1598,1788,3386,1198
2563,53,อุตรดิตถ์,5393,ท้องถิ่นเทศบาลตำบลท่าปลา,1088,1200,2288,1091,1200,2291,930
2563,53,อุตรดิตถ์,5394,ท้องถิ่นเทศบาลตำบลบ้านแก่ง,1000,1106,2106,1000,1107,2107,880
2563,53,อุตรดิตถ์,5395,ท้องถิ่นเทศบาลตำบลตรอน,810,869,1679,811,869,1680,675
2563,53,อุตรดิตถ์,5396,ท้องถิ่นเทศบาลตำบลวังกะพี้,4524,5144,9668,4530,5148,9678,3397
2563,53,อุตรดิตถ์,5397,ท้องถิ่นเทศบาลตำบลบ้านด่านนาขาม,1900,1966,3866,1901,1967,3868,1378
2563,53,อุตรดิตถ์,5398,ท้องถิ่นเทศบาลตำบลศรีพนมมาศ,1374,1625,2999,1376,1625,3001,1195
2563,53,อุตรดิตถ์,5399,ท้องถิ่นเทศบาลเมืองอุตรดิตถ์,14297,16816,31113,14354,16864,31218,14654
2563,54,แพร่,5401,อำเภอเมืองแพร่,29525,32930,62455,29572,32949,62521,27253
2563,54,แพร่,5402,อำเภอร้องกวาง,17091,18384,35475,17132,18430,35562,12559
2563,54,แพร่,5403,อำเภอลอง,15239,15405,30644,15257,15413,30670,11356
2563,54,แพร่,5404,อำเภอสูงเม่น,33135,36100,69235,33154,36121,69275,27792
2563,54,แพร่,5405,อำเภอเด่นชัย,10064,9622,19686,10072,9632,19704,8371
2563,54,แพร่,5406,อำเภอสอง,20749,21552,42301,20786,21574,42360,16078
2563,54,แพร่,5407,อำเภอวังชิ้น,21186,21324,42510,21236,21381,42617,15226
2563,54,แพร่,5408,อำเภอหนองม่วงไข่,6019,6848,12867,6023,6852,12875,5049
2563,54,แพร่,5482,ท้องถิ่นเทศบาลตำบลแม่ลานนา,3192,3344,6536,3195,3347,6542,2615
2563,54,แพร่,5483,ท้องถิ่นเทศบาลตำบลแม่ปาน,1482,1445,2927,1482,1445,2927,1140
2563,54,แพร่,5484,ท้องถิ่นเทศบาลตำบลเวียงต้า,3207,3150,6357,3208,3151,6359,2435
2563,54,แพร่,5485,ท้องถิ่นเทศบาลตำบลป่าแมต,5629,6403,12032,5638,6405,12043,4899
2563,54,แพร่,5486,ท้องถิ่นเทศบาลตำบลแม่คำมี,3530,3681,7211,3531,3681,7212,2706
2563,54,แพร่,5487,ท้องถิ่นเทศบาลตำบลหนองม่วงไข่,2071,2400,4471,2071,2402,4473,1880
2563,54,แพร่,5488,ท้องถิ่นเทศบาลตำบลวังชิ้น,1430,1507,2937,1435,1507,2942,1417
2563,54,แพร่,5489,ท้องถิ่นเทศบาลตำบลสอง,3067,3643,6710,3073,3648,6721,3101
2563,54,แพร่,5490,ท้องถิ่นเทศบาลตำบลแม่จั๊วะ,1815,1966,3781,1821,1968,3789,1556
2563,54,แพร่,5491,ท้องถิ่นเทศบาลตำบลเด่นชัย,5235,5819,11054,5247,5822,11069,5144
2563,54,แพร่,5492,ท้องถิ่นเทศบาลตำบลสูงเม่น,1749,2036,3785,1751,2039,3790,1896
2563,54,แพร่,5493,ท้องถิ่นเทศบาลตำบลห้วยอ้อ,2269,2586,4855,2274,2586,4860,2218
2563,54,แพร่,5494,ท้องถิ่นเทศบาลตำบลบ้านปิน,1023,1225,2248,1024,1226,2250,820
2563,54,แพร่,5495,ท้องถิ่นเทศบาลตำบลร้องกวาง,5896,6547,12443,5906,6549,12455,6031
2563,54,แพร่,5496,ท้องถิ่นเทศบาลตำบลแม่หล่าย,2043,2363,4406,2047,2371,4418,1965
2563,54,แพร่,5497,ท้องถิ่นเทศบาลตำบลทุ่งโฮ้ง,2850,3250,6100,2856,3255,6111,3139
2563,54,แพร่,5498,ท้องถิ่นเทศบาลตำบลช่อแฮ,4310,4611,8921,4312,4612,8924,3640
2563,54,แพร่,5499,ท้องถิ่นเทศบาลเมืองแพร่,6818,7966,14784,6870,8011,14881,8754
2563,55,น่าน,5501,อำเภอเมืองน่าน,31313,31204,62517,31404,31301,62705,24462
2563,55,น่าน,5502,อำเภอแม่จริม,8262,7945,16207,8287,7970,16257,4892
2563,55,น่าน,5503,อำเภอบ้านหลวง,5784,5750,11534,5785,5757,11542,3949
2563,55,น่าน,5504,อำเภอนาน้อย,14994,14889,29883,15009,14904,29913,10327
2563,55,น่าน,5505,อำเภอปัว,26728,26975,53703,26778,27062,53840,15914
2563,55,น่าน,5506,อำเภอท่าวังผา,22634,22561,45195,22702,22657,45359,14490
2563,55,น่าน,5507,อำเภอเวียงสา,33579,33197,66776,33673,33310,66983,24382
2563,55,น่าน,5508,อำเภอทุ่งช้าง,7743,7553,15296,7857,7740,15597,5190
2563,55,น่าน,5509,อำเภอเชียงกลาง,8728,8815,17543,8753,8837,17590,5762
2563,55,น่าน,5510,อำเภอนาหมื่น,7261,7070,14331,7263,7075,14338,4481
2563,55,น่าน,5511,อำเภอสันติสุข,8035,7648,15683,8046,7660,15706,5102
2563,55,น่าน,5512,อำเภอบ่อเกลือ,7763,7419,15182,7790,7448,15238,4903
2563,55,น่าน,5513,อำเภอสองแคว,6332,5867,12199,6413,5996,12409,3780
2563,55,น่าน,5514,อำเภอภูเพียง,17830,18141,35971,17856,18166,36022,13548
2563,55,น่าน,5515,อำเภอเฉลิมพระเกียรติ,4973,4741,9714,5032,4791,9823,3366
2563,55,น่าน,5592,ท้องถิ่นเทศบาลตำบลเชียงกลาง,4718,4918,9636,4730,4926,9656,3909
2563,55,น่าน,5593,ท้องถิ่นเทศบาลตำบลทุ่งช้าง,1705,1639,3344,1709,1642,3351,1419
2563,55,น่าน,5594,ท้องถิ่นเทศบาลตำบลเวียงสา,1317,1543,2860,1317,1545,2862,1295
2563,55,น่าน,5595,ท้องถิ่นเทศบาลตำบลท่าวังผา,2467,2669,5136,2475,2686,5161,2700
2563,55,น่าน,5596,ท้องถิ่นเทศบาลตำบลปัว,5020,5381,10401,5045,5408,10453,4844
2563,55,น่าน,5597,ท้องถิ่นเทศบาลตำบลนาน้อย,1136,1276,2412,1137,1279,2416,1221
2563,55,น่าน,5598,ท้องถิ่นเทศบาลตำบลหนองแดง,0,0,0,0,0,0,0
2563,55,น่าน,5599,ท้องถิ่นเทศบาลเมืองน่าน,9637,9792,19429,9677,9829,19506,10772
2563,56,พะเยา,5601,อำเภอเมืองพะเยา,21055,22338,43393,21102,22378,43480,17322
2563,56,พะเยา,5602,อำเภอจุน,8724,9625,18349,8750,9641,18391,7144
2563,56,พะเยา,5603,อำเภอเชียงคำ,27336,27407,54743,27763,27869,55632,21292
2563,56,พะเยา,5604,อำเภอเชียงม่วน,4815,4907,9722,4848,4945,9793,3912
2563,56,พะเยา,5605,อำเภอดอกคำใต้,18646,19638,38284,18689,19679,38368,14720
2563,56,พะเยา,5606,อำเภอปง,19734,19577,39311,19831,19670,39501,12375
2563,56,พะเยา,5607,อำเภอแม่ใจ,9836,10466,20302,9849,10478,20327,9431
2563,56,พะเยา,5608,อำเภอภูซาง,11987,12083,24070,12110,12290,24400,9425
2563,56,พะเยา,5609,อำเภอภูกามยาว,6090,6603,12693,6108,6615,12723,4993
2563,56,พะเยา,5677,ท้องถิ่นเทศบาลตำบลบ้านต๋อม,5682,6691,12373,5797,6793,12590,7205
2563,56,พะเยา,5678,ท้องถิ่นเทศบาลตำบลห้วยลาน,4261,4633,8894,4270,4645,8915,3275
2563,56,พะเยา,5679,ท้องถิ่นเทศบาลตำบลฝายกวาง,4277,4522,8799,4295,4543,8838,3756
2563,56,พะเยา,5680,ท้องถิ่นเทศบาลตำบลเวียงลอ,2982,3190,6172,2987,3196,6183,2656
2563,56,พะเยา,5681,ท้องถิ่นเทศบาลตำบลหงส์หิน,3281,3457,6738,3287,3461,6748,2730
2563,56,พะเยา,5682,ท้องถิ่นเทศบาลตำบลจุน,4415,4704,9119,4425,4710,9135,3919
2563,56,พะเยา,5683,ท้องถิ่นเทศบาลตำบลบ้านเหล่า,3841,3984,7825,3845,3989,7834,2938
2563,56,พะเยา,5684,ท้องถิ่นเทศบาลตำบลแม่กา,6229,6852,13081,6249,6871,13120,6743
2563,56,พะเยา,5685,ท้องถิ่นเทศบาลตำบลแม่ปืม,4433,4610,9043,4435,4619,9054,3400
2563,56,พะเยา,5686,ท้องถิ่นเทศบาลตำบลบ้านต๊ำ,3437,3651,7088,3443,3657,7100,3221
2563,56,พะเยา,5687,ท้องถิ่นเทศบาลตำบลท่าวังทอง,8068,7622,15690,8094,7632,15726,9546
2563,56,พะเยา,5688,ท้องถิ่นเทศบาลตำบลดงเจน,3903,4391,8294,3912,4395,8307,3554
2563,56,พะเยา,5689,ท้องถิ่นเทศบาลตำบลสบบง,3797,4061,7858,3818,4112,7930,3376
2563,56,พะเยา,5690,ท้องถิ่นเทศบาลตำบลแม่ใจ,2384,2616,5000,2388,2618,5006,2152
2563,56,พะเยา,5691,ท้องถิ่นเทศบาลตำบลปง,2683,2960,5643,2690,2966,5656,2800
2563,56,พะเยา,5692,ท้องถิ่นเทศบาลตำบลงิม,3333,3404,6737,3337,3411,6748,2474
2563,56,พะเยา,5693,ท้องถิ่นเทศบาลเมืองดอกคำใต้,5853,6779,12632,5864,6792,12656,5348
2563,56,พะเยา,5694,ท้องถิ่นเทศบาลตำบลบ้านถ้ำ,4163,4081,8244,4164,4083,8247,3180
2563,56,พะเยา,5695,ท้องถิ่นเทศบาลตำบลเชียงม่วน,4315,4349,8664,4324,4355,8679,3845
2563,56,พะเยา,5696,ท้องถิ่นเทศบาลตำบลเวียง,2645,2830,5475,2649,2835,5484,2259
2563,56,พะเยา,5697,ท้องถิ่นเทศบาลตำบลเชียงคำ,2811,3369,6180,2823,3389,6212,3667
2563,56,พะเยา,5698,ท้องถิ่นเทศบาลตำบลห้วยข้าวก่ำ,3951,4270,8221,3960,4281,8241,4133
2563,56,พะเยา,5699,ท้องถิ่นเทศบาลเมืองพะเยา,7552,8733,16285,7580,8752,16332,8213
2563,57,เชียงราย,5701,อำเภอเมืองเชียงราย,49100,54088,103188,51868,57126,108994,51067
2563,57,เชียงราย,5702,อำเภอเวียงชัย,18789,19822,38611,18911,19929,38840,15263
2563,57,เชียงราย,5703,อำเภอเชียงของ,12034,12164,24198,12413,12891,25304,10431
2563,57,เชียงราย,5704,อำเภอเทิง,36608,37046,73654,37186,37653,74839,28705
2563,57,เชียงราย,5705,อำเภอพาน,54014,57029,111043,54838,57917,112755,47738
2563,57,เชียงราย,5706,อำเภอป่าแดด,5887,5978,11865,5893,5985,11878,4044
2563,57,เชียงราย,5707,อำเภอแม่จัน,29255,30964,60219,34002,36351,70353,28143
2563,57,เชียงราย,5708,อำเภอเชียงแสน,21170,21753,42923,23754,24964,48718,21354
2563,57,เชียงราย,5709,อำเภอแม่สาย,22065,23494,45559,32931,36839,69770,28865
2563,57,เชียงราย,5710,อำเภอแม่สรวย,36840,36338,73178,39324,38783,78107,29052
2563,57,เชียงราย,5711,อำเภอเวียงป่าเป้า,28852,29303,58155,30385,30851,61236,24366
2563,57,เชียงราย,5712,อำเภอพญาเม็งราย,13469,13607,27076,13625,13790,27415,9667
2563,57,เชียงราย,5713,อำเภอเวียงแก่น,17193,16506,33699,18416,17937,36353,13030
2563,57,เชียงราย,5714,อำเภอขุนตาล,6883,7183,14066,6890,7193,14083,5504
2563,57,เชียงราย,5715,อำเภอแม่ฟ้าหลวง,28838,27978,56816,38576,38779,77355,24822
2563,57,เชียงราย,5716,อำเภอแม่ลาว,11977,12594,24571,12044,12663,24707,10856
2563,57,เชียงราย,5717,อำเภอเวียงเชียงรุ้ง,11827,12033,23860,11862,12059,23921,8945
2563,57,เชียงราย,5718,อำเภอดอยหลวง,9253,9170,18423,9382,9326,18708,8615
2563,57,เชียงราย,5764,ท้องถิ่นเทศบาลตำบลแม่ยาว,8673,8781,17454,10700,10927,21627,8977
2563,57,เชียงราย,5765,ท้องถิ่นเทศบาลตำบลห้วยซ้อ,6082,5966,12048,6212,6204,12416,5237
2563,57,เชียงราย,5766,ท้องถิ่นเทศบาลตำบลไม้ยา,5312,5306,10618,5317,5313,10630,3749
2563,57,เชียงราย,5767,ท้องถิ่นเทศบาลตำบลครึ่ง,3182,3162,6344,3196,3178,6374,2674
2563,57,เชียงราย,5768,ท้องถิ่นเทศบาลตำบลป่าอ้อดอนชัย,5204,5877,11081,5353,6010,11363,5324
2563,57,เชียงราย,5769,ท้องถิ่นเทศบาลตำบลยางฮอม,5384,5595,10979,5410,5629,11039,4003
2563,57,เชียงราย,5770,ท้องถิ่นเทศบาลตำบลเวียง,4489,4544,9033,4709,4837,9546,4198
2563,57,เชียงราย,5771,ท้องถิ่นเทศบาลตำบลนางแล,4941,5428,10369,5586,6062,11648,5737
2563,57,เชียงราย,5772,ท้องถิ่นเทศบาลตำบลป่าซาง,4810,5370,10180,5469,6132,11601,5548
2563,57,เชียงราย,5773,ท้องถิ่นเทศบาลตำบลเวียงพางคำ,4762,4950,9712,10359,11934,22293,9670
2563,57,เชียงราย,5774,ท้องถิ่นเทศบาลตำบลบ้านดู่,8565,9818,18383,9497,10753,20250,13899
2563,57,เชียงราย,5775,ท้องถิ่นเทศบาลตำบลบ้านเหล่า,2018,2026,4044,2019,2028,4047,1692
2563,57,เชียงราย,5776,ท้องถิ่นเทศบาลตำบลแม่ลาว,852,954,1806,858,958,1816,803
2563,57,เชียงราย,5777,ท้องถิ่นเทศบาลตำบลป่าก่อดำ,2010,2199,4209,2026,2214,4240,1989
2563,57,เชียงราย,5778,ท้องถิ่นเทศบาลตำบลบ้านต้า,2950,3153,6103,2953,3157,6110,2245
2563,57,เชียงราย,5779,ท้องถิ่นเทศบาลตำบลพญาเม็งราย,1968,2155,4123,2024,2193,4217,2209
2563,57,เชียงราย,5780,ท้องถิ่นเทศบาลตำบลเวียงป่าเป้า,2029,2404,4433,2081,2466,4547,2386
2563,57,เชียงราย,5781,ท้องถิ่นเทศบาลตำบลแม่ขะจาน,1366,1553,2919,1369,1557,2926,1579
2563,57,เชียงราย,5782,ท้องถิ่นเทศบาลตำบลเจดีย์หลวง,2368,2422,4790,2384,2436,4820,2102
2563,57,เชียงราย,5783,ท้องถิ่นเทศบาลตำบลแม่สรวย,669,713,1382,718,764,1482,1093
2563,57,เชียงราย,5784,ท้องถิ่นเทศบาลตำบลห้วยไคร้,2095,2358,4453,2331,2705,5036,2501
2563,57,เชียงราย,5785,ท้องถิ่นเทศบาลตำบลแม่สาย,8481,8869,17350,13196,15125,28321,13624
2563,57,เชียงราย,5786,ท้องถิ่นเทศบาลตำบลเวียงเชียงแสน,2307,2647,4954,3045,3452,6497,3326
2563,57,เชียงราย,5787,ท้องถิ่นเทศบาลตำบลสันทราย,1183,1329,2512,1240,1367,2607,1234
2563,57,เชียงราย,5788,ท้องถิ่นเทศบาลตำบลแม่จัน,1510,1706,3216,1704,1954,3658,2420
2563,57,เชียงราย,5789,ท้องถิ่นเทศบาลตำบลแม่คำ,2125,2373,4498,2161,2417,4578,2153
2563,57,เชียงราย,5790,ท้องถิ่นเทศบาลตำบลจันจว้า,6659,7453,14112,6745,7553,14298,6155
2563,57,เชียงราย,5791,ท้องถิ่นเทศบาลตำบลป่าแดด,3104,3235,6339,3109,3248,6357,2408
2563,57,เชียงราย,5792,ท้องถิ่นเทศบาลตำบลป่าแงะ,3739,3872,7611,3744,3879,7623,3047
2563,57,เชียงราย,5793,ท้องถิ่นเทศบาลตำบลเมืองพาน,2999,3449,6448,3024,3473,6497,3500
2563,57,เชียงราย,5794,ท้องถิ่นเทศบาลตำบลเวียงเทิง,2303,2668,4971,2337,2708,5045,2744
2563,57,เชียงราย,5795,ท้องถิ่นเทศบาลตำบลบ้านปล้อง,1960,2071,4031,1962,2073,4035,1592
2563,57,เชียงราย,5796,ท้องถิ่นเทศบาลตำบลเวียงเชียงของ,1781,2000,3781,1792,2027,3819,2342
2563,57,เชียงราย,5797,ท้องถิ่นเทศบาลตำบลบุญเรือง,2911,3059,5970,2920,3072,5992,2513
2563,57,เชียงราย,5798,ท้องถิ่นเทศบาลตำบลเวียงชัย,3144,3596,6740,3176,3614,6790,3077
2563,57,เชียงราย,5799,ท้องถิ่นเทศบาลนครเชียงราย,33288,37314,70602,36934,40611,77545,50608
2563,58,แม่ฮ่องสอน,5801,อำเภอเมืองแม่ฮ่องสอน,19848,19104,38952,28328,27839,56167,22862
2563,58,แม่ฮ่องสอน,5802,อำเภอขุนยวม,9653,9140,18793,10333,9719,20052,7622
2563,58,แม่ฮ่องสอน,5803,อำเภอปาย,15405,14333,29738,18176,16874,35050,14988
2563,58,แม่ฮ่องสอน,5804,อำเภอแม่สะเรียง,25043,24722,49765,26423,25958,52381,21357
2563,58,แม่ฮ่องสอน,5805,อำเภอแม่ลาน้อย,16179,15971,32150,16288,16046,32334,10719
2563,58,แม่ฮ่องสอน,5806,อำเภอสบเมย,18339,17825,36164,23368,22622,45990,17050
2563,58,แม่ฮ่องสอน,5807,อำเภอปางมะผ้า,8720,8283,17003,11185,10518,21703,8597
2563,58,แม่ฮ่องสอน,5895,ท้องถิ่นเทศบาลตำบลแม่ลาน้อย,1770,1794,3564,1797,1818,3615,1778
2563,58,แม่ฮ่องสอน,5896,ท้องถิ่นเทศบาลตำบลแม่สะเรียง,1185,1365,2550,1346,1505,2851,1945
2563,58,แม่ฮ่องสอน,5897,ท้องถิ่นเทศบาลตำบลปาย,1063,1176,2239,1753,1845,3598,1890
2563,58,แม่ฮ่องสอน,5898,ท้องถิ่นเทศบาลตำบลขุนยวม,1584,1645,3229,1703,1774,3477,1709
2563,58,แม่ฮ่องสอน,5899,ท้องถิ่นเทศบาลเมืองแม่ฮ่องสอน,3224,3400,6624,3611,3720,7331,4646
2563,60,นครสวรรค์,6001,อำเภอเมืองนครสวรรค์,77394,82090,159484,77556,82180,159736,69809
2563,60,นครสวรรค์,6002,อำเภอโกรกพระ,13057,13730,26787,13070,13739,26809,9614
2563,60,นครสวรรค์,6003,อำเภอชุมแสง,25922,27539,53461,25948,27552,53500,19299
2563,60,นครสวรรค์,6004,อำเภอหนองบัว,26991,27469,54460,27009,27476,54485,23201
2563,60,นครสวรรค์,6005,อำเภอบรรพตพิสัย,39821,41596,81417,39889,41624,81513,28538
2563,60,นครสวรรค์,6006,อำเภอเก้าเลี้ยว,13942,14610,28552,13960,14621,28581,10488
2563,60,นครสวรรค์,6007,อำเภอตาคลี,38528,39320,77848,38571,39354,77925,29788
2563,60,นครสวรรค์,6008,อำเภอท่าตะโก,29572,30900,60472,29605,30915,60520,23482
2563,60,นครสวรรค์,6009,อำเภอไพศาลี,29670,30245,59915,29681,30263,59944,20948
2563,60,นครสวรรค์,6010,อำเภอพยุหะคีรี,24291,25651,49942,24327,25670,49997,21002
2563,60,นครสวรรค์,6011,อำเภอลาดยาว,36146,37579,73725,36176,37609,73785,27641
2563,60,นครสวรรค์,6012,อำเภอตากฟ้า,16783,17389,34172,16792,17393,34185,12604
2563,60,นครสวรรค์,6013,อำเภอแม่วงก์,24956,25211,50167,24982,25222,50204,18663
2563,60,นครสวรรค์,6014,อำเภอแม่เปิน,10511,10394,20905,10512,10395,20907,6903
2563,60,นครสวรรค์,6015,อำเภอชุมตาบง,8940,9077,18017,8942,9078,18020,6400
2563,60,นครสวรรค์,6082,ท้องถิ่นเทศบาลตำบลตากฟ้า,2632,2820,5452,2644,2828,5472,2738
2563,60,นครสวรรค์,6083,ท้องถิ่นเทศบาลตำบลลาดยาว,2834,3197,6031,2843,3206,6049,3478
2563,60,นครสวรรค์,6084,ท้องถิ่นเทศบาลตำบลศาลเจ้าไก่ต่อ,1561,1754,3315,1562,1756,3318,1444
2563,60,นครสวรรค์,6085,ท้องถิ่นเทศบาลตำบลพยุหะ,2588,3003,5591,2601,3010,5611,2965
2563,60,นครสวรรค์,6086,ท้องถิ่นเทศบาลตำบลท่าน้ำอ้อยม่วงหัก,2422,2628,5050,2428,2631,5059,2737
2563,60,นครสวรรค์,6087,ท้องถิ่นเทศบาลตำบลไพศาลี,4882,5438,10320,4889,5443,10332,4946
2563,60,นครสวรรค์,6088,ท้องถิ่นเทศบาลตำบลท่าตะโก,2629,2976,5605,2639,2992,5631,2878
2563,60,นครสวรรค์,6089,ท้องถิ่นเทศบาลตำบลช่องแค,1464,1579,3043,1466,1579,3045,1062
2563,60,นครสวรรค์,6090,ท้องถิ่นเทศบาลตำบลเก้าเลี้ยว,2753,2994,5747,2766,3000,5766,2293
2563,60,นครสวรรค์,6091,ท้องถิ่นเทศบาลตำบลบรรพตพิสัย,1834,2016,3850,1839,2016,3855,1828
2563,60,นครสวรรค์,6092,ท้องถิ่นเทศบาลเมืองหนองบัว,5551,6070,11621,5555,6082,11637,4981
2563,60,นครสวรรค์,6093,ท้องถิ่นเทศบาลตำบลทับกฤช,1024,1132,2156,1028,1134,2162,820
2563,60,นครสวรรค์,6094,ท้องถิ่นเทศบาลตำบลบางประมุง,2463,2551,5014,2469,2552,5021,1565
2563,60,นครสวรรค์,6095,ท้องถิ่นเทศบาลตำบลโกรกพระ,1092,1189,2281,1094,1191,2285,997
2563,60,นครสวรรค์,6096,ท้องถิ่นเทศบาลตำบลหนองเบน,1344,1609,2953,1345,1615,2960,1495
2563,60,นครสวรรค์,6097,ท้องถิ่นเทศบาลเมืองตาคลี,11065,12051,23116,11112,12080,23192,9902
2563,60,นครสวรรค์,6098,ท้องถิ่นเทศบาลเมืองชุมแสง,3527,4015,7542,3537,4026,7563,3611
2563,60,นครสวรรค์,6099,ท้องถิ่นเทศบาลนครนครสวรรค์,38037,42295,80332,38542,42697,81239,42683
2563,61,อุทัยธานี,6101,อำเภอเมืองอุทัยธานี,17015,18459,35474,17027,18472,35499,13501
2563,61,อุทัยธานี,6102,อำเภอทัพทัน,7792,8162,15954,7796,8167,15963,5393
2563,61,อุทัยธานี,6103,อำเภอสว่างอารมณ์,14938,15018,29956,14946,15039,29985,10929
2563,61,อุทัยธานี,6104,อำเภอหนองฉาง,16557,17554,34111,16571,17566,34137,11772
2563,61,อุทัยธานี,6105,อำเภอหนองขาหย่าง,7259,8076,15335,7263,8077,15340,5773
2563,61,อุทัยธานี,6106,อำเภอบ้านไร่,31499,31840,63339,31566,31914,63480,24536
2563,61,อุทัยธานี,6107,อำเภอลานสัก,27552,27795,55347,27596,27847,55443,18767
2563,61,อุทัยธานี,6108,อำเภอห้วยคต,9943,10161,20104,9960,10170,20130,7408
2563,61,อุทัยธานี,6189,ท้องถิ่นเทศบาลตำบลหนองสระ,1008,1138,2146,1008,1138,2146,668
2563,61,อุทัยธานี,6190,ท้องถิ่นเทศบาลตำบลลานสัก,1685,1725,3410,1689,1728,3417,2126
2563,61,อุทัยธานี,6191,ท้องถิ่นเทศบาลตำบลเมืองการุ้ง,1003,1130,2133,1005,1130,2135,991
2563,61,อุทัยธานี,6192,ท้องถิ่นเทศบาลตำบลบ้านไร่,1250,1300,2550,1251,1300,2551,1391
2563,61,อุทัยธานี,6193,ท้องถิ่นเทศบาลตำบลหนองขาหย่าง,281,311,592,281,311,592,326
2563,61,อุทัยธานี,6194,ท้องถิ่นเทศบาลตำบลหนองฉาง,1302,1470,2772,1303,1472,2775,1888
2563,61,อุทัยธานี,6195,ท้องถิ่นเทศบาลตำบลเขาบางแกรก,2984,3252,6236,2988,3253,6241,2369
2563,61,อุทัยธานี,6196,ท้องถิ่นเทศบาลตำบลสว่างอารมณ์,795,839,1634,799,841,1640,966
2563,61,อุทัยธานี,6197,ท้องถิ่นเทศบาลตำบลทัพทัน,4211,4627,8838,4216,4635,8851,3614
2563,61,อุทัยธานี,6198,ท้องถิ่นเทศบาลตำบลตลุกดู่,5492,5796,11288,5494,5802,11296,3634
2563,61,อุทัยธานี,6199,ท้องถิ่นเทศบาลเมืองอุทัยธานี,6525,7652,14177,6563,7684,14247,9614
2563,62,กำแพงเพชร,6201,อำเภอเมืองกำแพงเพชร,66670,68735,135405,66737,68784,135521,52519
2563,62,กำแพงเพชร,6202,อำเภอไทรงาม,22563,22796,45359,22585,22806,45391,14860
2563,62,กำแพงเพชร,6203,อำเภอคลองลาน,20232,19494,39726,20282,19537,39819,14910
2563,62,กำแพงเพชร,6204,อำเภอขาณุวรลักษบุรี,34298,34773,69071,34325,34787,69112,25743
2563,62,กำแพงเพชร,6205,อำเภอคลองขลุง,27485,28575,56060,27560,28633,56193,23406
2563,62,กำแพงเพชร,6206,อำเภอพรานกระต่าย,24374,24345,48719,24381,24351,48732,16207
2563,62,กำแพงเพชร,6207,อำเภอลานกระบือ,16356,16415,32771,16366,16435,32801,11122
2563,62,กำแพงเพชร,6208,อำเภอทรายทองวัฒนา,6991,6951,13942,6997,6954,13951,4160
2563,62,กำแพงเพชร,6209,อำเภอปางศิลาทอง,15157,15206,30363,15181,15223,30404,11049
2563,62,กำแพงเพชร,6210,อำเภอบึงสามัคคี,9118,9179,18297,9133,9188,18321,7245
2563,62,กำแพงเพชร,6211,อำเภอโกสัมพีนคร,14110,14096,28206,14126,14101,28227,10629
2563,62,กำแพงเพชร,6278,ท้องถิ่นเทศบาลเมืองปางมะค่า,8844,8809,17653,8851,8820,17671,6763
2563,62,กำแพงเพชร,6279,ท้องถิ่นเทศบาลตำบลบ้านพราน,3508,3483,6991,3528,3502,7030,2844
2563,62,กำแพงเพชร,6280,ท้องถิ่นเทศบาลตำบลระหาน,3547,3674,7221,3573,3701,7274,3545
2563,62,กำแพงเพชร,6281,ท้องถิ่นเทศบาลตำบลคลองพิไกร,2883,3043,5926,2884,3045,5929,2229
2563,62,กำแพงเพชร,6282,ท้องถิ่นเทศบาลตำบลนิคมทุ่งโพธิ์ทะเล,4503,4683,9186,4511,4693,9204,3613
2563,62,กำแพงเพชร,6283,ท้องถิ่นเทศบาลตำบลวังยาง,2698,2774,5472,2705,2784,5489,2112
2563,62,กำแพงเพชร,6284,ท้องถิ่นเทศบาลตำบลทุ่งทราย,4306,4486,8792,4310,4490,8800,3233
2563,62,กำแพงเพชร,6285,ท้องถิ่นเทศบาลตำบลเทพนคร,9744,10281,20025,9753,10289,20042,8332
2563,62,กำแพงเพชร,6286,ท้องถิ่นเทศบาลตำบลคลองลานพัฒนา,11061,11454,22515,11130,11509,22639,8484
2563,62,กำแพงเพชร,6287,ท้องถิ่นเทศบาลตำบลช่องลม,2867,2864,5731,2868,2865,5733,1770
2563,62,กำแพงเพชร,6288,ท้องถิ่นเทศบาลตำบลลานกระบือ,2103,2149,4252,2118,2166,4284,2492
2563,62,กำแพงเพชร,6289,ท้องถิ่นเทศบาลตำบลพรานกระต่าย,4180,4556,8736,4187,4559,8746,3667
2563,62,กำแพงเพชร,6290,ท้องถิ่นเทศบาลตำบลท่ามะเขือ,1733,1853,3586,1745,1860,3605,2024
2563,62,กำแพงเพชร,6291,ท้องถิ่นเทศบาลตำบลท่าพุทรา,752,767,1519,754,767,1521,625
2563,62,กำแพงเพชร,6292,ท้องถิ่นเทศบาลตำบลคลองขลุง,936,1016,1952,953,1027,1980,1019
2563,62,กำแพงเพชร,6293,ท้องถิ่นเทศบาลตำบลสลกบาตร,3889,4264,8153,3905,4291,8196,4406
2563,62,กำแพงเพชร,6294,ท้องถิ่นเทศบาลตำบลขาณุวรลักษบุรี,3856,4118,7974,3924,4186,8110,3403
2563,62,กำแพงเพชร,6295,ท้องถิ่นเทศบาลตำบลไทรงาม,2386,2586,4972,2393,2601,4994,2458
2563,62,กำแพงเพชร,6296,ท้องถิ่นเทศบาลตำบลปากดง,1564,1704,3268,1567,1706,3273,1324
2563,62,กำแพงเพชร,6297,ท้องถิ่นเทศบาลตำบลนครชุม,3230,3648,6878,3237,3653,6890,3454
2563,62,กำแพงเพชร,6298,ท้องถิ่นเทศบาลตำบลคลองแม่ลาย,2842,3005,5847,2847,3011,5858,2428
2563,62,กำแพงเพชร,6299,ท้องถิ่นเทศบาลเมืองกำแพงเพชร,13099,14920,28019,13295,15083,28378,16231
2563,63,ตาก,6301,อำเภอเมืองตาก,37021,37355,74376,37105,37423,74528,29220
2563,63,ตาก,6302,อำเภอบ้านตาก,15531,15783,31314,15569,15818,31387,10829
2563,63,ตาก,6303,อำเภอสามเงา,12673,13022,25695,12683,13035,25718,9447
2563,63,ตาก,6304,อำเภอแม่ระมาด,21015,20402,41417,25530,24213,49743,16697
2563,63,ตาก,6305,อำเภอท่าสองยาง,35068,33554,68622,46635,44035,90670,23858
2563,63,ตาก,6306,อำเภอแม่สอด,38285,38325,76610,48761,47783,96544,36020
2563,63,ตาก,6307,อำเภอพบพระ,29740,29182,58922,42340,40717,83057,20064
2563,63,ตาก,6308,อำเภออุ้มผาง,15643,14662,30305,22558,20847,43405,11095
2563,63,ตาก,6309,อำเภอวังเจ้า,14530,14385,28915,15118,14994,30112,9102
2563,63,ตาก,6386,ท้องถิ่นเทศบาลตำบลไม้งาม,6516,5222,11738,6530,5232,11762,6340
2563,63,ตาก,6387,ท้องถิ่นเทศบาลตำบลวังเจ้า,2103,2130,4233,2105,2133,4238,1933
2563,63,ตาก,6388,ท้องถิ่นเทศบาลตำบลอุ้มผาง,857,882,1739,1912,1794,3706,898
2563,63,ตาก,6389,ท้องถิ่นเทศบาลตำบลพบพระ,2524,2426,4950,3275,3075,6350,2702
2563,63,ตาก,6390,ท้องถิ่นเทศบาลตำบลแม่กุ,3115,3202,6317,3202,3302,6504,2861
2563,63,ตาก,6391,ท้องถิ่นเทศบาลตำบลท่าสายลวด,3019,2945,5964,12655,11889,24544,4641
2563,63,ตาก,6392,ท้องถิ่นเทศบาลตำบลแม่ต้าน,1284,1327,2611,1896,1936,3832,1377
2563,63,ตาก,6393,ท้องถิ่นเทศบาลตำบลแม่ระมาด,1857,1879,3736,1991,2000,3991,1846
2563,63,ตาก,6394,ท้องถิ่นเทศบาลตำบลแม่จะเรา,2554,2678,5232,2590,2721,5311,2153
2563,63,ตาก,6395,ท้องถิ่นเทศบาลตำบลสามเงา,2177,2417,4594,2182,2419,4601,2085
2563,63,ตาก,6396,ท้องถิ่นเทศบาลตำบลบ้านตาก,3024,3505,6529,3048,3520,6568,2700
2563,63,ตาก,6397,ท้องถิ่นเทศบาลตำบลทุ่งกระเชาะ,2985,3039,6024,2989,3045,6034,2101
2563,63,ตาก,6398,ท้องถิ่นเทศบาลนครแม่สอด,13149,14201,27350,20670,20911,41581,19482
2563,63,ตาก,6399,ท้องถิ่นเทศบาลเมืองตาก,7454,8345,15799,7607,8472,16079,7439
2563,64,สุโขทัย,6401,อำเภอเมืองสุโขทัย,29399,31632,61031,29430,31649,61079,22659
2563,64,สุโขทัย,6402,อำเภอบ้านด่านลานหอย,22083,22038,44121,22187,22131,44318,14312
2563,64,สุโขทัย,6403,อำเภอคีรีมาศ,22772,23326,46098,22789,23340,46129,14276
2563,64,สุโขทัย,6404,อำเภอกงไกรลาศ,29014,30454,59468,29028,30465,59493,20400
2563,64,สุโขทัย,6405,อำเภอศรีสัชนาลัย,34289,35541,69830,34333,35582,69915,26755
2563,64,สุโขทัย,6406,อำเภอศรีสำโรง,29555,32021,61576,29585,32042,61627,22418
2563,64,สุโขทัย,6407,อำเภอสวรรคโลก,24213,26206,50419,24225,26216,50441,20004
2563,64,สุโขทัย,6408,อำเภอศรีนคร,10995,11574,22569,11009,11581,22590,8157
2563,64,สุโขทัย,6409,อำเภอทุ่งเสลี่ยม,20657,21146,41803,20690,21163,41853,14656
2563,64,สุโขทัย,6484,ท้องถิ่นเทศบาลตำบลในเมือง,3949,4194,8143,3952,4196,8148,3350
2563,64,สุโขทัย,6485,ท้องถิ่นเทศบาลตำบลป่ากุมเกาะ,3725,4015,7740,3726,4017,7743,2767
2563,64,สุโขทัย,6486,ท้องถิ่นเทศบาลตำบลบ้านกล้วย,7581,8519,16100,7593,8535,16128,7105
2563,64,สุโขทัย,6487,ท้องถิ่นเทศบาลตำบลทุ่งเสลี่ยม,3489,3917,7406,3492,3925,7417,3018
2563,64,สุโขทัย,6488,ท้องถิ่นเทศบาลตำบลศรีนคร,1435,1644,3079,1440,1648,3088,1677
2563,64,สุโขทัย,6489,ท้องถิ่นเทศบาลตำบลศรีสำโรง,3379,3895,7274,3385,3902,7287,3463
2563,64,สุโขทัย,6490,ท้องถิ่นเทศบาลตำบลหาดเสี้ยว,3086,3494,6580,3090,3499,6589,3584
2563,64,สุโขทัย,6491,ท้องถิ่นเทศบาลเมืองศรีสัชนาลัย,7184,7912,15096,7184,7913,15097,5772
2563,64,สุโขทัย,6492,ท้องถิ่นเทศบาลตำบลกงไกรลาศ,1950,2166,4116,1952,2167,4119,2016
2563,64,สุโขทัย,6493,ท้องถิ่นเทศบาลตำบลบ้านโตนด,1423,1607,3030,1425,1607,3032,1602
2563,64,สุโขทัย,6494,ท้องถิ่นเทศบาลตำบลทุ่งหลวง,3414,3722,7136,3414,3722,7136,2382
2563,64,สุโขทัย,6495,ท้องถิ่นเทศบาลตำบลลานหอย,1730,1868,3598,1733,1869,3602,1707
2563,64,สุโขทัย,6496,ท้องถิ่นเทศบาลตำบลเมืองเก่า,3335,3829,7164,3339,3829,7168,2581
2563,64,สุโขทัย,6497,ท้องถิ่นเทศบาลตำบลบ้านสวน,2073,2300,4373,2073,2301,4374,1703
2563,64,สุโขทัย,6498,ท้องถิ่นเทศบาลเมืองสวรรคโลก,7300,8127,15427,7323,8142,15465,6724
2563,64,สุโขทัย,6499,ท้องถิ่นเทศบาลเมืองสุโขทัยธานี,6530,7484,14014,6552,7493,14045,7072
2563,65,พิษณุโลก,6501,อำเภอเมืองพิษณุโลก,86707,92711,179418,86870,92778,179648,84862
2563,65,พิษณุโลก,6502,อำเภอนครไทย,33398,33682,67080,33459,33738,67197,23603
2563,65,พิษณุโลก,6503,อำเภอชาติตระการ,18096,17672,35768,18145,17708,35853,12257
2563,65,พิษณุโลก,6504,อำเภอบางระกำ,36567,37811,74378,36618,37872,74490,25986
2563,65,พิษณุโลก,6505,อำเภอบางกระทุ่ม,15908,16789,32697,15918,16809,32727,11545
2563,65,พิษณุโลก,6506,อำเภอพรหมพิราม,39672,41680,81352,39703,41696,81399,30550
2563,65,พิษณุโลก,6507,อำเภอวัดโบสถ์,14624,14919,29543,14632,14929,29561,11136
2563,65,พิษณุโลก,6508,อำเภอวังทอง,56379,57685,114064,56618,57818,114436,43228
2563,65,พิษณุโลก,6509,อำเภอเนินมะปราง,19140,19364,38504,19153,19374,38527,14635
2563,65,พิษณุโลก,6580,ท้องถิ่นเทศบาลเมืองอรัญญิก,16818,13536,30354,16858,13556,30414,14023
2563,65,พิษณุโลก,6581,ท้องถิ่นเทศบาลตำบลบ้านมุง,3467,3469,6936,3477,3474,6951,2566
2563,65,พิษณุโลก,6582,ท้องถิ่นเทศบาลตำบลบึงระมาณ,2123,2273,4396,2125,2276,4401,1676
2563,65,พิษณุโลก,6583,ท้องถิ่นเทศบาลตำบลพลายชุมพล,3513,4041,7554,3524,4043,7567,4165
2563,65,พิษณุโลก,6584,ท้องถิ่นเทศบาลตำบลพันเสา,3002,3072,6074,3006,3074,6080,2072
2563,65,พิษณุโลก,6585,ท้องถิ่นเทศบาลตำบลไทรย้อย,4221,4314,8535,4227,4315,8542,3110
2563,65,พิษณุโลก,6586,ท้องถิ่นเทศบาลตำบลบ้านแยง,5029,4857,9886,5052,4883,9935,4877
2563,65,พิษณุโลก,6587,ท้องถิ่นเทศบาลตำบลเนินมะปราง,1664,1778,3442,1670,1780,3450,1583
2563,65,พิษณุโลก,6588,ท้องถิ่นเทศบาลตำบลวังทอง,2036,2301,4337,2040,2305,4345,1713
2563,65,พิษณุโลก,6589,ท้องถิ่นเทศบาลตำบลวัดโบสถ์,3796,4227,8023,3802,4229,8031,3958
2563,65,พิษณุโลก,6590,ท้องถิ่นเทศบาลตำบลวงฆ้อง,1540,1611,3151,1544,1611,3155,1545
2563,65,พิษณุโลก,6591,ท้องถิ่นเทศบาลตำบลพรหมพิราม,525,596,1121,528,599,1127,544
2563,65,พิษณุโลก,6592,ท้องถิ่นเทศบาลตำบลบางกระทุ่ม,681,708,1389,683,709,1392,615
2563,65,พิษณุโลก,6593,ท้องถิ่นเทศบาลตำบลเนินกุ่ม,5840,6158,11998,5844,6161,12005,4505
2563,65,พิษณุโลก,6594,ท้องถิ่นเทศบาลตำบลปลักแรด,1695,1873,3568,1699,1875,3574,1303
2563,65,พิษณุโลก,6595,ท้องถิ่นเทศบาลตำบลบางระกำ,2028,2245,4273,2030,2249,4279,1975
2563,65,พิษณุโลก,6596,ท้องถิ่นเทศบาลตำบลป่าแดง,2614,2731,5345,2619,2737,5356,2564
2563,65,พิษณุโลก,6597,ท้องถิ่นเทศบาลตำบลนครไทย,4361,4656,9017,4375,4661,9036,4088
2563,65,พิษณุโลก,6598,ท้องถิ่นเทศบาลตำบลบ้านใหม่,913,1017,1930,916,1019,1935,790
2563,65,พิษณุโลก,6599,ท้องถิ่นเทศบาลนครพิษณุโลก,28901,34840,63741,29099,34969,64068,36826
2563,66,พิจิตร,6601,อำเภอเมืองพิจิตร,35270,37641,72911,35300,37658,72958,26105
2563,66,พิจิตร,6602,อำเภอวังทรายพูน,8675,8834,17509,8682,8841,17523,5842
2563,66,พิจิตร,6603,อำเภอโพธิ์ประทับช้าง,16707,17167,33874,16724,17188,33912,11452
2563,66,พิจิตร,6604,อำเภอตะพานหิน,22088,23159,45247,22108,23172,45280,15874
2563,66,พิจิตร,6605,อำเภอบางมูลนาก,9960,10613,20573,9970,10624,20594,7873
2563,66,พิจิตร,6606,อำเภอโพทะเล,26696,27918,54614,26726,27934,54660,18686
2563,66,พิจิตร,6607,อำเภอสามง่าม,12794,13003,25797,12797,13007,25804,8734
2563,66,พิจิตร,6608,อำเภอทับคล้อ,16629,17225,33854,16633,17232,33865,12531
2563,66,พิจิตร,6609,อำเภอสากเหล็ก,8990,9110,18100,8995,9115,18110,6086
2563,66,พิจิตร,6610,อำเภอบึงนาราง,14109,14626,28735,14124,14642,28766,10745
2563,66,พิจิตร,6611,อำเภอดงเจริญ,8515,8830,17345,8532,8838,17370,6239
2563,66,พิจิตร,6612,อำเภอวชิรบารมี,15329,15692,31021,15342,15703,31045,10897
2563,66,พิจิตร,6676,ท้องถิ่นเทศบาลตำบลหนองพยอม,3328,3466,6794,3329,3466,6795,2290
2563,66,พิจิตร,6677,ท้องถิ่นเทศบาลตำบลหนองปล้อง,1675,1734,3409,1676,1734,3410,1142
2563,66,พิจิตร,6678,ท้องถิ่นเทศบาลตำบลเนินมะกอก,3265,3514,6779,3273,3531,6804,2981
2563,66,พิจิตร,6679,ท้องถิ่นเทศบาลตำบลหอไกร,2875,3007,5882,2884,3019,5903,2671
2563,66,พิจิตร,6680,ท้องถิ่นเทศบาลตำบลดงป่าคำ,2342,2425,4767,2342,2425,4767,1607
2563,66,พิจิตร,6681,ท้องถิ่นเทศบาลตำบลเนินปอ,4531,4536,9067,4531,4538,9069,3069
2563,66,พิจิตร,6682,ท้องถิ่นเทศบาลตำบลสำนักขุนเณร,1098,1112,2210,1099,1116,2215,886
2563,66,พิจิตร,6683,ท้องถิ่นเทศบาลตำบลสากเหล็ก,2489,2758,5247,2492,2760,5252,2364
2563,66,พิจิตร,6684,ท้องถิ่นเทศบาลตำบลทับคล้อ,2121,2318,4439,2127,2321,4448,1753
2563,66,พิจิตร,6685,ท้องถิ่นเทศบาลตำบลเขาทราย,2154,2201,4355,2155,2201,4356,1890
2563,66,พิจิตร,6686,ท้องถิ่นเทศบาลตำบลสามง่าม,2240,2548,4788,2242,2551,4793,2257
2563,66,พิจิตร,6687,ท้องถิ่นเทศบาลตำบลกำแพงดิน,1051,1141,2192,1052,1142,2194,823
2563,66,พิจิตร,6688,ท้องถิ่นเทศบาลตำบลโพทะเล,1210,1281,2491,1212,1282,2494,1015
2563,66,พิจิตร,6689,ท้องถิ่นเทศบาลตำบลท่าเสา,749,738,1487,749,738,1487,524
2563,66,พิจิตร,6690,ท้องถิ่นเทศบาลตำบลวังตะกู,814,807,1621,820,809,1629,648
2563,66,พิจิตร,6691,ท้องถิ่นเทศบาลตำบลบางไผ่,718,794,1512,719,797,1516,627
2563,66,พิจิตร,6692,ท้องถิ่นเทศบาลตำบลโพธิ์ประทับช้าง,4637,4984,9621,4649,4992,9641,3575
2563,66,พิจิตร,6693,ท้องถิ่นเทศบาลตำบลวังทรายพูน,1616,1682,3298,1617,1683,3300,1224
2563,66,พิจิตร,6694,ท้องถิ่นเทศบาลตำบลหัวดง,1535,1622,3157,1544,1626,3170,1174
2563,66,พิจิตร,6695,ท้องถิ่นเทศบาลตำบลวังกรด,1490,1517,3007,1494,1520,3014,1045
2563,66,พิจิตร,6696,ท้องถิ่นเทศบาลตำบลท่าฬ่อ,1534,1662,3196,1536,1665,3201,1194
2563,66,พิจิตร,6697,ท้องถิ่นเทศบาลเมืองบางมูลนาก,3914,4311,8225,3930,4317,8247,3680
2563,66,พิจิตร,6698,ท้องถิ่นเทศบาลเมืองตะพานหิน,6274,7197,13471,6312,7224,13536,6249
2563,66,พิจิตร,6699,ท้องถิ่นเทศบาลเมืองพิจิตร,9882,11213,21095,9934,11248,21182,12478
2563,67,เพชรบูรณ์,6701,อำเภอเมืองเพชรบูรณ์,80484,79821,160305,80699,79880,160579,62078
2563,67,เพชรบูรณ์,6702,อำเภอชนแดน,34122,34068,68190,34146,34086,68232,27799
2563,67,เพชรบูรณ์,6703,อำเภอหล่มสัก,70508,73903,144411,70613,73936,144549,48644
2563,67,เพชรบูรณ์,6704,อำเภอหล่มเก่า,29477,30670,60147,29521,30715,60236,18739
2563,67,เพชรบูรณ์,6705,อำเภอวิเชียรบุรี,49571,50703,100274,49625,50724,100349,33391
2563,67,เพชรบูรณ์,6706,อำเภอศรีเทพ,28309,28596,56905,28346,28628,56974,19427
2563,67,เพชรบูรณ์,6707,อำเภอหนองไผ่,37932,38314,76246,37970,38342,76312,24954
2563,67,เพชรบูรณ์,6708,อำเภอบึงสามพัน,31108,31705,62813,31148,31725,62873,25452
2563,67,เพชรบูรณ์,6709,อำเภอน้ำหนาว,9528,9042,18570,9535,9045,18580,7071
2563,67,เพชรบูรณ์,6710,อำเภอวังโป่ง,14047,14297,28344,14057,14308,28365,9215
2563,67,เพชรบูรณ์,6711,อำเภอเขาค้อ,17279,17186,34465,17553,17512,35065,11797
2563,67,เพชรบูรณ์,6778,ท้องถิ่นเทศบาลตำบลแคมป์สน,2613,2792,5405,2626,2794,5420,3037
2563,67,เพชรบูรณ์,6779,ท้องถิ่นเทศบาลตำบลโคกสะอาด,3255,3291,6546,3257,3294,6551,2165
2563,67,เพชรบูรณ์,6780,ท้องถิ่นเทศบาลตำบลบัววัฒนา,2949,2940,5889,2951,2940,5891,1885
2563,67,เพชรบูรณ์,6781,ท้องถิ่นเทศบาลตำบลบ่อไทย,4713,4883,9596,4722,4894,9616,2983
2563,67,เพชรบูรณ์,6782,ท้องถิ่นเทศบาลตำบลนางั่ว,5993,6789,12782,6067,6792,12859,5647
2563,67,เพชรบูรณ์,6783,ท้องถิ่นเทศบาลตำบลเฉลียงทอง,3768,3779,7547,3773,3779,7552,2556
2563,67,เพชรบูรณ์,6784,ท้องถิ่นเทศบาลตำบลวังโป่ง,1840,2022,3862,1842,2025,3867,1494
2563,67,เพชรบูรณ์,6785,ท้องถิ่นเทศบาลตำบลท้ายดง,1682,1782,3464,1682,1785,3467,1061
2563,67,เพชรบูรณ์,6786,ท้องถิ่นเทศบาลตำบลซับสมอทอด,4201,4380,8581,4233,4414,8647,5058
2563,67,เพชรบูรณ์,6787,ท้องถิ่นเทศบาลตำบลหนองไผ่,3511,3843,7354,3520,3849,7369,3836
2563,67,เพชรบูรณ์,6788,ท้องถิ่นเทศบาลตำบลนาเฉลียง,2026,2229,4255,2031,2231,4262,1731
2563,67,เพชรบูรณ์,6789,ท้องถิ่นเทศบาลตำบลสว่างวัฒนา,3166,3411,6577,3173,3412,6585,2893
2563,67,เพชรบูรณ์,6790,ท้องถิ่นเทศบาลเมืองวิเชียรบุรี,10556,11716,22272,10638,11741,22379,8669
2563,67,เพชรบูรณ์,6791,ท้องถิ่นเทศบาลตำบลพุเตย,3608,3772,7380,3613,3773,7386,3013
2563,67,เพชรบูรณ์,6792,ท้องถิ่นเทศบาลตำบลหล่มเก่า,2793,3129,5922,2799,3129,5928,2624
2563,67,เพชรบูรณ์,6793,ท้องถิ่นเทศบาลตำบลท่าข้าม,1251,1237,2488,1253,1239,2492,968
2563,67,เพชรบูรณ์,6794,ท้องถิ่นเทศบาลตำบลดงขุย,1237,1366,2603,1238,1366,2604,1021
2563,67,เพชรบูรณ์,6795,ท้องถิ่นเทศบาลตำบลชนแดน,1747,1658,3405,1753,1660,3413,1824
2563,67,เพชรบูรณ์,6796,ท้องถิ่นเทศบาลตำบลวังชมภู,1660,1882,3542,1669,1886,3555,1317
2563,67,เพชรบูรณ์,6797,ท้องถิ่นเทศบาลตำบลท่าพล,3633,3982,7615,3647,3990,7637,2570
2563,67,เพชรบูรณ์,6798,ท้องถิ่นเทศบาลเมืองหล่มสัก,5444,6041,11485,5472,6053,11525,6538
2563,67,เพชรบูรณ์,6799,ท้องถิ่นเทศบาลเมืองเพชรบูรณ์,9678,11089,20767,9714,11107,20821,12662
2563,70,ราชบุรี,7001,อำเภอเมืองราชบุรี,59424,62673,122097,60034,63207,123241,47697
2563,70,ราชบุรี,7002,อำเภอจอมบึง,28090,28794,56884,28308,29009,57317,19183
2563,70,ราชบุรี,7003,อำเภอสวนผึ้ง,15085,14327,29412,24272,22278,46550,14477
2563,70,ราชบุรี,7004,อำเภอดำเนินสะดวก,35384,37848,73232,35621,38049,73670,23203
2563,70,ราชบุรี,7005,อำเภอบ้านโป่ง,46309,50388,96697,46512,50562,97074,36712
2563,70,ราชบุรี,7006,อำเภอบางแพ,8552,9297,17849,8584,9327,17911,6532
2563,70,ราชบุรี,7007,อำเภอโพธาราม,34718,36861,71579,34849,37001,71850,25130
2563,70,ราชบุรี,7008,อำเภอปากท่อ,24525,25659,50184,25061,26154,51215,18512
2563,70,ราชบุรี,7009,อำเภอวัดเพลง,5119,5655,10774,5122,5658,10780,3624
2563,70,ราชบุรี,7010,อำเภอบ้านคา,12274,11820,24094,12943,12343,25286,9586
2563,70,ราชบุรี,7070,ท้องถิ่นเทศบาลตำบลดอนทราย,3354,3711,7065,3406,3747,7153,3093
2563,70,ราชบุรี,7071,ท้องถิ่นเทศบาลตำบลหลุมดิน,2502,2596,5098,2517,2607,5124,1742
2563,70,ราชบุรี,7072,ท้องถิ่นเทศบาลตำบลเบิกไพร,7542,8498,16040,7559,8514,16073,6524
2563,70,ราชบุรี,7073,ท้องถิ่นเทศบาลตำบลทุ่งหลวง,6834,6872,13706,6870,6899,13769,4296
2563,70,ราชบุรี,7074,ท้องถิ่นเทศบาลตำบลบ้านฆ้อง,4085,4502,8587,4111,4531,8642,3433
2563,70,ราชบุรี,7075,ท้องถิ่นเทศบาลตำบลกรับใหญ่,6223,6713,12936,6243,6719,12962,3815
2563,70,ราชบุรี,7076,ท้องถิ่นเทศบาลตำบลบ้านสิงห์,5744,6304,12048,5772,6331,12103,4488
2563,70,ราชบุรี,7077,ท้องถิ่นเทศบาลตำบลวัดเพลง,654,700,1354,666,716,1382,562
2563,70,ราชบุรี,7078,ท้องถิ่นเทศบาลตำบลปากท่อ,1371,1470,2841,1381,1471,2852,1389
2563,70,ราชบุรี,7079,ท้องถิ่นเทศบาลตำบลหนองโพ,1833,2058,3891,1837,2067,3904,2156
2563,70,ราชบุรี,7080,ท้องถิ่นเทศบาลตำบลบ้านเลือก,5123,5596,10719,5141,5613,10754,4948
2563,70,ราชบุรี,7081,ท้องถิ่นเทศบาลตำบลเจ็ดเสมียน,2709,2977,5686,2748,3021,5769,2219
2563,70,ราชบุรี,7082,ท้องถิ่นเทศบาลตำบลเขาขวาง,3498,3763,7261,3503,3771,7274,2604
2563,70,ราชบุรี,7083,ท้องถิ่นเทศบาลตำบลโพหัก,5091,5405,10496,5100,5413,10513,3677
2563,70,ราชบุรี,7084,ท้องถิ่นเทศบาลตำบลบางแพ,7616,8350,15966,7691,8418,16109,6461
2563,70,ราชบุรี,7085,ท้องถิ่นเทศบาลตำบลห้วยกระบอก,808,868,1676,822,874,1696,729
2563,70,ราชบุรี,7086,ท้องถิ่นเทศบาลเมืองท่าผา,9718,10356,20074,9764,10392,20156,8155
2563,70,ราชบุรี,7087,ท้องถิ่นเทศบาลตำบลกระจับ,3650,4072,7722,3702,4104,7806,3708
2563,70,ราชบุรี,7088,ท้องถิ่นเทศบาลตำบลศรีดอนไผ่,5082,5616,10698,5108,5633,10741,3388
2563,70,ราชบุรี,7089,ท้องถิ่นเทศบาลตำบลดำเนินสะดวก,3359,3851,7210,3376,3858,7234,3216
2563,70,ราชบุรี,7090,ท้องถิ่นเทศบาลตำบลสวนผึ้ง,1688,1687,3375,1723,1716,3439,1846
2563,70,ราชบุรี,7091,ท้องถิ่นเทศบาลตำบลบ้านชัฏป่าหวาย,1864,1879,3743,1961,1946,3907,1875
2563,70,ราชบุรี,7092,ท้องถิ่นเทศบาลตำบลด่านทับตะโก,1239,1209,2448,1241,1212,2453,825
2563,70,ราชบุรี,7093,ท้องถิ่นเทศบาลตำบลจอมบึง,2271,2610,4881,2277,2613,4890,3588
2563,70,ราชบุรี,7094,ท้องถิ่นเทศบาลตำบลห้วยชินสีห์,5426,5862,11288,5454,5890,11344,4284
2563,70,ราชบุรี,7095,ท้องถิ่นเทศบาลตำบลหลักเมือง,9441,8013,17454,9487,8047,17534,6990
2563,70,ราชบุรี,7096,ท้องถิ่นเทศบาลตำบลเขางู,4382,4751,9133,4405,4777,9182,2844
2563,70,ราชบุรี,7097,ท้องถิ่นเทศบาลเมืองโพธาราม,3892,4308,8200,4167,4579,8746,3691
2563,70,ราชบุรี,7098,ท้องถิ่นเทศบาลเมืองบ้านโป่ง,7162,8288,15450,7545,8650,16195,8256
2563,70,ราชบุรี,7099,ท้องถิ่นเทศบาลเมืองราชบุรี,15156,18014,33170,15948,18765,34713,16379
2563,71,กาญจนบุรี,7101,อำเภอเมืองกาญจนบุรี,52139,41006,93145,55456,43461,98917,38972
2563,71,กาญจนบุรี,7102,อำเภอไทรโยค,21944,21219,43163,30561,28535,59096,20932
2563,71,กาญจนบุรี,7103,อำเภอบ่อพลอย,23985,24069,48054,24064,24150,48214,18508
2563,71,กาญจนบุรี,7104,อำเภอศรีสวัสดิ์,12248,11650,23898,13305,12514,25819,10010
2563,71,กาญจนบุรี,7105,อำเภอท่ามะกา,43443,46148,89591,43725,46422,90147,30600
2563,71,กาญจนบุรี,7106,อำเภอท่าม่วง,27849,29617,57466,28008,29739,57747,23611
2563,71,กาญจนบุรี,7107,อำเภอทองผาภูมิ,21651,20050,41701,34435,31815,66250,27539
2563,71,กาญจนบุรี,7108,อำเภอสังขละบุรี,10504,9912,20416,21761,20312,42073,12201
2563,71,กาญจนบุรี,7109,อำเภอพนมทวน,15884,16693,32577,15899,16714,32613,11130
2563,71,กาญจนบุรี,7110,อำเภอเลาขวัญ,26543,26760,53303,26598,26800,53398,18105
2563,71,กาญจนบุรี,7111,อำเภอด่านมะขามเตี้ย,15564,15503,31067,15637,15559,31196,10941
2563,71,กาญจนบุรี,7112,อำเภอหนองปรือ,13658,13299,26957,13707,13330,27037,9492
2563,71,กาญจนบุรี,7113,อำเภอห้วยกระเจา,16549,17104,33653,16598,17128,33726,11723
2563,71,กาญจนบุรี,7167,ท้องถิ่นเทศบาลตำบลรางหวาย,3625,3616,7241,3637,3623,7260,2567
2563,71,กาญจนบุรี,7168,ท้องถิ่นเทศบาลตำบลหนองสาหร่าย,1715,1918,3633,1728,1924,3652,1197
2563,71,กาญจนบุรี,7169,ท้องถิ่นเทศบาลเมืองปากแพรก,12641,14242,26883,12744,14306,27050,15403
2563,71,กาญจนบุรี,7170,ท้องถิ่นเทศบาลตำบลวังศาลา,5740,6067,11807,5758,6090,11848,5126
2563,71,กาญจนบุรี,7171,ท้องถิ่นเทศบาลตำบลท่าล้อ,4278,4739,9017,4308,4759,9067,3878
2563,71,กาญจนบุรี,7172,ท้องถิ่นเทศบาลตำบลวังขนาย,4318,4748,9066,4354,4768,9122,3843
2563,71,กาญจนบุรี,7173,ท้องถิ่นเทศบาลตำบลหนองปรือ,2157,2270,4427,2161,2276,4437,1743
2563,71,กาญจนบุรี,7174,ท้องถิ่นเทศบาลตำบลด่านมะขามเตี้ย,1194,1239,2433,1238,1257,2495,1255
2563,71,กาญจนบุรี,7175,ท้องถิ่นเทศบาลตำบลหนองฝ้าย,1028,1104,2132,1070,1142,2212,957
2563,71,กาญจนบุรี,7176,ท้องถิ่นเทศบาลตำบลเลาขวัญ,1300,1314,2614,1311,1318,2629,1300
2563,71,กาญจนบุรี,7177,ท้องถิ่นเทศบาลตำบลตลาดเขต,1922,2165,4087,1929,2173,4102,1789
2563,71,กาญจนบุรี,7178,ท้องถิ่นเทศบาลตำบลพนมทวน,2427,2724,5151,2470,2756,5226,2179
2563,71,กาญจนบุรี,7179,ท้องถิ่นเทศบาลตำบลวังกะ,3481,3286,6767,4683,4535,9218,2553
2563,71,กาญจนบุรี,7180,ท้องถิ่นเทศบาลตำบลทองผาภูมิ,1405,1355,2760,1582,1513,3095,1569
2563,71,กาญจนบุรี,7181,ท้องถิ่นเทศบาลตำบลหนองตากยา,1467,1538,3005,1471,1541,3012,949
2563,71,กาญจนบุรี,7182,ท้องถิ่นเทศบาลตำบลหนองขาว,2403,2670,5073,2416,2673,5089,1608
2563,71,กาญจนบุรี,7183,ท้องถิ่นเทศบาลตำบลสำรอง,895,941,1836,901,942,1843,629
2563,71,กาญจนบุรี,7184,ท้องถิ่นเทศบาลตำบลท่าม่วง,4510,5224,9734,4657,5375,10032,5460
2563,71,กาญจนบุรี,7185,ท้องถิ่นเทศบาลตำบลหวายเหนียว,2058,2210,4268,2070,2224,4294,1836
2563,71,กาญจนบุรี,7186,ท้องถิ่นเทศบาลตำบลพระแท่น,2948,3210,6158,2960,3219,6179,2118
2563,71,กาญจนบุรี,7187,ท้องถิ่นเทศบาลตำบลท่าไม้,4420,4721,9141,4444,4731,9175,3847
2563,71,กาญจนบุรี,7188,ท้องถิ่นเทศบาลตำบลท่ามะกา,3533,4140,7673,4027,4606,8633,4687
2563,71,กาญจนบุรี,7189,ท้องถิ่นเทศบาลตำบลลูกแก,1666,1922,3588,1669,1924,3593,1510
2563,71,กาญจนบุรี,7190,ท้องถิ่นเทศบาลตำบลเอราวัณ,472,488,960,472,488,960,723
2563,71,กาญจนบุรี,7191,ท้องถิ่นเทศบาลตำบลหนองรี,1029,1100,2129,1031,1100,2131,789
2563,71,กาญจนบุรี,7192,ท้องถิ่นเทศบาลตำบลบ่อพลอย,3385,3452,6837,3468,3512,6980,2703
2563,71,กาญจนบุรี,7193,ท้องถิ่นเทศบาลตำบลวังโพธิ์,965,925,1890,1070,1007,2077,883
2563,71,กาญจนบุรี,7194,ท้องถิ่นเทศบาลตำบลน้ำตกไทรโยคน้อย,1921,1980,3901,1935,1991,3926,1572
2563,71,กาญจนบุรี,7195,ท้องถิ่นเทศบาลตำบลหนองบัว,3046,3394,6440,3062,3407,6469,2908
2563,71,กาญจนบุรี,7196,ท้องถิ่นเทศบาลตำบลลาดหญ้า,2642,2826,5468,2655,2833,5488,2324
2563,71,กาญจนบุรี,7197,ท้องถิ่นเทศบาลตำบลแก่งเสี้ยน,2939,3372,6311,2951,3384,6335,3758
2563,71,กาญจนบุรี,7198,ท้องถิ่นเทศบาลเมืองท่าเรือพระแท่น,5251,5849,11100,5291,5886,11177,5031
2563,71,กาญจนบุรี,7199,ท้องถิ่นเทศบาลเมืองกาญจนบุรี,12377,13959,26336,12706,14231,26937,15913
2563,72,สุพรรณบุรี,7201,อำเภอเมืองสุพรรณบุรี,51117,56250,107367,51215,56324,107539,38078
2563,72,สุพรรณบุรี,7202,อำเภอเดิมบางนางบวช,20194,21504,41698,20228,21528,41756,15142
2563,72,สุพรรณบุรี,7203,อำเภอด่านช้าง,30290,31031,61321,30415,31108,61523,23590
2563,72,สุพรรณบุรี,7204,อำเภอบางปลาม้า,28745,30263,59008,28782,30311,59093,19645
2563,72,สุพรรณบุรี,7205,อำเภอศรีประจันต์,19255,21062,40317,19285,21094,40379,14997
2563,72,สุพรรณบุรี,7206,อำเภอดอนเจดีย์,19580,20825,40405,19594,20840,40434,14412
2563,72,สุพรรณบุรี,7207,อำเภอสองพี่น้อง,54127,56201,110328,54305,56363,110668,35842
2563,72,สุพรรณบุรี,7208,อำเภอสามชุก,19121,20747,39868,19155,20766,39921,14744
2563,72,สุพรรณบุรี,7209,อำเภออู่ทอง,31528,33466,64994,31636,33558,65194,21146
2563,72,สุพรรณบุรี,7210,อำเภอหนองหญ้าไซ,22566,23664,46230,22578,23680,46258,16317
2563,72,สุพรรณบุรี,7265,ท้องถิ่นเทศบาลตำบลปากน้ำ,2152,2359,4511,2153,2361,4514,1758
2563,72,สุพรรณบุรี,7266,ท้องถิ่นเทศบาลตำบลท้าวอู่ทอง,7659,8142,15801,7685,8158,15843,5812
2563,72,สุพรรณบุรี,7267,ท้องถิ่นเทศบาลตำบลกระจัน,3563,3759,7322,3568,3763,7331,1949
2563,72,สุพรรณบุรี,7268,ท้องถิ่นเทศบาลตำบลบ้านโข้ง,4445,4579,9024,4445,4580,9025,2998
2563,72,สุพรรณบุรี,7269,ท้องถิ่นเทศบาลตำบลเดิมบาง,3153,3610,6763,3155,3615,6770,2798
2563,72,สุพรรณบุรี,7270,ท้องถิ่นเทศบาลตำบลบางกุ้ง,914,993,1907,919,996,1915,584
2563,72,สุพรรณบุรี,7271,ท้องถิ่นเทศบาลตำบลท่าระหัด,4105,4858,8963,4122,4872,8994,4993
2563,72,สุพรรณบุรี,7272,ท้องถิ่นเทศบาลตำบลตะค่า,2643,2860,5503,2645,2863,5508,1909
2563,72,สุพรรณบุรี,7273,ท้องถิ่นเทศบาลตำบลบ้านดอน,3696,3926,7622,3699,3933,7632,2037
2563,72,สุพรรณบุรี,7274,ท้องถิ่นเทศบาลตำบลต้นคราม,2594,2867,5461,2616,2890,5506,2025
2563,72,สุพรรณบุรี,7275,ท้องถิ่นเทศบาลตำบลปลายนา,3980,4330,8310,3982,4333,8315,2873
2563,72,สุพรรณบุรี,7276,ท้องถิ่นเทศบาลตำบลขุนพัดเพ็ง,2678,2715,5393,2687,2719,5406,1829
2563,72,สุพรรณบุรี,7277,ท้องถิ่นเทศบาลตำบลวังยาง,3278,3633,6911,3284,3636,6920,2724
2563,72,สุพรรณบุรี,7278,ท้องถิ่นเทศบาลตำบลเขาดิน,2954,3104,6058,2955,3105,6060,2079
2563,72,สุพรรณบุรี,7279,ท้องถิ่นเทศบาลตำบลหนองหญ้าไซ,1219,1319,2538,1219,1320,2539,1085
2563,72,สุพรรณบุรี,7280,ท้องถิ่นเทศบาลตำบลอู่ทอง,3560,3987,7547,3575,3996,7571,3662
2563,72,สุพรรณบุรี,7281,ท้องถิ่นเทศบาลตำบลสระยายโสม,1344,1496,2840,1349,1499,2848,1043
2563,72,สุพรรณบุรี,7282,ท้องถิ่นเทศบาลตำบลสามชุก,6059,6797,12856,6079,6809,12888,6747
2563,72,สุพรรณบุรี,7283,ท้องถิ่นเทศบาลตำบลทุ่งคอก,1526,1777,3303,1542,1789,3331,1260
2563,72,สุพรรณบุรี,7284,ท้องถิ่นเทศบาลตำบลสระกระโจม,1199,1201,2400,1202,1203,2405,970
2563,72,สุพรรณบุรี,7285,ท้องถิ่นเทศบาลตำบลดอนเจดีย์,1381,1466,2847,1433,1508,2941,1365
2563,72,สุพรรณบุรี,7286,ท้องถิ่นเทศบาลตำบลศรีประจันต์,2672,3043,5715,2689,3052,5741,2596
2563,72,สุพรรณบุรี,7287,ท้องถิ่นเทศบาลตำบลไผ่กองดิน,841,876,1717,841,882,1723,616
2563,72,สุพรรณบุรี,7288,ท้องถิ่นเทศบาลตำบลบ้านแหลม,595,600,1195,596,602,1198,446
2563,72,สุพรรณบุรี,7289,ท้องถิ่นเทศบาลตำบลบางปลาม้า,907,986,1893,938,990,1928,662
2563,72,สุพรรณบุรี,7290,ท้องถิ่นเทศบาลตำบลโคกคราม,719,811,1530,724,813,1537,862
2563,72,สุพรรณบุรี,7291,ท้องถิ่นเทศบาลตำบลด่านช้าง,3008,3275,6283,3027,3293,6320,3341
2563,72,สุพรรณบุรี,7292,ท้องถิ่นเทศบาลตำบลบ่อกรุ,927,1051,1978,927,1051,1978,741
2563,72,สุพรรณบุรี,7293,ท้องถิ่นเทศบาลตำบลนางบวช,2112,2258,4370,2114,2260,4374,1624
2563,72,สุพรรณบุรี,7294,ท้องถิ่นเทศบาลตำบลเขาพระ,2584,3005,5589,2610,3026,5636,3229
2563,72,สุพรรณบุรี,7295,ท้องถิ่นเทศบาลตำบลสวนแตง,3182,3410,6592,3195,3417,6612,2285
2563,72,สุพรรณบุรี,7296,ท้องถิ่นเทศบาลตำบลโพธิ์พระยา,1518,1863,3381,1522,1865,3387,1710
2563,72,สุพรรณบุรี,7297,ท้องถิ่นเทศบาลตำบลท่าเสด็จ,6726,7167,13893,6747,7184,13931,4361
2563,72,สุพรรณบุรี,7298,ท้องถิ่นเทศบาลเมืองสองพี่น้อง,5698,6413,12111,5810,6536,12346,5138
2563,72,สุพรรณบุรี,7299,ท้องถิ่นเทศบาลเมืองสุพรรณบุรี,11174,13273,24447,11411,13479,24890,12975
2563,73,นครปฐม,7301,อำเภอเมืองนครปฐม,82694,89552,172246,82938,89749,172687,66425
2563,73,นครปฐม,7302,อำเภอกำแพงแสน,57853,61812,119665,58219,62145,120364,38863
2563,73,นครปฐม,7303,อำเภอนครชัยศรี,48035,53022,101057,48205,53175,101380,39072
2563,73,นครปฐม,7304,อำเภอดอนตูม,17166,17887,35053,17185,17902,35087,10927
2563,73,นครปฐม,7305,อำเภอบางเลน,39090,40061,79151,39296,40257,79553,28677
2563,73,นครปฐม,7306,อำเภอสามพราน,47017,51952,98969,47276,52195,99471,49095
2563,73,นครปฐม,7307,อำเภอพุทธมณฑล,9743,11499,21242,9838,11603,21441,11612
2563,73,นครปฐม,7380,ท้องถิ่นเทศบาลตำบลบ่อพลับ,4501,4996,9497,4535,5010,9545,4770
2563,73,นครปฐม,7381,ท้องถิ่นเทศบาลตำบลบางกระทึก,6249,7241,13490,6276,7261,13537,8744
2563,73,นครปฐม,7382,ท้องถิ่นเทศบาลเมืองกระทุ่มล้ม,13038,15072,28110,13097,15124,28221,18347
2563,73,นครปฐม,7383,ท้องถิ่นเทศบาลเมืองไร่ขิง,15042,17098,32140,15743,17806,33549,24326
2563,73,นครปฐม,7384,ท้องถิ่นเทศบาลเมืองคลองโยง,5018,5531,10549,5045,5556,10601,4390
2563,73,นครปฐม,7385,ท้องถิ่นเทศบาลตำบลศาลายา,5953,5271,11224,5970,5284,11254,7650
2563,73,นครปฐม,7386,ท้องถิ่นเทศบาลตำบลอ้อมใหญ่,11504,12568,24072,11600,12673,24273,21722
2563,73,นครปฐม,7387,ท้องถิ่นเทศบาลเมืองสามพราน,7976,7557,15533,8752,8286,17038,8739
2563,73,นครปฐม,7388,ท้องถิ่นเทศบาลตำบลลำพญา,917,998,1915,921,1000,1921,624
2563,73,นครปฐม,7389,ท้องถิ่นเทศบาลตำบลรางกระทุ่ม,1011,1099,2110,1018,1103,2121,683
2563,73,นครปฐม,7390,ท้องถิ่นเทศบาลตำบลบางหลวง,1014,1087,2101,1018,1090,2108,769
2563,73,นครปฐม,7391,ท้องถิ่นเทศบาลตำบลบางเลน,3906,3958,7864,4216,4221,8437,4094
2563,73,นครปฐม,7392,ท้องถิ่นเทศบาลตำบลสามง่าม,6616,7179,13795,6674,7239,13913,4830
2563,73,นครปฐม,7393,ท้องถิ่นเทศบาลตำบลห้วยพลู,907,1030,1937,1030,1155,2185,890
2563,73,นครปฐม,7394,ท้องถิ่นเทศบาลตำบลนครชัยศรี,3750,4424,8174,3756,4427,8183,5052
2563,73,นครปฐม,7395,ท้องถิ่นเทศบาลตำบลกำแพงแสน,3224,3593,6817,3240,3600,6840,4177
2563,73,นครปฐม,7396,ท้องถิ่นเทศบาลตำบลโพรงมะเดื่อ,5152,5645,10797,5164,5656,10820,4178
2563,73,นครปฐม,7397,ท้องถิ่นเทศบาลตำบลธรรมศาลา,3282,3639,6921,3296,3643,6939,2970
2563,73,นครปฐม,7398,ท้องถิ่นเทศบาลตำบลดอนยายหอม,3123,3371,6494,3131,3377,6508,2186
2563,73,นครปฐม,7399,ท้องถิ่นเทศบาลนครนครปฐม,32748,36840,69588,34445,38308,72753,37774
2563,74,สมุทรสาคร,7401,อำเภอเมืองสมุทรสาคร,95597,104680,200277,97385,106186,203571,113256
2563,74,สมุทรสาคร,7402,อำเภอกระทุ่มแบน,30938,33397,64335,31417,33857,65274,38279
2563,74,สมุทรสาคร,7403,อำเภอบ้านแพ้ว,23886,25988,49874,23981,26075,50056,15560
2563,74,สมุทรสาคร,7491,ท้องถิ่นเทศบาลตำบลสวนหลวง,17584,17505,35089,17673,17598,35271,21467
2563,74,สมุทรสาคร,7492,ท้องถิ่นเทศบาลตำบลนาดี,13230,14764,27994,13282,14813,28095,16548
2563,74,สมุทรสาคร,7493,ท้องถิ่นเทศบาลตำบลหลักห้า,20290,21517,41807,20329,21555,41884,10326
2563,74,สมุทรสาคร,7494,ท้องถิ่นเทศบาลตำบลบ้านแพ้ว,1224,1344,2568,1538,1669,3207,1056
2563,74,สมุทรสาคร,7495,ท้องถิ่นเทศบาลตำบลเกษตรพัฒนา,2434,2619,5053,2451,2641,5092,1564
2563,74,สมุทรสาคร,7496,ท้องถิ่นเทศบาลตำบลบางปลา,3352,3602,6954,3358,3604,6962,4327
2563,74,สมุทรสาคร,7497,ท้องถิ่นเทศบาลนครอ้อมน้อย,25475,28071,53546,25625,28197,53822,49114
2563,74,สมุทรสาคร,7498,ท้องถิ่นเทศบาลเมืองกระทุ่มแบน,8763,9833,18596,13444,14112,27556,6403
2563,74,สมุทรสาคร,7499,ท้องถิ่นเทศบาลนครสมุทรสาคร,21674,23467,45141,32240,33169,65409,18925
2563,75,สมุทรสงคราม,7501,อำเภอเมืองสมุทรสงคราม,37570,40821,78391,37673,40920,78593,31968
2563,75,สมุทรสงคราม,7502,อำเภอบางคนที,13020,14333,27353,13041,14344,27385,9863
2563,75,สมุทรสงคราม,7503,อำเภออัมพวา,23079,24959,48038,23102,24983,48085,15516
2563,75,สมุทรสงคราม,7595,ท้องถิ่นเทศบาลตำบลเหมืองใหม่,953,1018,1971,955,1019,1974,773
2563,75,สมุทรสงคราม,7596,ท้องถิ่นเทศบาลตำบลบางนกแขวก,790,944,1734,794,948,1742,853
2563,75,สมุทรสงคราม,7597,ท้องถิ่นเทศบาลตำบลกระดังงา,1029,1176,2205,1036,1183,2219,851
2563,75,สมุทรสงคราม,7598,ท้องถิ่นเทศบาลตำบลอัมพวา,2255,2460,4715,2260,2471,4731,1961
2563,75,สมุทรสงคราม,7599,ท้องถิ่นเทศบาลเมืองสมุทรสงคราม,12231,13644,25875,12964,14359,27323,10947
2563,76,เพชรบุรี,7601,อำเภอเมืองเพชรบุรี,42280,47854,90134,42312,47885,90197,34794
2563,76,เพชรบุรี,7602,อำเภอเขาย้อย,11445,12030,23475,11473,12048,23521,10176
2563,76,เพชรบุรี,7603,อำเภอหนองหญ้าปล้อง,8148,8095,16243,8172,8128,16300,6743
2563,76,เพชรบุรี,7604,อำเภอชะอำ,10833,11042,21875,10891,11070,21961,8503
2563,76,เพชรบุรี,7605,อำเภอท่ายาง,23742,25025,48767,23770,25034,48804,19740
2563,76,เพชรบุรี,7606,อำเภอบ้านลาด,23063,25163,48226,23086,25184,48270,15724
2563,76,เพชรบุรี,7607,อำเภอบ้านแหลม,17754,18532,36286,17776,18540,36316,11465
2563,76,เพชรบุรี,7608,อำเภอแก่งกระจาน,16317,15350,31667,17204,16041,33245,15166
2563,76,เพชรบุรี,7688,ท้องถิ่นเทศบาลตำบลท่าแลง,2978,3231,6209,2979,3232,6211,2158
2563,76,เพชรบุรี,7689,ท้องถิ่นเทศบาลตำบลบ้านแหลม,5612,6050,11662,5651,6080,11731,4212
2563,76,เพชรบุรี,7690,ท้องถิ่นเทศบาลตำบลบางตะบูน,2503,2632,5135,2504,2633,5137,1862
2563,76,เพชรบุรี,7691,ท้องถิ่นเทศบาลตำบลบ้านลาด,1692,1981,3673,1696,1981,3677,1655
2563,76,เพชรบุรี,7692,ท้องถิ่นเทศบาลตำบลหนองจอก,1282,1451,2733,1284,1452,2736,1001
2563,76,เพชรบุรี,7693,ท้องถิ่นเทศบาลตำบลท่ายาง,13209,14645,27854,13283,14713,27996,11452
2563,76,เพชรบุรี,7694,ท้องถิ่นเทศบาลตำบลนายาง,9033,9744,18777,9108,9774,18882,7030
2563,76,เพชรบุรี,7695,ท้องถิ่นเทศบาลตำบลเขาย้อย,7013,7755,14768,7290,8049,15339,8081
2563,76,เพชรบุรี,7696,ท้องถิ่นเทศบาลตำบลหาดเจ้าสำราญ,2359,2566,4925,2366,2567,4933,2513
2563,76,เพชรบุรี,7697,ท้องถิ่นเทศบาลตำบลหัวสะพาน,2835,3119,5954,2838,3120,5958,1993
2563,76,เพชรบุรี,7698,ท้องถิ่นเทศบาลเมืองชะอำ,18702,20566,39268,19263,20740,40003,45786
2563,76,เพชรบุรี,7699,ท้องถิ่นเทศบาลเมืองเพชรบุรี,9696,10745,20441,9969,11007,20976,10308
2563,77,ประจวบคีรีขันธ์,7701,อำเภอเมืองประจวบคีรีขันธ์,32130,32131,64261,32579,32461,65040,26113
2563,77,ประจวบคีรีขันธ์,7702,อำเภอกุยบุรี,17049,17554,34603,17177,17683,34860,11142
2563,77,ประจวบคีรีขันธ์,7703,อำเภอทับสะแก,20431,21167,41598,21296,21835,43131,14838
2563,77,ประจวบคีรีขันธ์,7704,อำเภอบางสะพาน,29662,30214,59876,30502,30985,61487,26329
2563,77,ประจวบคีรีขันธ์,7705,อำเภอบางสะพานน้อย,17906,18001,35907,18335,18356,36691,16029
2563,77,ประจวบคีรีขันธ์,7706,อำเภอปราณบุรี,28160,24426,52586,28750,24790,53540,27075
2563,77,ประจวบคีรีขันธ์,7707,อำเภอหัวหิน,24248,26569,50817,25423,27221,52644,27972
2563,77,ประจวบคีรีขันธ์,7708,อำเภอสามร้อยยอด,15533,15790,31323,15642,15840,31482,12266
2563,77,ประจวบคีรีขันธ์,7785,ท้องถิ่นเทศบาลตำบลไร่เก่า,5217,5338,10555,5274,5390,10664,4140
2563,77,ประจวบคีรีขันธ์,7786,ท้องถิ่นเทศบาลตำบลหนองพลับ,2252,2443,4695,2264,2450,4714,2828
2563,77,ประจวบคีรีขันธ์,7787,ท้องถิ่นเทศบาลตำบลปากน้ำปราณ,3911,3890,7801,3931,3904,7835,3463
2563,77,ประจวบคีรีขันธ์,7788,ท้องถิ่นเทศบาลตำบลปราณบุรี,7889,8643,16532,7942,8674,16616,9308
2563,77,ประจวบคีรีขันธ์,7789,ท้องถิ่นเทศบาลตำบลบางสะพานน้อย,1445,1479,2924,1461,1492,2953,1503
2563,77,ประจวบคีรีขันธ์,7790,ท้องถิ่นเทศบาลตำบลร่อนทอง,3828,3952,7780,3880,3984,7864,3359
2563,77,ประจวบคีรีขันธ์,7791,ท้องถิ่นเทศบาลตำบลบ้านกรูด,1961,2178,4139,1981,2189,4170,2294
2563,77,ประจวบคีรีขันธ์,7792,ท้องถิ่นเทศบาลตำบลกำเนิดนพคุณ,1276,1315,2591,1295,1329,2624,1618
2563,77,ประจวบคีรีขันธ์,7793,ท้องถิ่นเทศบาลตำบลทับสะแก,3111,3446,6557,3128,3463,6591,3462
2563,77,ประจวบคีรีขันธ์,7794,ท้องถิ่นเทศบาลตำบลไร่ใหม่,3582,3881,7463,3730,4003,7733,2856
2563,77,ประจวบคีรีขันธ์,7795,ท้องถิ่นเทศบาลตำบลกุยบุรี,4187,4573,8760,4205,4588,8793,4194
2563,77,ประจวบคีรีขันธ์,7796,ท้องถิ่นเทศบาลตำบลคลองวาฬ,2135,2285,4420,2148,2292,4440,1839
2563,77,ประจวบคีรีขันธ์,7797,ท้องถิ่นเทศบาลตำบล กม.5,1695,1857,3552,1730,1869,3599,1389
2563,77,ประจวบคีรีขันธ์,7798,ท้องถิ่นเทศบาลนครหัวหิน,29761,32324,62085,31763,33270,65033,57007
2563,77,ประจวบคีรีขันธ์,7799,ท้องถิ่นเทศบาลเมืองประจวบคีรีขันธ์,8061,9468,17529,8413,9761,18174,10866
2563,80,นครศรีธรรมราช,8001,อำเภอเมืองนครศรีธรรมราช,78030,79930,157960,78087,79953,158040,61795
2563,80,นครศรีธรรมราช,8002,อำเภอพรหมคีรี,13443,13853,27296,13449,13856,27305,8957
2563,80,นครศรีธรรมราช,8003,อำเภอลานสกา,19156,20143,39299,19160,20146,39306,14466
2563,80,นครศรีธรรมราช,8004,อำเภอฉวาง,25975,27375,53350,26066,27465,53531,19321
2563,80,นครศรีธรรมราช,8005,อำเภอพิปูน,8899,9181,18080,8903,9186,18089,7274
2563,80,นครศรีธรรมราช,8006,อำเภอเชียรใหญ่,20270,20227,40497,20282,20235,40517,14387
2563,80,นครศรีธรรมราช,8007,อำเภอชะอวด,40869,41525,82394,40892,41547,82439,29715
2563,80,นครศรีธรรมราช,8008,อำเภอท่าศาลา,55741,59342,115083,55813,59385,115198,35793
2563,80,นครศรีธรรมราช,8009,อำเภอทุ่งสง,59493,57303,116796,59712,57518,117230,47358
2563,80,นครศรีธรรมราช,8010,อำเภอนาบอน,11889,12191,24080,11947,12263,24210,8497
2563,80,นครศรีธรรมราช,8011,อำเภอทุ่งใหญ่,34625,34931,69556,34638,34936,69574,24071
2563,80,นครศรีธรรมราช,8012,อำเภอปากพนัง,39391,38841,78232,39401,38856,78257,25868
2563,80,นครศรีธรรมราช,8013,อำเภอร่อนพิบูลย์,30635,30818,61453,30654,30837,61491,20042
2563,80,นครศรีธรรมราช,8014,อำเภอสิชล,40444,41047,81491,40558,41128,81686,28665
2563,80,นครศรีธรรมราช,8015,อำเภอขนอม,10045,10328,20373,10068,10346,20414,9456
2563,80,นครศรีธรรมราช,8016,อำเภอหัวไทร,22003,22227,44230,22018,22230,44248,17631
2563,80,นครศรีธรรมราช,8017,อำเภอบางขัน,23861,23410,47271,23884,23431,47315,16553
2563,80,นครศรีธรรมราช,8018,อำเภอถ้ำพรรณรา,9616,9652,19268,9635,9668,19303,7396
2563,80,นครศรีธรรมราช,8019,อำเภอจุฬาภรณ์,15482,15950,31432,15484,15952,31436,10679
2563,80,นครศรีธรรมราช,8020,อำเภอพระพรหม,21930,22552,44482,21935,22559,44494,16285
2563,80,นครศรีธรรมราช,8021,อำเภอนบพิตำ,16803,16757,33560,16804,16757,33561,11983
2563,80,นครศรีธรรมราช,8022,อำเภอช้างกลาง,13960,14465,28425,13964,14468,28432,10925
2563,80,นครศรีธรรมราช,8023,อำเภอเฉลิมพระเกียรติ,11097,11218,22315,11101,11219,22320,7920
2563,80,นครศรีธรรมราช,8070,ท้องถิ่นเทศบาลตำบลหน้าสตน,4139,4159,8298,4142,4164,8306,2902
2563,80,นครศรีธรรมราช,8071,ท้องถิ่นเทศบาลตำบลเขาพระ,4096,4091,8187,4097,4091,8188,3337
2563,80,นครศรีธรรมราช,8072,ท้องถิ่นเทศบาลตำบลเกาะเพชร,3486,3382,6868,3487,3385,6872,2121
2563,80,นครศรีธรรมราช,8073,ท้องถิ่นเทศบาลตำบลทางพูน,4530,4357,8887,4532,4358,8890,2846
2563,80,นครศรีธรรมราช,8074,ท้องถิ่นเทศบาลตำบลที่วัง,7101,7084,14185,7106,7086,14192,6364
2563,80,นครศรีธรรมราช,8075,ท้องถิ่นเทศบาลตำบลท้องเนียน,2777,2792,5569,2783,2793,5576,3253
2563,80,นครศรีธรรมราช,8076,ท้องถิ่นเทศบาลตำบลหัวไทร,2022,2183,4205,2027,2188,4215,1832
2563,80,นครศรีธรรมราช,8077,ท้องถิ่นเทศบาลตำบลขนอม,2028,2041,4069,2205,2219,4424,2412
2563,80,นครศรีธรรมราช,8078,ท้องถิ่นเทศบาลตำบลสิชล,3204,3436,6640,3368,3590,6958,3978
2563,80,นครศรีธรรมราช,8079,ท้องถิ่นเทศบาลตำบลหินตก,4167,4169,8336,4171,4172,8343,2724
2563,80,นครศรีธรรมราช,8080,ท้องถิ่นเทศบาลตำบลร่อนพิบูลย์,3657,4008,7665,3672,4013,7685,3303
2563,80,นครศรีธรรมราช,8081,ท้องถิ่นเทศบาลตำบลเขาชุมทอง,2102,2236,4338,2104,2237,4341,1355
2563,80,นครศรีธรรมราช,8082,ท้องถิ่นเทศบาลตำบลท่ายาง,2368,2598,4966,2450,2713,5163,3021
2563,80,นครศรีธรรมราช,8083,ท้องถิ่นเทศบาลตำบลนาบอน,1108,1144,2252,1120,1159,2279,1139
2563,80,นครศรีธรรมราช,8084,ท้องถิ่นเทศบาลตำบลท่าศาลา,1345,1520,2865,1347,1521,2868,1771
2563,80,นครศรีธรรมราช,8085,ท้องถิ่นเทศบาลตำบลชะอวด,1625,1883,3508,1627,1883,3510,1658
2563,80,นครศรีธรรมราช,8086,ท้องถิ่นเทศบาลตำบลเชียรใหญ่,803,818,1621,804,818,1622,748
2563,80,นครศรีธรรมราช,8087,ท้องถิ่นเทศบาลตำบลพิปูน,1316,1412,2728,1317,1412,2729,1123
2563,80,นครศรีธรรมราช,8088,ท้องถิ่นเทศบาลตำบลไม้เรียง,1143,1236,2379,1151,1244,2395,1252
2563,80,นครศรีธรรมราช,8089,ท้องถิ่นเทศบาลตำบลฉวาง,1218,1262,2480,1220,1263,2483,1279
2563,80,นครศรีธรรมราช,8090,ท้องถิ่นเทศบาลตำบลจันดี,3421,3807,7228,3467,3843,7310,3967
2563,80,นครศรีธรรมราช,8091,ท้องถิ่นเทศบาลตำบลลานสกา,868,907,1775,869,907,1776,1011
2563,80,นครศรีธรรมราช,8092,ท้องถิ่นเทศบาลตำบลพรหมโลก,3342,3429,6771,3349,3440,6789,2677
2563,80,นครศรีธรรมราช,8093,ท้องถิ่นเทศบาลตำบลทอนหงส์,1717,1708,3425,1719,1710,3429,1050
2563,80,นครศรีธรรมราช,8094,ท้องถิ่นเทศบาลตำบลปากนคร,3167,3128,6295,3167,3129,6296,2000
2563,80,นครศรีธรรมราช,8095,ท้องถิ่นเทศบาลตำบลบางจาก,865,952,1817,865,952,1817,659
2563,80,นครศรีธรรมราช,8096,ท้องถิ่นเทศบาลตำบลท่าแพ,1968,2042,4010,1970,2044,4014,1286
2563,80,นครศรีธรรมราช,8097,ท้องถิ่นเทศบาลเมืองทุ่งสง,13752,16225,29977,13767,16235,30002,11362
2563,80,นครศรีธรรมราช,8098,ท้องถิ่นเทศบาลเมืองปากพนัง,9570,9819,19389,9601,9836,19437,7928
2563,80,นครศรีธรรมราช,8099,ท้องถิ่นเทศบาลนครนครศรีธรรมราช,47241,52908,100149,47411,53005,100416,46553
2563,81,กระบี่,8101,อำเภอเมืองกระบี่,36175,37144,73319,36409,37265,73674,38326
2563,81,กระบี่,8102,อำเภอเขาพนม,25108,24908,50016,25153,24959,50112,17956
2563,81,กระบี่,8103,อำเภอเกาะลันตา,17414,17052,34466,17501,17105,34606,14403
2563,81,กระบี่,8104,อำเภอคลองท่อม,36205,35149,71354,36270,35229,71499,24667
2563,81,กระบี่,8105,อำเภออ่าวลึก,23219,23425,46644,23248,23453,46701,16328
2563,81,กระบี่,8106,อำเภอปลายพระยา,16210,16166,32376,16226,16185,32411,10959
2563,81,กระบี่,8107,อำเภอลำทับ,10257,10022,20279,10264,10024,20288,7291
2563,81,กระบี่,8108,อำเภอเหนือคลอง,29640,30204,59844,29687,30250,59937,20157
2563,81,กระบี่,8189,ท้องถิ่นเทศบาลตำบลกระบี่น้อย,8973,9233,18206,8988,9251,18239,8566
2563,81,กระบี่,8190,ท้องถิ่นเทศบาลตำบลเหนือคลอง,2054,2224,4278,2065,2227,4292,2412
2563,81,กระบี่,8191,ท้องถิ่นเทศบาลตำบลลำทับ,2046,2183,4229,2086,2219,4305,2370
2563,81,กระบี่,8192,ท้องถิ่นเทศบาลตำบลปลายพระยา,3030,3007,6037,3036,3023,6059,2478
2563,81,กระบี่,8193,ท้องถิ่นเทศบาลตำบลอ่าวลึกใต้,2684,2933,5617,2711,2954,5665,2915
2563,81,กระบี่,8194,ท้องถิ่นเทศบาลตำบลแหลมสัก,2069,2045,4114,2069,2046,4115,1233
2563,81,กระบี่,8195,ท้องถิ่นเทศบาลตำบลคลองพน,1398,1490,2888,1398,1491,2889,1288
2563,81,กระบี่,8196,ท้องถิ่นเทศบาลตำบลคลองท่อมใต้,1689,1828,3517,1690,1828,3518,1779
2563,81,กระบี่,8197,ท้องถิ่นเทศบาลตำบลเกาะลันตาใหญ่,570,602,1172,570,602,1172,497
2563,81,กระบี่,8198,ท้องถิ่นเทศบาลตำบลเขาพนม,2700,2944,5644,2764,2988,5752,2468
2563,81,กระบี่,8199,ท้องถิ่นเทศบาลเมืองกระบี่,14598,17012,31610,15107,17429,32536,17608
2563,82,พังงา,8201,อำเภอเมืองพังงา,15496,15899,31395,15511,15916,31427,12247
2563,82,พังงา,8202,อำเภอเกาะยาว,6845,6729,13574,6894,6772,13666,5272
2563,82,พังงา,8203,อำเภอกะปง,6635,6610,13245,6691,6653,13344,5924
2563,82,พังงา,8204,อำเภอตะกั่วทุ่ง,19745,19568,39313,19828,19657,39485,15802
2563,82,พังงา,8205,อำเภอตะกั่วป่า,19929,20398,40327,20771,21136,41907,23677
2563,82,พังงา,8206,อำเภอคุระบุรี,12127,11924,24051,12303,12117,24420,10176
2563,82,พังงา,8207,อำเภอทับปุด,12537,12508,25045,12553,12537,25090,8055
2563,82,พังงา,8208,อำเภอท้ายเหมือง,22746,22267,45013,22916,22386,45302,20768
2563,82,พังงา,8291,ท้องถิ่นเทศบาลตำบลท้ายเหมือง,1593,1714,3307,1599,1719,3318,1744
2563,82,พังงา,8292,ท้องถิ่นเทศบาลตำบลทับปุด,494,526,1020,497,528,1025,650
2563,82,พังงา,8293,ท้องถิ่นเทศบาลตำบลคุระบุรี,1636,1694,3330,1711,1756,3467,2121
2563,82,พังงา,8294,ท้องถิ่นเทศบาลเมืองโคกกลอย,1605,1758,3363,1697,1838,3535,1710
2563,82,พังงา,8295,ท้องถิ่นเทศบาลตำบลกระโสม,860,945,1805,861,949,1810,773
2563,82,พังงา,8296,ท้องถิ่นเทศบาลตำบลท่านา,500,538,1038,503,539,1042,590
2563,82,พังงา,8297,ท้องถิ่นเทศบาลตำบลเกาะยาว,408,424,832,409,424,833,495
2563,82,พังงา,8298,ท้องถิ่นเทศบาลเมืองตะกั่วป่า,3948,4263,8211,3962,4267,8229,2708
2563,82,พังงา,8299,ท้องถิ่นเทศบาลเมืองพังงา,4464,4794,9258,5037,5292,10329,5897
2563,83,ภูเก็ต,8301,อำเภอเมืองภูเก็ต,20355,23131,43486,20537,23210,43747,30443
2563,83,ภูเก็ต,8302,อำเภอกะทู้,3304,3658,6962,3359,3678,7037,6688
2563,83,ภูเก็ต,8303,อำเภอถลาง,44230,47024,91254,44683,47243,91926,69914
2563,83,ภูเก็ต,8391,ท้องถิ่นเทศบาลตำบลวิชิต,24085,27465,51550,24471,27812,52283,34698
2563,83,ภูเก็ต,8392,ท้องถิ่นเทศบาลตำบลราไวย์,8624,9904,18528,8798,9962,18760,19219
2563,83,ภูเก็ต,8393,ท้องถิ่นเทศบาลตำบลรัษฎา,22764,25387,48151,23061,25635,48696,30382
2563,83,ภูเก็ต,8394,ท้องถิ่นเทศบาลตำบลเทพกระษัตรี,4091,4410,8501,4496,4760,9256,4982
2563,83,ภูเก็ต,8395,ท้องถิ่นเทศบาลตำบลเชิงทะเล,3006,3759,6765,3064,3806,6870,3661
2563,83,ภูเก็ต,8396,ท้องถิ่นเทศบาลเมืองกะทู้,13752,16143,29895,14055,16208,30263,21292
2563,83,ภูเก็ต,8397,ท้องถิ่นเทศบาลตำบลกะรน,3623,4045,7668,3661,4072,7733,8500
2563,83,ภูเก็ต,8398,ท้องถิ่นเทศบาลเมืองป่าตอง,8999,9678,18677,9783,10339,20122,16472
2563,83,ภูเก็ต,8399,ท้องถิ่นเทศบาลนครภูเก็ต,32634,39035,71669,35827,41951,77778,26666
2563,84,สุราษฎร์ธานี,8401,อำเภอเมืองสุราษฎร์ธานี,8702,9162,17864,8707,9172,17879,7371
2563,84,สุราษฎร์ธานี,8402,อำเภอกาญจนดิษฐ์,39638,40394,80032,39726,40480,80206,32848
2563,84,สุราษฎร์ธานี,8403,อำเภอดอนสัก,12413,12470,24883,12423,12476,24899,10377
2563,84,สุราษฎร์ธานี,8405,อำเภอเกาะพะงัน,5039,5048,10087,5484,5300,10784,12194
2563,84,สุราษฎร์ธานี,8406,อำเภอไชยา,18874,19700,38574,18905,19718,38623,16594
2563,84,สุราษฎร์ธานี,8407,อำเภอท่าชนะ,25935,25764,51699,25965,25790,51755,22480
2563,84,สุราษฎร์ธานี,8408,อำเภอคีรีรัฐนิคม,20986,21089,42075,21035,21159,42194,16953
2563,84,สุราษฎร์ธานี,8409,อำเภอบ้านตาขุน,4553,4589,9142,4557,4591,9148,3888
2563,84,สุราษฎร์ธานี,8410,อำเภอพนม,12467,11997,24464,12477,12004,24481,9370
2563,84,สุราษฎร์ธานี,8411,อำเภอท่าฉาง,14703,14507,29210,14716,14513,29229,12914
2563,84,สุราษฎร์ธานี,8412,อำเภอบ้านนาสาร,25165,25843,51008,25174,25857,51031,18180
2563,84,สุราษฎร์ธานี,8413,อำเภอบ้านนาเดิม,10301,10514,20815,10305,10515,20820,7681
2563,84,สุราษฎร์ธานี,8414,อำเภอเคียนซา,13771,13715,27486,13886,13827,27713,11194
2563,84,สุราษฎร์ธานี,8415,อำเภอเวียงสระ,8422,8676,17098,8424,8677,17101,6796
2563,84,สุราษฎร์ธานี,8416,อำเภอพระแสง,31484,31195,62679,31493,31206,62699,24170
2563,84,สุราษฎร์ธานี,8417,อำเภอพุนพิน,37201,37114,74315,37313,37235,74548,35363
2563,84,สุราษฎร์ธานี,8418,อำเภอชัยบุรี,14180,13966,28146,14195,13982,28177,11205
2563,84,สุราษฎร์ธานี,8419,อำเภอวิภาวดี,8070,7459,15529,8137,7521,15658,7312
2563,84,สุราษฎร์ธานี,8471,ท้องถิ่นเทศบาลตำบลบ้านเสด็จ,9774,9520,19294,9777,9521,19298,7725
2563,84,สุราษฎร์ธานี,8472,ท้องถิ่นเทศบาลตำบลคลองชะอุ่น,4777,4721,9498,4777,4723,9500,3342
2563,84,สุราษฎร์ธานี,8473,ท้องถิ่นเทศบาลตำบลทุ่งหลวง,5495,5810,11305,5495,5810,11305,4164
2563,84,สุราษฎร์ธานี,8474,ท้องถิ่นเทศบาลตำบลขุนทะเล,7209,9016,16225,7226,9099,16325,11181
2563,84,สุราษฎร์ธานี,8475,ท้องถิ่นเทศบาลตำบลช้างซ้าย,5483,5587,11070,5493,5595,11088,3889
2563,84,สุราษฎร์ธานี,8476,ท้องถิ่นเทศบาลตำบลเขานิพันธ์,3254,3312,6566,3254,3312,6566,2759
2563,84,สุราษฎร์ธานี,8477,ท้องถิ่นเทศบาลตำบลวัดประดู่,8834,9762,18596,8848,9765,18613,10822
2563,84,สุราษฎร์ธานี,8478,ท้องถิ่นเทศบาลตำบลบ้านส้อง,8737,8905,17642,8738,8907,17645,6817
2563,84,สุราษฎร์ธานี,8479,ท้องถิ่นเทศบาลตำบลย่านดินแดง,1194,1242,2436,1217,1258,2475,1077
2563,84,สุราษฎร์ธานี,8480,ท้องถิ่นเทศบาลตำบลบางสวรรค์,2012,2027,4039,2012,2027,4039,1929
2563,84,สุราษฎร์ธานี,8481,ท้องถิ่นเทศบาลเมืองเวียงสระ,4408,4881,9289,4481,4960,9441,5762
2563,84,สุราษฎร์ธานี,8482,ท้องถิ่นเทศบาลตำบลเคียนซา,868,838,1706,868,838,1706,741
2563,84,สุราษฎร์ธานี,8483,ท้องถิ่นเทศบาลตำบลบ้านนา,1573,1691,3264,1585,1699,3284,1638
2563,84,สุราษฎร์ธานี,8484,ท้องถิ่นเทศบาลตำบลท่าฉาง,2272,2438,4710,2300,2466,4766,1923
2563,84,สุราษฎร์ธานี,8485,ท้องถิ่นเทศบาลตำบลพนม,2463,2435,4898,2480,2450,4930,1982
2563,84,สุราษฎร์ธานี,8486,ท้องถิ่นเทศบาลตำบลบ้านตาขุน,1166,1227,2393,1168,1228,2396,1801
2563,84,สุราษฎร์ธานี,8487,ท้องถิ่นเทศบาลตำบลบ้านเชี่ยวหลาน,2288,2257,4545,2290,2257,4547,1948
2563,84,สุราษฎร์ธานี,8488,ท้องถิ่นเทศบาลตำบลท่าขนอน,958,960,1918,965,962,1927,1095
2563,84,สุราษฎร์ธานี,8489,ท้องถิ่นเทศบาลตำบลท่าชนะ,1380,1530,2910,1381,1531,2912,1746
2563,84,สุราษฎร์ธานี,8490,ท้องถิ่นเทศบาลตำบลพุมเรียง,3844,4034,7878,3844,4034,7878,2713
2563,84,สุราษฎร์ธานี,8491,ท้องถิ่นเทศบาลตำบลตลาดไชยา,2313,2633,4946,2485,2802,5287,2930
2563,84,สุราษฎร์ธานี,8492,ท้องถิ่นเทศบาลตำบลเกาะพะงัน,3524,3689,7213,3706,3759,7465,5471
2563,84,สุราษฎร์ธานี,8493,ท้องถิ่นเทศบาลนครเกาะสมุย,31611,34493,66104,33265,35729,68994,55845
2563,84,สุราษฎร์ธานี,8494,ท้องถิ่นเทศบาลเมืองดอนสัก,5856,6189,12045,5883,6215,12098,5734
2563,84,สุราษฎร์ธานี,8495,ท้องถิ่นเทศบาลตำบลท่าทองใหม่,3479,3570,7049,3481,3573,7054,3112
2563,84,สุราษฎร์ธานี,8496,ท้องถิ่นเทศบาลตำบลกาญจนดิษฐ์,4580,4954,9534,4583,4956,9539,4674
2563,84,สุราษฎร์ธานี,8497,ท้องถิ่นเทศบาลเมืองท่าข้าม,9107,9555,18662,9229,9676,18905,9018
2563,84,สุราษฎร์ธานี,8498,ท้องถิ่นเทศบาลเมืองนาสาร,9332,9823,19155,9359,9840,19199,8080
2563,84,สุราษฎร์ธานี,8499,ท้องถิ่นเทศบาลนครสุราษฎร์ธานี,61777,68274,130051,62604,68995,131599,75558
2563,85,ระนอง,8501,อำเภอเมืองระนอง,32307,31770,64077,35580,34654,70234,37744
2563,85,ระนอง,8502,อำเภอละอุ่น,6277,6063,12340,6326,6116,12442,5510
2563,85,ระนอง,8503,อำเภอกะเปอร์,10147,9834,19981,10377,10044,20421,7930
2563,85,ระนอง,8504,อำเภอกระบุรี,22350,21595,43945,22746,21966,44712,22216
2563,85,ระนอง,8505,อำเภอสุขสำราญ,6852,6889,13741,7160,7176,14336,4528
2563,85,ระนอง,8594,ท้องถิ่นเทศบาลตำบลน้ำจืด,1656,1721,3377,1820,1854,3674,1918
2563,85,ระนอง,8595,ท้องถิ่นเทศบาลตำบลกะเปอร์,754,795,1549,757,798,1555,666
2563,85,ระนอง,8596,ท้องถิ่นเทศบาลตำบลละอุ่น,1271,1235,2506,1356,1315,2671,1195
2563,85,ระนอง,8597,ท้องถิ่นเทศบาลตำบลหงาว,1158,1231,2389,1205,1284,2489,1093
2563,85,ระนอง,8598,ท้องถิ่นเทศบาลตำบลปากน้ำ,1307,1159,2466,1343,1210,2553,1753
2563,85,ระนอง,8599,ท้องถิ่นเทศบาลเมืองระนอง,6151,6634,12785,9484,9801,19285,8186
2563,86,ชุมพร,8601,อำเภอเมืองชุมพร,45795,46412,92207,45854,46472,92326,44007
2563,86,ชุมพร,8602,อำเภอท่าแซะ,40724,40894,81618,41127,41280,82407,35258
2563,86,ชุมพร,8603,อำเภอปะทิว,19710,20140,39850,19799,20205,40004,17906
2563,86,ชุมพร,8604,อำเภอหลังสวน,27257,28452,55709,27458,28629,56087,23726
2563,86,ชุมพร,8605,อำเภอละแม,13120,13037,26157,13254,13146,26400,11781
2563,86,ชุมพร,8606,อำเภอพะโต๊ะ,11785,11279,23064,11789,11279,23068,10702
2563,86,ชุมพร,8607,อำเภอสวี,34799,35102,69901,34857,35160,70017,32255
2563,86,ชุมพร,8608,อำเภอทุ่งตะโก,10705,10673,21378,10728,10696,21424,9561
2563,86,ชุมพร,8685,ท้องถิ่นเทศบาลเมืองท่ายาง,5029,5204,10233,5041,5206,10247,4663
2563,86,ชุมพร,8686,ท้องถิ่นเทศบาลตำบลปากตะโก,2081,2014,4095,2084,2014,4098,1621
2563,86,ชุมพร,8687,ท้องถิ่นเทศบาลตำบลนาโพธิ์,1371,1563,2934,1375,1565,2940,1676
2563,86,ชุมพร,8688,ท้องถิ่นเทศบาลตำบลพะโต๊ะ,731,736,1467,739,741,1480,687
2563,86,ชุมพร,8689,ท้องถิ่นเทศบาลตำบลละแม,1477,1584,3061,1483,1592,3075,1815
2563,86,ชุมพร,8690,ท้องถิ่นเทศบาลตำบลปากน้ำหลังสวน,3194,3264,6458,3221,3293,6514,3039
2563,86,ชุมพร,8691,ท้องถิ่นเทศบาลตำบลสะพลี,1051,1161,2212,1053,1161,2214,1131
2563,86,ชุมพร,8692,ท้องถิ่นเทศบาลตำบลมาบอำมฤต,1664,1715,3379,1832,1907,3739,2181
2563,86,ชุมพร,8693,ท้องถิ่นเทศบาลตำบลปะทิว,560,657,1217,635,736,1371,874
2563,86,ชุมพร,8694,ท้องถิ่นเทศบาลตำบลเนินสันติ,901,969,1870,904,974,1878,1248
2563,86,ชุมพร,8695,ท้องถิ่นเทศบาลตำบลท่าแซะ,958,1074,2032,958,1076,2034,1355
2563,86,ชุมพร,8696,ท้องถิ่นเทศบาลตำบลวังไผ่,3190,3522,6712,3195,3525,6720,4604
2563,86,ชุมพร,8697,ท้องถิ่นเทศบาลตำบลปากน้ำชุมพร,2935,3114,6049,3144,3297,6441,3400
2563,86,ชุมพร,8698,ท้องถิ่นเทศบาลเมืองหลังสวน,5144,5819,10963,5158,5828,10986,6853
2563,86,ชุมพร,8699,ท้องถิ่นเทศบาลเมืองชุมพร,15024,17507,32531,15682,18056,33738,19905
2563,90,สงขลา,9001,อำเภอเมืองสงขลา,7315,7931,15246,7327,7933,15260,5479
2563,90,สงขลา,9002,อำเภอสทิงพระ,22056,23123,45179,22064,23127,45191,13716
2563,90,สงขลา,9003,อำเภอจะนะ,50172,50889,101061,50202,50914,101116,27516
2563,90,สงขลา,9004,อำเภอนาทวี,31896,31081,62977,31928,31112,63040,19417
2563,90,สงขลา,9005,อำเภอเทพา,31042,29235,60277,31087,29286,60373,16505
2563,90,สงขลา,9006,อำเภอสะบ้าย้อย,39674,38690,78364,39761,38753,78514,19054
2563,90,สงขลา,9007,อำเภอระโนด,23950,24575,48525,23970,24602,48572,19310
2563,90,สงขลา,9008,อำเภอกระแสสินธุ์,7345,7617,14962,7349,7619,14968,5163
2563,90,สงขลา,9009,อำเภอรัตภูมิ,33340,34018,67358,33583,34025,67608,21813
2563,90,สงขลา,9010,อำเภอสะเดา,29187,28891,58078,29409,29123,58532,21237
2563,90,สงขลา,9011,อำเภอหาดใหญ่,14726,15928,30654,14760,15957,30717,12806
2563,90,สงขลา,9012,อำเภอนาหม่อม,11061,11852,22913,11076,11857,22933,8987
2563,90,สงขลา,9013,อำเภอควนเนียง,14738,15321,30059,14755,15332,30087,9769
2563,90,สงขลา,9014,อำเภอบางกล่ำ,4840,4993,9833,4920,5046,9966,3394
2563,90,สงขลา,9015,อำเภอสิงหนคร,21524,22593,44117,21531,22594,44125,14664
2563,90,สงขลา,9016,อำเภอคลองหอยโข่ง,6234,5755,11989,6279,5805,12084,5073
2563,90,สงขลา,9066,ท้องถิ่นเทศบาลเมืองทุ่งตำเสา,8253,8671,16924,8262,8679,16941,6032
2563,90,สงขลา,9067,ท้องถิ่นเทศบาลตำบลโคกม่วง,4217,3490,7707,4219,3494,7713,2734
2563,90,สงขลา,9068,ท้องถิ่นเทศบาลตำบลทุ่งลาน,3566,3785,7351,3571,3785,7356,2499
2563,90,สงขลา,9069,ท้องถิ่นเทศบาลตำบลเกาะแต้ว,5555,5922,11477,5558,5924,11482,3773
2563,90,สงขลา,9070,ท้องถิ่นเทศบาลตำบลคูเต่า,5669,5772,11441,5674,5773,11447,3155
2563,90,สงขลา,9071,ท้องถิ่นเทศบาลตำบลท่าช้าง,10958,11135,22093,10971,11139,22110,9709
2563,90,สงขลา,9072,ท้องถิ่นเทศบาลตำบลน้ำน้อย,6956,7813,14769,6972,7814,14786,6044
2563,90,สงขลา,9073,ท้องถิ่นเทศบาลตำบลลำไพล,7829,7995,15824,7859,8011,15870,4572
2563,90,สงขลา,9074,ท้องถิ่นเทศบาลตำบลบ้านไร่,3919,4100,8019,3931,4104,8035,3384
2563,90,สงขลา,9075,ท้องถิ่นเทศบาลตำบลพะวง,15775,17251,33026,16230,17693,33923,15176
2563,90,สงขลา,9076,ท้องถิ่นเทศบาลเมืองเขารูปช้าง,20151,22901,43052,20195,22913,43108,20451
2563,90,สงขลา,9077,ท้องถิ่นเทศบาลตำบลสำนักขาม,6268,7380,13648,6331,7415,13746,9249
2563,90,สงขลา,9078,ท้องถิ่นเทศบาลเมืองคลองแห,19098,21521,40619,19126,21540,40666,20846
2563,90,สงขลา,9079,ท้องถิ่นเทศบาลเมืองควนลัง,23041,26160,49201,23112,26209,49321,25502
2563,90,สงขลา,9080,ท้องถิ่นเทศบาลเมืองคอหงส์,22031,23987,46018,22137,24047,46184,29265
2563,90,สงขลา,9081,ท้องถิ่นเทศบาลเมืองสิงหนคร,19690,20157,39847,19706,20162,39868,13077
2563,90,สงขลา,9082,ท้องถิ่นเทศบาลตำบลควนเนียง,1930,2216,4146,1942,2228,4170,1753
2563,90,สงขลา,9083,ท้องถิ่นเทศบาลตำบลพะตง,3588,4073,7661,3625,4101,7726,4737
2563,90,สงขลา,9084,ท้องถิ่นเทศบาลตำบลคลองแงะ,4009,4143,8152,4071,4199,8270,3415
2563,90,สงขลา,9085,ท้องถิ่นเทศบาลเมืองปาดังเบซาร์,7738,8153,15891,7761,8177,15938,6168
2563,90,สงขลา,9086,ท้องถิ่นเทศบาลตำบลปริก,3111,3250,6361,3119,3251,6370,2011
2563,90,สงขลา,9087,ท้องถิ่นเทศบาลตำบลนาสีทอง,1380,1533,2913,1381,1534,2915,1107
2563,90,สงขลา,9088,ท้องถิ่นเทศบาลตำบลกำแพงเพชร,2321,2480,4801,2373,2540,4913,2550
2563,90,สงขลา,9089,ท้องถิ่นเทศบาลตำบลระโนด,2176,2363,4539,2177,2364,4541,1946
2563,90,สงขลา,9090,ท้องถิ่นเทศบาลตำบลบ่อตรุ,5446,5659,11105,5447,5659,11106,3472
2563,90,สงขลา,9091,ท้องถิ่นเทศบาลตำบลสะบ้าย้อย,625,681,1306,625,681,1306,786
2563,90,สงขลา,9092,ท้องถิ่นเทศบาลตำบลเทพา,1142,1192,2334,1150,1200,2350,1056
2563,90,สงขลา,9093,ท้องถิ่นเทศบาลตำบลนาทวี,3003,3066,6069,3215,3254,6469,3683
2563,90,สงขลา,9094,ท้องถิ่นเทศบาลตำบลจะนะ,3321,3458,6779,3384,3500,6884,3292
2563,90,สงขลา,9095,ท้องถิ่นเทศบาลตำบลสทิงพระ,1314,1467,2781,1315,1467,2782,1290
2563,90,สงขลา,9096,ท้องถิ่นเทศบาลเมืองบ้านพรุ,12406,13668,26074,12441,13690,26131,12353
2563,90,สงขลา,9097,ท้องถิ่นเทศบาลเมืองสะเดา,10251,10827,21078,10526,11090,21616,8747
2563,90,สงขลา,9098,ท้องถิ่นเทศบาลนครหาดใหญ่,66186,77869,144055,69036,80423,149459,68333
2563,90,สงขลา,9099,ท้องถิ่นเทศบาลนครสงขลา,28841,31071,59912,28906,31115,60021,27527
2563,91,สตูล,9101,อำเภอเมืองสตูล,32416,33300,65716,32447,33330,65777,18364
2563,91,สตูล,9102,อำเภอควนโดน,10711,10894,21605,10720,10895,21615,5977
2563,91,สตูล,9103,อำเภอควนกาหลง,17746,17613,35359,17754,17622,35376,11917
2563,91,สตูล,9104,อำเภอท่าแพ,14690,14949,29639,14703,14951,29654,8716
2563,91,สตูล,9105,อำเภอละงู,33974,34287,68261,34087,34388,68475,20869
2563,91,สตูล,9106,อำเภอทุ่งหว้า,10573,10497,21070,10594,10514,21108,6649
2563,91,สตูล,9107,อำเภอมะนัง,9470,9036,18506,9473,9036,18509,6319
2563,91,สตูล,9193,ท้องถิ่นเทศบาลตำบลคลองขุด,10544,9813,20357,10554,9815,20369,9086
2563,91,สตูล,9194,ท้องถิ่นเทศบาลตำบลทุ่งหว้า,1584,1653,3237,1586,1653,3239,1231
2563,91,สตูล,9195,ท้องถิ่นเทศบาลตำบลกำแพง,2377,2628,5005,2380,2629,5009,2834
2563,91,สตูล,9196,ท้องถิ่นเทศบาลตำบลควนโดน,2704,2716,5420,2707,2719,5426,1925
2563,91,สตูล,9197,ท้องถิ่นเทศบาลตำบลฉลุง,1136,1222,2358,1136,1222,2358,996
2563,91,สตูล,9198,ท้องถิ่นเทศบาลตำบลเจ๊ะบิลัง,2006,2015,4021,2016,2023,4039,997
2563,91,สตูล,9199,ท้องถิ่นเทศบาลเมืองสตูล,11084,11946,23030,11146,11998,23144,10023
2563,92,ตรัง,9201,อำเภอเมืองตรัง,45702,48976,94678,45759,49012,94771,39876
2563,92,ตรัง,9202,อำเภอกันตัง,37420,37636,75056,37440,37660,75100,23967
2563,92,ตรัง,9203,อำเภอย่านตาขาว,27791,28805,56596,27834,28830,56664,17741
2563,92,ตรัง,9204,อำเภอปะเหลียน,31030,31856,62886,31083,31899,62982,21459
2563,92,ตรัง,9205,อำเภอสิเกา,17502,17169,34671,17523,17193,34716,12505
2563,92,ตรัง,9206,อำเภอห้วยยอด,38695,39774,78469,38792,39851,78643,26655
2563,92,ตรัง,9207,อำเภอวังวิเศษ,20089,20332,40421,20102,20347,40449,13916
2563,92,ตรัง,9208,อำเภอนาโยง,19933,21191,41124,19938,21191,41129,13405
2563,92,ตรัง,9209,อำเภอรัษฎา,13279,13666,26945,13301,13695,26996,9829
2563,92,ตรัง,9210,อำเภอหาดสำราญ,8487,8403,16890,8493,8410,16903,4855
2563,92,ตรัง,9286,ท้องถิ่นเทศบาลตำบลคลองปาง,1094,1159,2253,1095,1160,2255,1325
2563,92,ตรัง,9287,ท้องถิ่นเทศบาลตำบลนาโยงเหนือ,1671,1847,3518,1674,1849,3523,1551
2563,92,ตรัง,9288,ท้องถิ่นเทศบาลตำบลวังวิเศษ,1465,1514,2979,1486,1534,3020,1320
2563,92,ตรัง,9289,ท้องถิ่นเทศบาลตำบลลำภูรา,1980,1465,3445,1980,1465,3445,1489
2563,92,ตรัง,9290,ท้องถิ่นเทศบาลตำบลนาวง,1958,2079,4037,1966,2079,4045,1792
2563,92,ตรัง,9291,ท้องถิ่นเทศบาลตำบลสิเกา,656,715,1371,687,740,1427,661
2563,92,ตรัง,9292,ท้องถิ่นเทศบาลตำบลควนกุน,1060,1118,2178,1060,1118,2178,747
2563,92,ตรัง,9293,ท้องถิ่นเทศบาลตำบลทุ่งยาว,1140,1311,2451,1147,1317,2464,1092
2563,92,ตรัง,9294,ท้องถิ่นเทศบาลตำบลท่าข้าม,704,688,1392,706,690,1396,661
2563,92,ตรัง,9295,ท้องถิ่นเทศบาลตำบลย่านตาขาว,3571,4156,7727,3588,4176,7764,3794
2563,92,ตรัง,9296,ท้องถิ่นเทศบาลตำบลคลองเต็ง,1786,1949,3735,1793,1951,3744,1709
2563,92,ตรัง,9297,ท้องถิ่นเทศบาลตำบลห้วยยอด,3922,4315,8237,3932,4320,8252,4110
2563,92,ตรัง,9298,ท้องถิ่นเทศบาลเมืองกันตัง,5755,5964,11719,5806,6009,11815,5033
2563,92,ตรัง,9299,ท้องถิ่นเทศบาลนครตรัง,25922,30471,56393,26183,30710,56893,25371
2563,93,พัทลุง,9301,อำเภอเมืองพัทลุง,42378,46052,88430,42410,46067,88477,33671
2563,93,พัทลุง,9302,อำเภอกงหรา,14688,14620,29308,14688,14622,29310,9369
2563,93,พัทลุง,9303,อำเภอเขาชัยสน,15181,15802,30983,15189,15807,30996,11443
2563,93,พัทลุง,9304,อำเภอตะโหมด,7064,7214,14278,7068,7216,14284,4681
2563,93,พัทลุง,9305,อำเภอควนขนุน,38011,41174,79185,38021,41178,79199,29999
2563,93,พัทลุง,9306,อำเภอปากพะยูน,16173,16649,32822,16174,16650,32824,11004
2563,93,พัทลุง,9307,อำเภอศรีบรรพต,9004,8967,17971,9008,8976,17984,6869
2563,93,พัทลุง,9308,อำเภอป่าบอน,21708,22092,43800,21713,22094,43807,15726
2563,93,พัทลุง,9309,อำเภอบางแก้ว,8848,8988,17836,8853,8990,17843,6387
2563,93,พัทลุง,9310,อำเภอป่าพะยอม,13281,13922,27203,13286,13932,27218,10717
2563,93,พัทลุง,9311,อำเภอศรีนครินทร์,5136,5317,10453,5138,5320,10458,3604
2563,93,พัทลุง,9382,ท้องถิ่นเทศบาลตำบลเขาหัวช้าง,3561,3584,7145,3561,3585,7146,2142
2563,93,พัทลุง,9383,ท้องถิ่นเทศบาลตำบลชะรัด,3618,3690,7308,3620,3690,7310,2237
2563,93,พัทลุง,9384,ท้องถิ่นเทศบาลตำบลหารเทา,4946,5092,10038,4949,5092,10041,3472
2563,93,พัทลุง,9385,ท้องถิ่นเทศบาลตำบลบางแก้ว,1861,1932,3793,1865,1933,3798,1421
2563,93,พัทลุง,9386,ท้องถิ่นเทศบาลตำบลอ่าวพะยูน,2273,2370,4643,2278,2372,4650,1634
2563,93,พัทลุง,9387,ท้องถิ่นเทศบาลตำบลชุมพล,4808,4124,8932,4811,4124,8935,3530
2563,93,พัทลุง,9388,ท้องถิ่นเทศบาลตำบลโคกม่วง,5113,5271,10384,5114,5272,10386,3623
2563,93,พัทลุง,9389,ท้องถิ่นเทศบาลตำบลบ้านนา,3723,3804,7527,3725,3804,7529,3053
2563,93,พัทลุง,9390,ท้องถิ่นเทศบาลตำบลลานข่อย,4222,4453,8675,4226,4453,8679,2909
2563,93,พัทลุง,9391,ท้องถิ่นเทศบาลตำบลท่ามะเดื่อ,2007,2158,4165,2009,2161,4170,1785
2563,93,พัทลุง,9392,ท้องถิ่นเทศบาลตำบลป่าบอน,1930,1989,3919,1932,1989,3921,1714
2563,93,พัทลุง,9393,ท้องถิ่นเทศบาลตำบลปากพะยูน,1572,1705,3277,1576,1707,3283,1523
2563,93,พัทลุง,9394,ท้องถิ่นเทศบาลตำบลมะกอกเหนือ,981,1167,2148,982,1170,2152,790
2563,93,พัทลุง,9395,ท้องถิ่นเทศบาลตำบลควนขนุน,1014,1135,2149,1018,1138,2156,1176
2563,93,พัทลุง,9396,ท้องถิ่นเทศบาลตำบลแม่ขรี,2989,3240,6229,2995,3244,6239,3398
2563,93,พัทลุง,9397,ท้องถิ่นเทศบาลตำบลตะโหมด,2120,2209,4329,2120,2209,4329,1549
2563,93,พัทลุง,9398,ท้องถิ่นเทศบาลตำบลเขาชัยสน,1665,1856,3521,1669,1861,3530,1597
2563,93,พัทลุง,9399,ท้องถิ่นเทศบาลเมืองพัทลุง,14835,17458,32293,14910,17513,32423,16063
2563,94,ปัตตานี,9401,อำเภอเมืองปัตตานี,43391,48167,91558,43448,48214,91662,30960
2563,94,ปัตตานี,9402,อำเภอโคกโพธิ์,30368,31805,62173,30383,31812,62195,17737
2563,94,ปัตตานี,9403,อำเภอหนองจิก,29338,29579,58917,29347,29583,58930,13296
2563,94,ปัตตานี,9404,อำเภอปะนาเระ,17920,18700,36620,17928,18706,36634,9536
2563,94,ปัตตานี,9405,อำเภอมายอ,27697,28370,56067,27714,28395,56109,12716
2563,94,ปัตตานี,9406,อำเภอทุ่งยางแดง,12282,12677,24959,12284,12682,24966,5854
2563,94,ปัตตานี,9407,อำเภอสายบุรี,27730,28899,56629,27741,28910,56651,13457
2563,94,ปัตตานี,9408,อำเภอไม้แก่น,6388,6550,12938,6388,6552,12940,3381
2563,94,ปัตตานี,9409,อำเภอยะหริ่ง,34884,35225,70109,34921,35257,70178,15895
2563,94,ปัตตานี,9410,อำเภอยะรัง,44784,44918,89702,44803,44930,89733,21773
2563,94,ปัตตานี,9411,อำเภอกะพ้อ,9324,9588,18912,9326,9591,18917,4444
2563,94,ปัตตานี,9412,อำเภอแม่ลาน,8536,8853,17389,8542,8861,17403,4473
2563,94,ปัตตานี,9488,ท้องถิ่นเทศบาลตำบลยะรัง,2466,2577,5043,2466,2578,5044,1337
2563,94,ปัตตานี,9489,ท้องถิ่นเทศบาลตำบลยะหริ่ง,3185,3066,6251,3186,3068,6254,1916
2563,94,ปัตตานี,9490,ท้องถิ่นเทศบาลตำบลบางปู,5181,5229,10410,5183,5230,10413,2257
2563,94,ปัตตานี,9491,ท้องถิ่นเทศบาลตำบลตันหยง,1318,1484,2802,1321,1485,2806,730
2563,94,ปัตตานี,9492,ท้องถิ่นเทศบาลตำบลมายอ,2414,2419,4833,2417,2420,4837,1194
2563,94,ปัตตานี,9493,ท้องถิ่นเทศบาลตำบลปะนาเระ,5302,5245,10547,5303,5246,10549,2642
2563,94,ปัตตานี,9494,ท้องถิ่นเทศบาลตำบลหนองจิก,3138,3143,6281,3143,3149,6292,1982
2563,94,ปัตตานี,9495,ท้องถิ่นเทศบาลตำบลบ่อทอง,10189,6320,16509,10194,6323,16517,5868
2563,94,ปัตตานี,9496,ท้องถิ่นเทศบาลตำบลนาประดู่,1506,1606,3112,1509,1608,3117,1403
2563,94,ปัตตานี,9497,ท้องถิ่นเทศบาลตำบลโคกโพธิ์,1592,1762,3354,1593,1763,3356,1790
2563,94,ปัตตานี,9498,ท้องถิ่นเทศบาลเมืองตะลุบัน,7112,7332,14444,7133,7351,14484,4420
2563,94,ปัตตานี,9499,ท้องถิ่นเทศบาลเมืองปัตตานี,21741,23117,44858,22338,23690,46028,16163
2563,95,ยะลา,9501,อำเภอเมืองยะลา,37639,38672,76311,37643,38675,76318,18681
2563,95,ยะลา,9502,อำเภอเบตง,18377,17217,35594,18591,17461,36052,15649
2563,95,ยะลา,9503,อำเภอบันนังสตา,28455,27362,55817,28508,27413,55921,15689
2563,95,ยะลา,9504,อำเภอธารโต,12507,11463,23970,12568,11504,24072,9015
2563,95,ยะลา,9505,อำเภอยะหา,30770,30560,61330,30778,30563,61341,14407
2563,95,ยะลา,9506,อำเภอรามัน,42775,43690,86465,42788,43701,86489,20622
2563,95,ยะลา,9507,อำเภอกาบัง,12918,12333,25251,12931,12341,25272,7053
2563,95,ยะลา,9508,อำเภอกรงปินัง,14998,14780,29778,14999,14780,29779,6530
2563,95,ยะลา,9590,ท้องถิ่นเทศบาลเมืองสะเตงนอก,16399,17503,33902,16407,17507,33914,14734
2563,95,ยะลา,9591,ท้องถิ่นเทศบาลตำบลเขื่อนบางลาง,2349,2136,4485,2349,2136,4485,2000
2563,95,ยะลา,9592,ท้องถิ่นเทศบาลตำบลโกตาบารู,2897,2977,5874,2899,2978,5877,1539
2563,95,ยะลา,9593,ท้องถิ่นเทศบาลตำบลเมืองรามันห์,2514,2579,5093,2519,2580,5099,1865
2563,95,ยะลา,9594,ท้องถิ่นเทศบาลตำบลยะหา,1258,1220,2478,1258,1220,2478,759
2563,95,ยะลา,9595,ท้องถิ่นเทศบาลตำบลคอกช้าง,768,731,1499,768,731,1499,584
2563,95,ยะลา,9596,ท้องถิ่นเทศบาลตำบลบันนังสตา,1311,1300,2611,1311,1300,2611,979
2563,95,ยะลา,9597,ท้องถิ่นเทศบาลตำบลลำใหม่,495,496,991,495,496,991,378
2563,95,ยะลา,9598,ท้องถิ่นเทศบาลเมืองเบตง,12638,13593,26231,12730,13691,26421,11310
2563,95,ยะลา,9599,ท้องถิ่นเทศบาลนครยะลา,28106,31322,59428,28377,31606,59983,28297
2563,96,นราธิวาส,9601,อำเภอเมืองนราธิวาส,42100,42412,84512,42135,42439,84574,25961
2563,96,นราธิวาส,9602,อำเภอตากใบ,26669,27398,54067,26691,27412,54103,11914
2563,96,นราธิวาส,9603,อำเภอบาเจาะ,20253,20862,41115,20264,20868,41132,9376
2563,96,นราธิวาส,9604,อำเภอยี่งอ,21723,22306,44029,21732,22319,44051,10454
2563,96,นราธิวาส,9605,อำเภอระแงะ,38364,39695,78059,38375,39706,78081,17399
2563,96,นราธิวาส,9606,อำเภอรือเสาะ,33110,33347,66457,33114,33352,66466,15681
2563,96,นราธิวาส,9607,อำเภอศรีสาคร,18413,17876,36289,18422,17886,36308,9408
2563,96,นราธิวาส,9608,อำเภอแว้ง,21487,22083,43570,21514,22116,43630,10323
2563,96,นราธิวาส,9609,อำเภอสุคิริน,11708,11251,22959,11713,11265,22978,7392
2563,96,นราธิวาส,9610,อำเภอสุไหงโกลก,18140,19416,37556,18157,19433,37590,10994
2563,96,นราธิวาส,9611,อำเภอสุไหงปาดี,23706,24378,48084,23733,24403,48136,12081
2563,96,นราธิวาส,9612,อำเภอจะแนะ,19950,19305,39255,19969,19317,39286,9674
2563,96,นราธิวาส,9613,อำเภอเจาะไอร้อง,20441,20497,40938,20450,20503,40953,9694
2563,96,นราธิวาส,9686,ท้องถิ่นเทศบาลตำบลปะลุรู,3453,3573,7026,3475,3588,7063,2085
2563,96,นราธิวาส,9687,ท้องถิ่นเทศบาลตำบลสุคิริน,1775,1675,3450,1783,1688,3471,1569
2563,96,นราธิวาส,9688,ท้องถิ่นเทศบาลตำบลแว้ง,2610,2739,5349,2611,2741,5352,1665
2563,96,นราธิวาส,9689,ท้องถิ่นเทศบาลตำบลบูเก๊ะตา,2465,2573,5038,2467,2575,5042,1381
2563,96,นราธิวาส,9690,ท้องถิ่นเทศบาลตำบลศรีสาคร,2568,2491,5059,2581,2500,5081,1770
2563,96,นราธิวาส,9691,ท้องถิ่นเทศบาลตำบลรือเสาะ,3694,3820,7514,3712,3825,7537,3509
2563,96,นราธิวาส,9692,ท้องถิ่นเทศบาลตำบลมะรือโบตก,4238,4180,8418,4242,4181,8423,1758
2563,96,นราธิวาส,9693,ท้องถิ่นเทศบาลตำบลตันหยงมัส,3370,3635,7005,3402,3652,7054,3808
2563,96,นราธิวาส,9694,ท้องถิ่นเทศบาลตำบลยี่งอ,1515,1536,3051,1520,1537,3057,1086
2563,96,นราธิวาส,9695,ท้องถิ่นเทศบาลตำบลบาเจาะ,4752,4754,9506,4758,4760,9518,2277
2563,96,นราธิวาส,9696,ท้องถิ่นเทศบาลตำบลต้นไทร,2337,2564,4901,2338,2564,4902,1354
2563,96,นราธิวาส,9697,ท้องถิ่นเทศบาลเมืองตากใบ,9548,10115,19663,9557,10129,19686,5659
2563,96,นราธิวาส,9698,ท้องถิ่นเทศบาลเมืองสุไหงโกลก,19161,21358,40519,19312,21510,40822,15395
2563,96,นราธิวาส,9699,ท้องถิ่นเทศบาลเมืองนราธิวาส,19499,20324,39823,19673,20460,40133,15736
2564,10,กรุงเทพมหานคร,1001,เขตพระนคร,20303,22034,42337,20753,22309,43062,19140
2564,10,กรุงเทพมหานคร,1002,เขตดุสิต,42949,36959,79908,43840,37654,81494,31693
2564,10,กรุงเทพมหานคร,1003,เขตหนองจอก,86748,91708,178456,86985,91871,178856,68505
2564,10,กรุงเทพมหานคร,1004,เขตบางรัก,16287,19679,35966,21172,23843,45015,32664
2564,10,กรุงเทพมหานคร,1005,เขตบางเขน,86903,98447,185350,87386,98814,186200,115522
2564,10,กรุงเทพมหานคร,1006,เขตบางกะปิ,63724,77109,140833,64756,77818,142574,109419
2564,10,กรุงเทพมหานคร,1007,เขตปทุมวัน,17995,20886,38881,19596,22167,41763,32328
2564,10,กรุงเทพมหานคร,1008,เขตป้อมปราบศัตรูพ่าย,18389,19617,38006,19672,20746,40418,19609
2564,10,กรุงเทพมหานคร,1009,เขตพระโขนง,38739,47573,86312,39143,47875,87018,61515
2564,10,กรุงเทพมหานคร,1010,เขตมีนบุรี,66170,74443,140613,66632,74742,141374,63274
2564,10,กรุงเทพมหานคร,1011,เขตลาดกระบัง,84173,93473,177646,84621,93803,178424,100871
2564,10,กรุงเทพมหานคร,1012,เขตยานนาวา,33742,39538,73280,34827,40249,75076,53663
2564,10,กรุงเทพมหานคร,1013,เขตสัมพันธวงศ์,9646,10452,20098,10065,10712,20777,13177
2564,10,กรุงเทพมหานคร,1014,เขตพญาไท,31823,33343,65166,32448,33764,66212,44826
2564,10,กรุงเทพมหานคร,1015,เขตธนบุรี,46591,53219,99810,47330,53887,101217,61449
2564,10,กรุงเทพมหานคร,1016,เขตบางกอกใหญ่,29013,33102,62115,29283,33367,62650,32521
2564,10,กรุงเทพมหานคร,1017,เขตห้วยขวาง,35937,45023,80960,37246,46032,83278,86846
2564,10,กรุงเทพมหานคร,1018,เขตคลองสาน,28820,34304,63124,31176,36403,67579,40914
2564,10,กรุงเทพมหานคร,1019,เขตตลิ่งชัน,47512,54415,101927,47806,54663,102469,43319
2564,10,กรุงเทพมหานคร,1020,เขตบางกอกน้อย,46520,52496,99016,47817,53694,101511,51364
2564,10,กรุงเทพมหานคร,1021,เขตบางขุนเทียน,86473,97437,183910,87046,97948,184994,92129
2564,10,กรุงเทพมหานคร,1022,เขตภาษีเจริญ,56608,65306,121914,57096,65728,122824,65974
2564,10,กรุงเทพมหานคร,1023,เขตหนองแขม,71820,82544,154364,72347,83013,155360,63568
2564,10,กรุงเทพมหานคร,1024,เขตราษฎร์บูรณะ,36471,40350,76821,36852,40657,77509,38059
2564,10,กรุงเทพมหานคร,1025,เขตบางพลัด,39836,47859,87695,40151,48139,88290,57812
2564,10,กรุงเทพมหานคร,1026,เขตดินแดง,51335,60708,112043,51754,61060,112814,63891
2564,10,กรุงเทพมหานคร,1027,เขตบึงกุ่ม,63036,75581,138617,63412,75922,139334,76268
2564,10,กรุงเทพมหานคร,1028,เขตสาทร,33331,37938,71269,34930,39057,73987,43840
2564,10,กรุงเทพมหานคร,1029,เขตบางซื่อ,55414,64429,119843,55921,64797,120718,76659
2564,10,กรุงเทพมหานคร,1030,เขตจตุจักร,70390,82632,153022,71058,83088,154146,129790
2564,10,กรุงเทพมหานคร,1031,เขตบางคอแหลม,37204,41933,79137,38217,42761,80978,40393
2564,10,กรุงเทพมหานคร,1032,เขตประเวศ,83758,95310,179068,85211,96421,181632,93842
2564,10,กรุงเทพมหานคร,1033,เขตคลองเตย,42179,47506,89685,43403,48233,91636,78678
2564,10,กรุงเทพมหานคร,1034,เขตสวนหลวง,54934,66022,120956,56032,66792,122824,82161
2564,10,กรุงเทพมหานคร,1035,เขตจอมทอง,67111,75354,142465,68913,76858,145771,73995
2564,10,กรุงเทพมหานคร,1036,เขตดอนเมือง,83225,84111,167336,83606,84315,167921,78493
2564,10,กรุงเทพมหานคร,1037,เขตราชเทวี,28143,31865,60008,32260,35475,67735,54612
2564,10,กรุงเทพมหานคร,1038,เขตลาดพร้าว,52139,62834,114973,52473,63129,115602,58086
2564,10,กรุงเทพมหานคร,1039,เขตวัฒนา,30698,37497,68195,37755,43627,81382,82927
2564,10,กรุงเทพมหานคร,1040,เขตบางแค,88446,102516,190962,89222,103209,192431,94679
2564,10,กรุงเทพมหานคร,1041,เขตหลักสี่,47168,52930,100098,47405,53129,100534,58706
2564,10,กรุงเทพมหานคร,1042,เขตสายไหม,95947,109138,205085,96935,109896,206831,106948
2564,10,กรุงเทพมหานคร,1043,เขตคันนายาว,40339,47141,87480,44604,51032,95636,46218
2564,10,กรุงเทพมหานคร,1044,เขตสะพานสูง,43633,51715,95348,43972,51950,95922,41892
2564,10,กรุงเทพมหานคร,1045,เขตวังทองหลาง,47843,57239,105082,48304,57597,105901,63328
2564,10,กรุงเทพมหานคร,1046,เขตคลองสามวา,96937,108892,205829,97295,109142,206437,88145
2564,10,กรุงเทพมหานคร,1047,เขตบางนา,39606,46138,85744,40379,46674,87053,72310
2564,10,กรุงเทพมหานคร,1048,เขตทวีวัฒนา,36195,42117,78312,36457,42341,78798,34905
2564,10,กรุงเทพมหานคร,1049,เขตทุ่งครุ,57334,65331,122665,57748,65644,123392,55205
2564,10,กรุงเทพมหานคร,1050,เขตบางบอน,47786,52581,100367,48980,53655,102635,51099
2564,11,สมุทรปราการ,1101,อำเภอเมืองสมุทรปราการ,60076,66939,127015,60207,67037,127244,59084
2564,11,สมุทรปราการ,1102,อำเภอบางบ่อ,45449,48203,93652,46049,48735,94784,46974
2564,11,สมุทรปราการ,1103,อำเภอบางพลี,124972,141317,266289,125824,141887,267711,173802
2564,11,สมุทรปราการ,1104,อำเภอพระประแดง,18323,19989,38312,18351,20018,38369,13444
2564,11,สมุทรปราการ,1105,อำเภอพระสมุทรเจดีย์,55983,60543,116526,56107,60648,116755,55716
2564,11,สมุทรปราการ,1106,อำเภอบางเสาธง,29030,31112,60142,29125,31173,60298,45276
2564,11,สมุทรปราการ,1183,ท้องถิ่นเทศบาลเมืองปากน้ำสมุทรปราการ,17421,19897,37318,17488,19942,37430,16532
2564,11,สมุทรปราการ,1184,ท้องถิ่นเทศบาลตำบลบางเสาธง,10152,11182,21334,10180,11205,21385,17156
2564,11,สมุทรปราการ,1185,ท้องถิ่นเทศบาลตำบลแหลมฟ้าผ่า,10403,10963,21366,10426,10995,21421,9469
2564,11,สมุทรปราการ,1186,ท้องถิ่นเทศบาลตำบลพระสมุทรเจดีย์,5546,5740,11286,5828,6011,11839,5711
2564,11,สมุทรปราการ,1187,ท้องถิ่นเทศบาลตำบลบางพลี,3367,3564,6931,5861,5883,11744,2212
2564,11,สมุทรปราการ,1188,ท้องถิ่นเทศบาลตำบลบางบ่อ,3025,3323,6348,3044,3331,6375,2396
2564,11,สมุทรปราการ,1189,ท้องถิ่นเทศบาลตำบลคลองสวน,1430,1512,2942,1432,1512,2944,866
2564,11,สมุทรปราการ,1190,ท้องถิ่นเทศบาลตำบลคลองด่าน,5523,5731,11254,5538,5747,11285,3215
2564,11,สมุทรปราการ,1191,ท้องถิ่นเทศบาลตำบลบางปู,57200,61781,118981,57367,61916,119283,60294
2564,11,สมุทรปราการ,1192,ท้องถิ่นเทศบาลตำบลแพรกษา,12415,14033,26448,12456,14071,26527,15685
2564,11,สมุทรปราการ,1193,ท้องถิ่นเทศบาลตำบลบางเมือง,45901,52565,98466,46069,52721,98790,50229
2564,11,สมุทรปราการ,1194,ท้องถิ่นเทศบาลตำบลด่านสำโรง,25223,28872,54095,25340,28960,54300,26474
2564,11,สมุทรปราการ,1195,ท้องถิ่นเทศบาลเมืองปู่เจ้าสมิงพราย,34056,36255,70311,34184,36363,70547,35748
2564,11,สมุทรปราการ,1196,ท้องถิ่นเทศบาลตำบลสำโรงเหนือ,13756,16532,30288,13906,16623,30529,31219
2564,11,สมุทรปราการ,1197,ท้องถิ่นเทศบาลเมืองลัดหลวง,32414,35488,67902,33180,36237,69417,37499
2564,11,สมุทรปราการ,1198,ท้องถิ่นเทศบาลเมืองพระประแดง,4154,4437,8591,4207,4487,8694,2185
2564,11,สมุทรปราการ,1199,ท้องถิ่นเทศบาลนครสมุทรปราการ,20172,21750,41922,23715,25063,48778,21999
2564,12,นนทบุรี,1201,อำเภอเมืองนนทบุรี,26918,31015,57933,26998,31082,58080,30885
2564,12,นนทบุรี,1202,อำเภอบางกรวย,15704,18494,34198,15760,18552,34312,19869
2564,12,นนทบุรี,1203,อำเภอบางใหญ่,48357,56158,104515,48652,56388,105040,52740
2564,12,นนทบุรี,1204,อำเภอบางบัวทอง,87232,99875,187107,87502,100127,187629,98118
2564,12,นนทบุรี,1205,อำเภอไทรน้อย,33204,36678,69882,33439,36900,70339,33605
2564,12,นนทบุรี,1206,อำเภอปากเกร็ด,23632,26234,49866,23894,26650,50544,24121
2564,12,นนทบุรี,1286,ท้องถิ่นเทศบาลเมืองเสาธงหิน,18012,21723,39735,18099,21793,39892,26714
2564,12,นนทบุรี,1287,ท้องถิ่นเทศบาลเมืองบางพลับ,5196,6042,11238,5225,6056,11281,6052
2564,12,นนทบุรี,1288,ท้องถิ่นเทศบาลเมืองพิมลราช,22712,26360,49072,22755,26409,49164,24029
2564,12,นนทบุรี,1289,ท้องถิ่นเทศบาลเมืองศาลากลาง,9868,11464,21332,9892,11478,21370,11481
2564,12,นนทบุรี,1290,ท้องถิ่นเทศบาลเมืองไทรม้า,10967,12973,23940,11026,13007,24033,15853
2564,12,นนทบุรี,1291,ท้องถิ่นเทศบาลตำบลไทรน้อย,1240,1228,2468,1252,1231,2483,1078
2564,12,นนทบุรี,1292,ท้องถิ่นเทศบาลเมืองบางใหญ่,6028,6569,12597,6054,6589,12643,5957
2564,12,นนทบุรี,1293,ท้องถิ่นเทศบาลตำบลบางม่วง,3031,3168,6199,3048,3174,6222,2851
2564,12,นนทบุรี,1294,ท้องถิ่นเทศบาลเมืองปลายบาง,21508,25264,46772,21583,25318,46901,23656
2564,12,นนทบุรี,1295,ท้องถิ่นเทศบาลเมืองบางศรีเมือง,15301,17817,33118,15333,17840,33173,13421
2564,12,นนทบุรี,1296,ท้องถิ่นเทศบาลเมืองบางกรวย,20238,23971,44209,20436,24163,44599,22210
2564,12,นนทบุรี,1297,ท้องถิ่นเทศบาลนครปากเกร็ด,86929,101551,188480,87992,102353,190345,134053
2564,12,นนทบุรี,1298,ท้องถิ่นเทศบาลนครบางบัวทอง,23449,27780,51229,23765,28034,51799,25948
2564,12,นนทบุรี,1299,ท้องถิ่นเทศบาลนครนนทบุรี,114167,130498,244665,116462,132326,248788,156312
2564,13,ปทุมธานี,1301,อำเภอเมืองปทุมธานี,61525,68178,129703,61698,68295,129993,69029
2564,13,ปทุมธานี,1302,อำเภอคลองหลวง,70619,78161,148780,70855,78323,149178,71013
2564,13,ปทุมธานี,1303,อำเภอธัญบุรี,0,0,0,0,0,0,0
2564,13,ปทุมธานี,1304,อำเภอหนองเสือ,25683,26120,51803,25759,26187,51946,16849
2564,13,ปทุมธานี,1305,อำเภอลาดหลุมแก้ว,29285,30721,60006,29321,30752,60073,30194
2564,13,ปทุมธานี,1306,อำเภอลำลูกกา,41847,44766,86613,41994,44886,86880,43663
2564,13,ปทุมธานี,1307,อำเภอสามโคก,21648,23240,44888,21708,23276,44984,20052
2564,13,ปทุมธานี,1379,ท้องถิ่นเทศบาลเมืองลาดสวาย,32073,36659,68732,32202,36742,68944,40175
2564,13,ปทุมธานี,1380,ท้องถิ่นเทศบาลตำบลบางพูน,12248,13786,26034,12274,13802,26076,20334
2564,13,ปทุมธานี,1381,ท้องถิ่นเทศบาลตำบลบ้านกลาง,5953,6672,12625,5988,6693,12681,6840
2564,13,ปทุมธานี,1382,ท้องถิ่นเทศบาลเมืองลำสามแก้ว,30495,35433,65928,30580,35492,66072,33596
2564,13,ปทุมธานี,1384,ท้องถิ่นเทศบาลเมืองบึงยี่โถ,15263,18094,33357,15331,18126,33457,15749
2564,13,ปทุมธานี,1386,ท้องถิ่นเทศบาลเมืองบางกะดี,7033,7911,14944,7070,7928,14998,7555
2564,13,ปทุมธานี,1387,ท้องถิ่นเทศบาลตำบลบางเตย,5357,5652,11009,5374,5662,11036,4644
2564,13,ปทุมธานี,1388,ท้องถิ่นเทศบาลตำบลลำลูกกา,9265,10310,19575,9286,10328,19614,10407
2564,13,ปทุมธานี,1389,ท้องถิ่นเทศบาลตำบลลำไทร,1227,1273,2500,1276,1322,2598,1054
2564,13,ปทุมธานี,1390,ท้องถิ่นเทศบาลตำบลระแหง,4945,5389,10334,4967,5414,10381,5409
2564,13,ปทุมธานี,1391,ท้องถิ่นเทศบาลตำบลหนองเสือ,1642,1745,3387,1648,1759,3407,1896
2564,13,ปทุมธานี,1392,ท้องถิ่นเทศบาลเมืองสนั่นรักษ์,15234,17078,32312,15289,17124,32413,17691
2564,13,ปทุมธานี,1393,ท้องถิ่นเทศบาลตำบลธัญบุรี,29544,33006,62550,30327,33510,63837,34123
2564,13,ปทุมธานี,1394,ท้องถิ่นเทศบาลเมืองคลองหลวง,31483,35529,67012,31645,35646,67291,55813
2564,13,ปทุมธานี,1395,ท้องถิ่นเทศบาลตำบลบางหลวง,3510,3863,7373,3518,3874,7392,4497
2564,13,ปทุมธานี,1396,ท้องถิ่นเทศบาลเมืองท่าโขลง,33346,39543,72889,34746,40889,75635,56782
2564,13,ปทุมธานี,1397,ท้องถิ่นเทศบาลเมืองคูคต,20604,22394,42998,20763,22528,43291,26428
2564,13,ปทุมธานี,1398,ท้องถิ่นเทศบาลนครรังสิต,38893,45050,83943,39132,45252,84384,56705
2564,13,ปทุมธานี,1399,ท้องถิ่นเทศบาลเมืองปทุมธานี,9825,11127,20952,11100,12399,23499,9522
2564,14,พระนครศรีอยุธยา,1401,อำเภอพระนครศรีอยุธยา,33836,37089,70925,33882,37117,70999,25524
2564,14,พระนครศรีอยุธยา,1402,อำเภอท่าเรือ,14758,16262,31020,14776,16275,31051,11511
2564,14,พระนครศรีอยุธยา,1403,อำเภอนครหลวง,10469,11431,21900,10491,11449,21940,11490
2564,14,พระนครศรีอยุธยา,1404,อำเภอบางไทร,15490,16296,31786,15512,16308,31820,10725
2564,14,พระนครศรีอยุธยา,1405,อำเภอบางบาล,6924,7478,14402,6926,7481,14407,5490
2564,14,พระนครศรีอยุธยา,1406,อำเภอบางปะอิน,24811,27300,52111,24855,27333,52188,27283
2564,14,พระนครศรีอยุธยา,1407,อำเภอบางปะหัน,17440,18646,36086,17546,18748,36294,12672
2564,14,พระนครศรีอยุธยา,1408,อำเภอผักไห่,10769,11516,22285,10775,11523,22298,7353
2564,14,พระนครศรีอยุธยา,1409,อำเภอภาชี,12492,13277,25769,12500,13286,25786,8348
2564,14,พระนครศรีอยุธยา,1410,อำเภอลาดบัวหลวง,14712,15054,29766,14738,15075,29813,9732
2564,14,พระนครศรีอยุธยา,1411,อำเภอวังน้อย,27036,28581,55617,27109,28653,55762,26599
2564,14,พระนครศรีอยุธยา,1412,อำเภอเสนา,15119,15921,31040,15132,15932,31064,9936
2564,14,พระนครศรีอยุธยา,1413,อำเภอบางซ้าย,6854,7026,13880,6876,7039,13915,4486
2564,14,พระนครศรีอยุธยา,1414,อำเภออุทัย,22316,24201,46517,22345,24232,46577,21869
2564,14,พระนครศรีอยุธยา,1415,อำเภอมหาราช,6420,7053,13473,6422,7055,13477,5107
2564,14,พระนครศรีอยุธยา,1416,อำเภอบ้านแพรก,3163,3656,6819,3169,3657,6826,2685
2564,14,พระนครศรีอยุธยา,1466,ท้องถิ่นเทศบาลตำบลสามเมือง,3616,3711,7327,3642,3746,7388,2869
2564,14,พระนครศรีอยุธยา,1467,ท้องถิ่นเทศบาลตำบลสามกอ,3283,3623,6906,3313,3652,6965,2924
2564,14,พระนครศรีอยุธยา,1468,ท้องถิ่นเทศบาลตำบลบางนมโค,3588,4025,7613,3593,4038,7631,4162
2564,14,พระนครศรีอยุธยา,1469,ท้องถิ่นเทศบาลตำบลบางกระสั้น,6213,7085,13298,6221,7092,13313,5779
2564,14,พระนครศรีอยุธยา,1470,ท้องถิ่นเทศบาลตำบลเชียงรากน้อย,4896,5236,10132,4938,5261,10199,4451
2564,14,พระนครศรีอยุธยา,1471,ท้องถิ่นเทศบาลตำบลคลองจิก,4431,4973,9404,4439,4977,9416,5508
2564,14,พระนครศรีอยุธยา,1472,ท้องถิ่นเทศบาลตำบลปราสาททอง,2299,2556,4855,2327,2572,4899,3038
2564,14,พระนครศรีอยุธยา,1473,ท้องถิ่นเทศบาลตำบลบ้านแพรก,952,1014,1966,953,1017,1970,877
2564,14,พระนครศรีอยุธยา,1474,ท้องถิ่นเทศบาลตำบลโรงช้าง,2983,3286,6269,2988,3289,6277,2488
2564,14,พระนครศรีอยุธยา,1475,ท้องถิ่นเทศบาลตำบลมหาราช,1560,1648,3208,1562,1649,3211,1447
2564,14,พระนครศรีอยุธยา,1476,ท้องถิ่นเทศบาลตำบลอุทัย,3187,3638,6825,3189,3642,6831,4323
2564,14,พระนครศรีอยุธยา,1477,ท้องถิ่นเทศบาลตำบลบางซ้าย,2548,2660,5208,2549,2661,5210,1869
2564,14,พระนครศรีอยุธยา,1478,ท้องถิ่นเทศบาลตำบลหัวเวียง,2829,3032,5861,2829,3032,5861,1815
2564,14,พระนครศรีอยุธยา,1479,ท้องถิ่นเทศบาลเมืองลำตาเสา,10498,11064,21562,10515,11083,21598,9870
2564,14,พระนครศรีอยุธยา,1480,ท้องถิ่นเทศบาลตำบลลาดบัวหลวง,1304,1346,2650,1306,1352,2658,1426
2564,14,พระนครศรีอยุธยา,1481,ท้องถิ่นเทศบาลตำบลภาชี,2480,2780,5260,2500,2802,5302,2567
2564,14,พระนครศรีอยุธยา,1482,ท้องถิ่นเทศบาลตำบลลาดชะโด,3658,3893,7551,3664,3893,7557,2777
2564,14,พระนครศรีอยุธยา,1483,ท้องถิ่นเทศบาลเมืองผักไห่,4550,4874,9424,4557,4884,9441,4389
2564,14,พระนครศรีอยุธยา,1484,ท้องถิ่นเทศบาลตำบลพระอินทราชา,4442,4962,9404,4457,4977,9434,6504
2564,14,พระนครศรีอยุธยา,1485,ท้องถิ่นเทศบาลเมืองบ้านสร้าง,5076,5868,10944,5084,5879,10963,7104
2564,14,พระนครศรีอยุธยา,1486,ท้องถิ่นเทศบาลตำบลบางปะอิน,3281,3373,6654,3291,3377,6668,2194
2564,14,พระนครศรีอยุธยา,1487,ท้องถิ่นเทศบาลตำบลบางปะหัน,2468,2787,5255,2470,2789,5259,2232
2564,14,พระนครศรีอยุธยา,1488,ท้องถิ่นเทศบาลตำบลมหาพราหมณ์,4064,4384,8448,4067,4387,8454,3295
2564,14,พระนครศรีอยุธยา,1489,ท้องถิ่นเทศบาลตำบลบางบาล,5156,5730,10886,5157,5734,10891,3733
2564,14,พระนครศรีอยุธยา,1490,ท้องถิ่นเทศบาลตำบลราชคราม,3024,3021,6045,3037,3032,6069,1829
2564,14,พระนครศรีอยุธยา,1491,ท้องถิ่นเทศบาลเมืองบางไทร,4996,5231,10227,5005,5240,10245,3842
2564,14,พระนครศรีอยุธยา,1492,ท้องถิ่นเทศบาลตำบลอรัญญิก,3742,4019,7761,3745,4020,7765,2821
2564,14,พระนครศรีอยุธยา,1493,ท้องถิ่นเทศบาลตำบลนครหลวง,3285,3623,6908,3288,3623,6911,3045
2564,14,พระนครศรีอยุธยา,1494,ท้องถิ่นเทศบาลตำบลท่าหลวง,3926,4408,8334,3934,4412,8346,4141
2564,14,พระนครศรีอยุธยา,1495,ท้องถิ่นเทศบาลเมืองอโยธยา,9217,10750,19967,9240,10770,20010,10337
2564,14,พระนครศรีอยุธยา,1496,ท้องถิ่นเทศบาลเมืองเจ้าเจ็ด,5120,5504,10624,5187,5562,10749,3213
2564,14,พระนครศรีอยุธยา,1497,ท้องถิ่นเทศบาลตำบลท่าเรือ,3002,3426,6428,3016,3444,6460,3193
2564,14,พระนครศรีอยุธยา,1498,ท้องถิ่นเทศบาลเมืองเสนา,1713,1930,3643,1729,1936,3665,1460
2564,14,พระนครศรีอยุธยา,1499,ท้องถิ่นเทศบาลนครพระนครศรีอยุธยา,22902,25250,48152,23178,25501,48679,20421
2564,15,อ่างทอง,1501,อำเภอเมืองอ่างทอง,20631,22928,43559,20653,22959,43612,17022
2564,15,อ่างทอง,1502,อำเภอไชโย,3399,3683,7082,3401,3685,7086,2420
2564,15,อ่างทอง,1503,อำเภอป่าโมก,8909,9833,18742,8919,9848,18767,6758
2564,15,อ่างทอง,1504,อำเภอโพธิ์ทอง,20766,22786,43552,20785,22804,43589,15604
2564,15,อ่างทอง,1505,อำเภอแสวงหา,15012,15742,30754,15022,15748,30770,10154
2564,15,อ่างทอง,1506,อำเภอวิเศษชัยชาญ,24321,26296,50617,24352,26320,50672,18332
2564,15,อ่างทอง,1507,อำเภอสามโก้,4062,4337,8399,4063,4341,8404,2868
2564,15,อ่างทอง,1590,ท้องถิ่นเทศบาลตำบลสามโก้,5021,5585,10606,5024,5588,10612,3569
2564,15,อ่างทอง,1591,ท้องถิ่นเทศบาลตำบลวิเศษไชยชาญ,2703,3182,5885,2720,3191,5911,3013
2564,15,อ่างทอง,1592,ท้องถิ่นเทศบาลตำบลบางจัก,3618,3974,7592,3620,3976,7596,2802
2564,15,อ่างทอง,1593,ท้องถิ่นเทศบาลตำบลแสวงหา,1560,1652,3212,1564,1656,3220,1272
2564,15,อ่างทอง,1594,ท้องถิ่นเทศบาลตำบลรำมะสัก,1998,2185,4183,1999,2188,4187,1579
2564,15,อ่างทอง,1595,ท้องถิ่นเทศบาลตำบลโพธิ์ทอง,1983,2240,4223,1985,2241,4226,1841
2564,15,อ่างทอง,1596,ท้องถิ่นเทศบาลตำบลไชโย,6056,6498,12554,6063,6505,12568,4201
2564,15,อ่างทอง,1597,ท้องถิ่นเทศบาลตำบลเกษไชโย,1359,1401,2760,1362,1403,2765,977
2564,15,อ่างทอง,1598,ท้องถิ่นเทศบาลตำบลป่าโมก,4174,4536,8710,4200,4558,8758,3647
2564,15,อ่างทอง,1599,ท้องถิ่นเทศบาลเมืองอ่างทอง,5621,6300,11921,5667,6353,12020,6625
2564,16,ลพบุรี,1601,อำเภอเมืองลพบุรี,51730,51103,102833,51772,51130,102902,41642
2564,16,ลพบุรี,1602,อำเภอพัฒนานิคม,26737,27621,54358,26766,27644,54410,23684
2564,16,ลพบุรี,1603,อำเภอโคกสำโรง,37601,38490,76091,37632,38512,76144,29077
2564,16,ลพบุรี,1604,อำเภอชัยบาดาล,36250,37163,73413,36284,37179,73463,28369
2564,16,ลพบุรี,1605,อำเภอท่าวุ้ง,21064,22751,43815,21077,22770,43847,15450
2564,16,ลพบุรี,1606,อำเภอบ้านหมี่,33130,35845,68975,33150,35865,69015,25240
2564,16,ลพบุรี,1607,อำเภอท่าหลวง,12688,13051,25739,12702,13061,25763,9503
2564,16,ลพบุรี,1608,อำเภอสระโบสถ์,7100,6938,14038,7104,6944,14048,5293
2564,16,ลพบุรี,1609,อำเภอโคกเจริญ,12165,12181,24346,12169,12189,24358,8601
2564,16,ลพบุรี,1610,อำเภอลำสนธิ,13528,13728,27256,13541,13729,27270,10482
2564,16,ลพบุรี,1611,อำเภอหนองม่วง,13606,14199,27805,13637,14236,27873,11570
2564,16,ลพบุรี,1681,ท้องถิ่นเทศบาลตำบลกกโก,4750,5617,10367,4756,5618,10374,5351
2564,16,ลพบุรี,1682,ท้องถิ่นเทศบาลตำบลถนนใหญ่,6174,5027,11201,6181,5032,11213,4778
2564,16,ลพบุรี,1683,ท้องถิ่นเทศบาลเมืองเขาสามยอด,15542,13111,28653,15738,13252,28990,12576
2564,16,ลพบุรี,1684,ท้องถิ่นเทศบาลตำบลท่าศาลา,6820,7736,14556,6835,7756,14591,7134
2564,16,ลพบุรี,1685,ท้องถิ่นเทศบาลตำบลดีลัง,3883,4154,8037,3888,4157,8045,3808
2564,16,ลพบุรี,1686,ท้องถิ่นเทศบาลตำบลเขาพระงาม,15971,9110,25081,15976,9116,25092,11902
2564,16,ลพบุรี,1688,ท้องถิ่นเทศบาลตำบลสระโบสถ์,3451,3758,7209,3453,3759,7212,3309
2564,16,ลพบุรี,1689,ท้องถิ่นเทศบาลตำบลบ้านท่าหลวง,1906,1917,3823,1913,1920,3833,2109
2564,16,ลพบุรี,1690,ท้องถิ่นเทศบาลตำบลท่าวุ้ง,1015,1101,2116,1016,1101,2117,923
2564,16,ลพบุรี,1691,ท้องถิ่นเทศบาลตำบลท่าโขลง,1039,1183,2222,1047,1196,2243,1009
2564,16,ลพบุรี,1692,ท้องถิ่นเทศบาลตำบลลำนารายณ์,7437,8085,15522,7555,8165,15720,8651
2564,16,ลพบุรี,1693,ท้องถิ่นเทศบาลตำบลหนองม่วง,2375,2539,4914,2381,2541,4922,2156
2564,16,ลพบุรี,1694,ท้องถิ่นเทศบาลตำบลพัฒนานิคม,1468,1604,3072,1566,1712,3278,1466
2564,16,ลพบุรี,1695,ท้องถิ่นเทศบาลตำบลแก่งเสือเต้น,1308,1363,2671,1309,1364,2673,1080
2564,16,ลพบุรี,1696,ท้องถิ่นเทศบาลตำบลโคกตูม,14751,15192,29943,14765,15199,29964,11840
2564,16,ลพบุรี,1697,ท้องถิ่นเทศบาลตำบลโคกสำโรง,2716,2961,5677,2725,2966,5691,2442
2564,16,ลพบุรี,1698,ท้องถิ่นเทศบาลเมืองบ้านหมี่,1470,1645,3115,1502,1665,3167,1399
2564,16,ลพบุรี,1699,ท้องถิ่นเทศบาลเมืองลพบุรี,10260,10943,21203,10293,10962,21255,12721
2564,17,สิงห์บุรี,1701,อำเภอเมืองสิงห์บุรี,16969,19401,36370,17001,19425,36426,13613
2564,17,สิงห์บุรี,1702,อำเภอบางระจัน,9317,9994,19311,9324,9999,19323,7153
2564,17,สิงห์บุรี,1703,อำเภอค่ายบางระจัน,12410,13309,25719,12421,13324,25745,8949
2564,17,สิงห์บุรี,1704,อำเภอพรหมบุรี,7809,8692,16501,7819,8711,16530,5966
2564,17,สิงห์บุรี,1705,อำเภอท่าช้าง,2525,2880,5405,2530,2882,5412,1860
2564,17,สิงห์บุรี,1706,อำเภออินทร์บุรี,23339,25298,48637,23357,25320,48677,17754
2564,17,สิงห์บุรี,1793,ท้องถิ่นเทศบาลตำบลอินทร์บุรี,2111,2337,4448,2115,2340,4455,2276
2564,17,สิงห์บุรี,1794,ท้องถิ่นเทศบาลตำบลถอนสมอ,4141,4553,8694,4145,4557,8702,3432
2564,17,สิงห์บุรี,1795,ท้องถิ่นเทศบาลตำบลพรหมบุรี,1515,1629,3144,1519,1632,3151,1309
2564,17,สิงห์บุรี,1796,ท้องถิ่นเทศบาลตำบลบางน้ำเชี่ยว,1602,1757,3359,1613,1765,3378,1398
2564,17,สิงห์บุรี,1797,ท้องถิ่นเทศบาลตำบลโพสังโฆ,957,1079,2036,958,1080,2038,845
2564,17,สิงห์บุรี,1798,ท้องถิ่นเทศบาลเมืองบางระจัน,6453,7316,13769,6466,7323,13789,5678
2564,17,สิงห์บุรี,1799,ท้องถิ่นเทศบาลเมืองสิงห์บุรี,7843,8998,16841,7876,9024,16900,9261
2564,18,ชัยนาท,1801,อำเภอเมืองชัยนาท,11018,11758,22776,11032,11764,22796,8727
2564,18,ชัยนาท,1802,อำเภอมโนรมย์,11341,12363,23704,11356,12381,23737,8962
2564,18,ชัยนาท,1803,อำเภอวัดสิงห์,10660,11384,22044,10662,11388,22050,9218
2564,18,ชัยนาท,1804,อำเภอสรรพยา,14815,15832,30647,14817,15836,30653,11765
2564,18,ชัยนาท,1805,อำเภอสรรคบุรี,29128,31644,60772,29154,31664,60818,22304
2564,18,ชัยนาท,1806,อำเภอหันคา,19797,21148,40945,19814,21166,40980,14689
2564,18,ชัยนาท,1807,อำเภอหนองมะโมง,6269,6482,12751,6273,6485,12758,5148
2564,18,ชัยนาท,1808,อำเภอเนินขาม,5290,5500,10790,5291,5500,10791,4000
2564,18,ชัยนาท,1880,ท้องถิ่นเทศบาลตำบลบางหลวง,2502,2805,5307,2502,2807,5309,2624
2564,18,ชัยนาท,1881,ท้องถิ่นเทศบาลตำบลนางลือ,3558,3923,7481,3560,3930,7490,2596
2564,18,ชัยนาท,1882,ท้องถิ่นเทศบาลตำบลเสือโฮก,3643,3875,7518,3646,3875,7521,2456
2564,18,ชัยนาท,1883,ท้องถิ่นเทศบาลตำบลหาดท่าเสา,2441,2577,5018,2442,2578,5020,1811
2564,18,ชัยนาท,1884,ท้องถิ่นเทศบาลตำบลชัยนาท,3603,4356,7959,3604,4357,7961,2707
2564,18,ชัยนาท,1885,ท้องถิ่นเทศบาลตำบลบ้านกล้วย,3288,3660,6948,3298,3663,6961,3561
2564,18,ชัยนาท,1887,ท้องถิ่นเทศบาลตำบลหนองแซง,3780,3943,7723,3783,3947,7730,2765
2564,18,ชัยนาท,1889,ท้องถิ่นเทศบาลตำบลวังตะเคียน,3257,3412,6669,3258,3413,6671,2476
2564,18,ชัยนาท,1890,ท้องถิ่นเทศบาลตำบลเนินขาม,2868,3094,5962,2868,3095,5963,2669
2564,18,ชัยนาท,1891,ท้องถิ่นเทศบาลตำบลหันคา,1941,2146,4087,1945,2149,4094,2433
2564,18,ชัยนาท,1892,ท้องถิ่นเทศบาลตำบลสามง่ามท่าโบสถ์,635,686,1321,636,686,1322,469
2564,18,ชัยนาท,1893,ท้องถิ่นเทศบาลตำบลแพรกศรีราชา,1150,1330,2480,1155,1339,2494,1368
2564,18,ชัยนาท,1894,ท้องถิ่นเทศบาลตำบลสรรพยา,1476,1595,3071,1476,1595,3071,1367
2564,18,ชัยนาท,1895,ท้องถิ่นเทศบาลตำบลโพธิ์พิทักษ์,737,826,1563,738,827,1565,577
2564,18,ชัยนาท,1896,ท้องถิ่นเทศบาลตำบลหางน้ำสาคร,2923,3147,6070,2937,3153,6090,3128
2564,18,ชัยนาท,1897,ท้องถิ่นเทศบาลตำบลคุ้งสำเภา,875,944,1819,881,947,1828,992
2564,18,ชัยนาท,1898,ท้องถิ่นเทศบาลตำบลวัดสิงห์,1492,1673,3165,1495,1676,3171,1965
2564,18,ชัยนาท,1899,ท้องถิ่นเทศบาลเมืองชัยนาท,5293,6199,11492,5339,6249,11588,7507
2564,19,สระบุรี,1901,อำเภอเมืองสระบุรี,25009,22067,47076,25054,22118,47172,20210
2564,19,สระบุรี,1902,อำเภอแก่งคอย,34537,35519,70056,34666,35597,70263,31359
2564,19,สระบุรี,1903,อำเภอหนองแค,32986,35001,67987,33044,35066,68110,34229
2564,19,สระบุรี,1904,อำเภอวิหารแดง,16265,16915,33180,16300,16957,33257,12238
2564,19,สระบุรี,1905,อำเภอหนองแซง,6207,6810,13017,6214,6819,13033,4465
2564,19,สระบุรี,1906,อำเภอบ้านหมอ,15341,16191,31532,15359,16204,31563,12473
2564,19,สระบุรี,1907,อำเภอดอนพุด,957,1022,1979,957,1023,1980,663
2564,19,สระบุรี,1908,อำเภอหนองโดน,5619,5931,11550,5626,5935,11561,4491
2564,19,สระบุรี,1909,อำเภอพระพุทธบาท,11919,12657,24576,11932,12670,24602,9993
2564,19,สระบุรี,1910,อำเภอเสาไห้,10573,11607,22180,10600,11636,22236,8436
2564,19,สระบุรี,1911,อำเภอมวกเหล็ก,24704,24906,49610,24790,24968,49758,22171
2564,19,สระบุรี,1912,อำเภอวังม่วง,5651,5923,11574,5661,5930,11591,4642
2564,19,สระบุรี,1913,อำเภอเฉลิมพระเกียรติ,14534,15313,29847,14557,15343,29900,12813
2564,19,สระบุรี,1974,ท้องถิ่นเทศบาลตำบลพุกร่าง,3312,3455,6767,3312,3459,6771,2450
2564,19,สระบุรี,1975,ท้องถิ่นเทศบาลตำบลคำพราน,2060,2099,4159,2064,2100,4164,2126
2564,19,สระบุรี,1976,ท้องถิ่นเทศบาลตำบลไผ่ต่ำ,1981,2050,4031,1987,2061,4048,2123
2564,19,สระบุรี,1977,ท้องถิ่นเทศบาลตำบลตะกุด,2344,2426,4770,2350,2431,4781,2261
2564,19,สระบุรี,1978,ท้องถิ่นเทศบาลตำบลกุดนกเปล้า,2900,3083,5983,2901,3086,5987,2620
2564,19,สระบุรี,1979,ท้องถิ่นเทศบาลตำบลหน้าพระลาน,3906,3867,7773,3926,3895,7821,3332
2564,19,สระบุรี,1980,ท้องถิ่นเทศบาลตำบลวังม่วง,2066,2195,4261,2080,2205,4285,2570
2564,19,สระบุรี,1981,ท้องถิ่นเทศบาลตำบลมวกเหล็ก,3250,3473,6723,3279,3502,6781,3801
2564,19,สระบุรี,1982,ท้องถิ่นเทศบาลตำบลเสาไห้,1485,1617,3102,1492,1623,3115,1467
2564,19,สระบุรี,1983,ท้องถิ่นเทศบาลตำบลสวนดอกไม้,3665,4091,7756,3667,4092,7759,4053
2564,19,สระบุรี,1984,ท้องถิ่นเทศบาลตำบลบ้านยาง,494,574,1068,496,575,1071,387
2564,19,สระบุรี,1985,ท้องถิ่นเทศบาลตำบลหนองโดน,1138,1261,2399,1139,1261,2400,1036
2564,19,สระบุรี,1986,ท้องถิ่นเทศบาลตำบลดอนพุด,2308,2363,4671,2309,2364,4673,1846
2564,19,สระบุรี,1987,ท้องถิ่นเทศบาลตำบลบ้านหมอ,1256,1353,2609,1259,1359,2618,1344
2564,19,สระบุรี,1988,ท้องถิ่นเทศบาลตำบลท่าลาน,3772,4035,7807,3778,4040,7818,4013
2564,19,สระบุรี,1989,ท้องถิ่นเทศบาลตำบลหนองแซง,1347,1498,2845,1352,1499,2851,1030
2564,19,สระบุรี,1990,ท้องถิ่นเทศบาลตำบลหนองหมู,807,854,1661,809,854,1663,501
2564,19,สระบุรี,1991,ท้องถิ่นเทศบาลตำบลวิหารแดง,1907,2131,4038,1917,2142,4059,1908
2564,19,สระบุรี,1992,ท้องถิ่นเทศบาลตำบลหินกอง,4364,4903,9267,4380,4920,9300,5599
2564,19,สระบุรี,1993,ท้องถิ่นเทศบาลตำบลคชสิทธิ์,631,686,1317,636,691,1327,669
2564,19,สระบุรี,1994,ท้องถิ่นเทศบาลเมืองทับกวาง,9867,9911,19778,9925,9949,19874,9793
2564,19,สระบุรี,1995,ท้องถิ่นเทศบาลตำบลป๊อกแป๊ก,328,394,722,330,395,725,421
2564,19,สระบุรี,1996,ท้องถิ่นเทศบาลเมืองพระพุทธบาท,13134,15257,28391,15587,17502,33089,13349
2564,19,สระบุรี,1997,ท้องถิ่นเทศบาลตำบลหนองแค,5871,6319,12190,5944,6392,12336,6422
2564,19,สระบุรี,1998,ท้องถิ่นเทศบาลเมืองแก่งคอย,5274,5687,10961,5294,5698,10992,6203
2564,19,สระบุรี,1999,ท้องถิ่นเทศบาลเมืองสระบุรี,29045,29264,58309,29228,29401,58629,28768
2564,20,ชลบุรี,2001,อำเภอเมืองชลบุรี,20489,21667,42156,20522,21692,42214,27013
2564,20,ชลบุรี,2002,อำเภอบ้านบึง,40786,42148,82934,41131,42399,83530,46182
2564,20,ชลบุรี,2003,อำเภอหนองใหญ่,7489,7529,15018,7699,7690,15389,6725
2564,20,ชลบุรี,2004,อำเภอบางละมุง,13631,15401,29032,13866,15562,29428,18682
2564,20,ชลบุรี,2005,อำเภอพานทอง,23362,24167,47529,23388,24190,47578,38633
2564,20,ชลบุรี,2006,อำเภอพนัสนิคม,48853,51936,100789,49157,52223,101380,37310
2564,20,ชลบุรี,2007,อำเภอศรีราชา,27996,28260,56256,28135,28346,56481,47964
2564,20,ชลบุรี,2008,อำเภอเกาะสีชัง,0,0,0,0,0,0,0
2564,20,ชลบุรี,2009,อำเภอสัตหีบ,26429,26267,52696,26828,26615,53443,29607
2564,20,ชลบุรี,2010,อำเภอบ่อทอง,18864,18650,37514,18982,18737,37719,13607
2564,20,ชลบุรี,2011,อำเภอเกาะจันทร์,13208,12644,25852,13641,12985,26626,8668
2564,20,ชลบุรี,2060,ท้องถิ่นเทศบาลตำบลเกล็ดแก้ว,7214,5480,12694,7364,5495,12859,6456
2564,20,ชลบุรี,2061,ท้องถิ่นเทศบาลตำบลเขตรอุดมศักดิ์,34526,21905,56431,34624,21944,56568,27109
2564,20,ชลบุรี,2063,ท้องถิ่นเทศบาลตำบลหมอนนาง,6540,6973,13513,6573,6987,13560,4541
2564,20,ชลบุรี,2064,ท้องถิ่นเทศบาลตำบลตะเคียนเตี้ย,11924,12918,24842,11980,12947,24927,13005
2564,20,ชลบุรี,2065,ท้องถิ่นเทศบาลตำบลเสม็ด,10237,12434,22671,10274,12451,22725,17575
2564,20,ชลบุรี,2066,ท้องถิ่นเทศบาลเมืองดอนหัวฬ่อ,6628,6728,13356,6638,6731,13369,15019
2564,20,ชลบุรี,2067,ท้องถิ่นเทศบาลตำบลห้วยกะปิ,7794,8839,16633,7810,8845,16655,10377
2564,20,ชลบุรี,2068,ท้องถิ่นเทศบาลตำบลนาป่า,20286,21329,41615,20312,21347,41659,26194
2564,20,ชลบุรี,2069,ท้องถิ่นเทศบาลตำบลหนองไม้แดง,6714,6353,13067,6724,6356,13080,11224
2564,20,ชลบุรี,2070,ท้องถิ่นเทศบาลตำบลธาตุทอง,3832,3945,7777,3879,3987,7866,2774
2564,20,ชลบุรี,2071,ท้องถิ่นเทศบาลตำบลโป่ง,5034,5644,10678,5157,5661,10818,6552
2564,20,ชลบุรี,2072,ท้องถิ่นเทศบาลเมืองหนองปรือ,38074,48325,86399,39433,48552,87985,51625
2564,20,ชลบุรี,2073,ท้องถิ่นเทศบาลตำบลท่าบุญมี,3264,3460,6724,3278,3475,6753,4183
2564,20,ชลบุรี,2074,ท้องถิ่นเทศบาลตำบลเกาะจันทร์,4178,1835,6013,4184,1838,6022,1825
2564,20,ชลบุรี,2075,ท้องถิ่นเทศบาลตำบลบ่อทอง,1790,1902,3692,2088,2167,4255,2072
2564,20,ชลบุรี,2076,ท้องถิ่นเทศบาลเมืองสัตหีบ,10343,11521,21864,10395,11557,21952,12168
2564,20,ชลบุรี,2077,ท้องถิ่นเทศบาลตำบลบางเสร่,5141,6286,11427,5301,6309,11610,9335
2564,20,ชลบุรี,2078,ท้องถิ่นเทศบาลตำบลนาจอมเทียน,3532,4090,7622,3701,4141,7842,16104
2564,20,ชลบุรี,2079,ท้องถิ่นเทศบาลตำบลเกาะสีชัง,2229,2297,4526,2234,2301,4535,2210
2564,20,ชลบุรี,2080,ท้องถิ่นเทศบาลนครเจ้าพระยาสุรศักดิ์,73025,77386,150411,73320,77547,150867,103988
2564,20,ชลบุรี,2081,ท้องถิ่นเทศบาลตำบลบางพระ,6374,7008,13382,6408,7022,13430,7920
2564,20,ชลบุรี,2082,ท้องถิ่นเทศบาลตำบลหนองตำลึง,10656,10910,21566,10666,10921,21587,16934
2564,20,ชลบุรี,2083,ท้องถิ่นเทศบาลตำบลพานทอง,2903,3099,6002,3077,3268,6345,3773
2564,20,ชลบุรี,2084,ท้องถิ่นเทศบาลตำบลห้วยใหญ่,14383,16357,30740,14600,16415,31015,18120
2564,20,ชลบุรี,2085,ท้องถิ่นเทศบาลตำบลบางละมุง,6012,6593,12605,6075,6676,12751,9040
2564,20,ชลบุรี,2086,ท้องถิ่นเทศบาลตำบลหนองใหญ่,4155,4016,8171,4379,4210,8589,3437
2564,20,ชลบุรี,2087,ท้องถิ่นเทศบาลตำบลหัวกุญแจ,1730,1938,3668,1755,1956,3711,2105
2564,20,ชลบุรี,2088,ท้องถิ่นเทศบาลตำบลหนองไผ่แก้ว,1107,1186,2293,1108,1190,2298,1588
2564,20,ชลบุรี,2089,ท้องถิ่นเทศบาลเมืองอ่างศิลา,16972,19649,36621,17008,19674,36682,22139
2564,20,ชลบุรี,2090,ท้องถิ่นเทศบาลนครบ้านสวน,33261,34073,67334,34380,35035,69415,45906
2564,20,ชลบุรี,2091,ท้องถิ่นเทศบาลตำบลบางทราย,6532,5133,11665,6559,5144,11703,7468
2564,20,ชลบุรี,2092,ท้องถิ่นเทศบาลตำบลคลองตำหรุ,2208,2501,4709,2220,2509,4729,6618
2564,20,ชลบุรี,2093,ท้องถิ่นเทศบาลนครแหลมฉบัง,44009,45572,89581,44524,46000,90524,81437
2564,20,ชลบุรี,2094,ท้องถิ่นเทศบาลเมืองแสนสุข,21261,24388,45649,21561,24604,46165,37949
2564,20,ชลบุรี,2095,ท้องถิ่นเทศบาลเมืองบ้านบึง,8883,10214,19097,9696,10961,20657,10505
2564,20,ชลบุรี,2096,ท้องถิ่นเมืองพัทยา,49651,60855,110506,53127,63324,116451,172313
2564,20,ชลบุรี,2097,ท้องถิ่นเทศบาลเมืองศรีราชา,9725,12184,21909,10507,12887,23394,8494
2564,20,ชลบุรี,2098,ท้องถิ่นเทศบาลเมืองพนัสนิคม,4560,5385,9945,4578,5390,9968,5015
2564,20,ชลบุรี,2099,ท้องถิ่นเทศบาลเมืองชลบุรี,11554,12906,24460,11617,12946,24563,12512
2564,21,ระยอง,2101,อำเภอเมืองระยอง,50150,51574,101724,50474,51708,102182,65818
2564,21,ระยอง,2102,อำเภอบ้านฉาง,5525,5068,10593,5546,5082,10628,4828
2564,21,ระยอง,2103,อำเภอแกลง,32514,34968,67482,32595,35025,67620,31513
2564,21,ระยอง,2104,อำเภอวังจันทร์,11068,11223,22291,11117,11256,22373,11221
2564,21,ระยอง,2105,อำเภอบ้านค่าย,32650,34416,67066,32742,34472,67214,35377
2564,21,ระยอง,2106,อำเภอปลวกแดง,36693,35425,72118,36765,35496,72261,99883
2564,21,ระยอง,2107,อำเภอเขาชะเมา,11727,11857,23584,11760,11889,23649,11135
2564,21,ระยอง,2108,อำเภอนิคมพัฒนา,10599,10755,21354,10630,10788,21418,17412
2564,21,ระยอง,2177,ท้องถิ่นเทศบาลตำบลพลา,4057,4165,8222,4203,4204,8407,5471
2564,21,ระยอง,2178,ท้องถิ่นเทศบาลตำบลเนินฆ้อ,2199,2356,4555,2209,2363,4572,1979
2564,21,ระยอง,2179,ท้องถิ่นเทศบาลตำบลทับมา,12482,12631,25113,12521,12651,25172,17254
2564,21,ระยอง,2180,ท้องถิ่นเทศบาลตำบลบ้านนา,4147,4317,8464,4155,4333,8488,3410
2564,21,ระยอง,2181,ท้องถิ่นเทศบาลตำบลมาบข่าพัฒนา,4971,5084,10055,4978,5095,10073,7414
2564,21,ระยอง,2182,ท้องถิ่นเทศบาลตำบลบ้านฉาง,7658,7984,15642,7770,8017,15787,9309
2564,21,ระยอง,2183,ท้องถิ่นเทศบาลเมืองมะขามคู่,6951,7062,14013,6958,7069,14027,12353
2564,21,ระยอง,2184,ท้องถิ่นเทศบาลเมืองนิคมพัฒนา,5480,5384,10864,5483,5391,10874,8450
2564,21,ระยอง,2185,ท้องถิ่นเทศบาลตำบลบ้านปลวกแดง,2415,2764,5179,2643,2958,5601,4546
2564,21,ระยอง,2186,ท้องถิ่นเทศบาลตำบลจอมพลเจ้าพระยา,335,334,669,335,334,669,503
2564,21,ระยอง,2187,ท้องถิ่นเทศบาลตำบลบ้านค่าย,1494,1669,3163,1576,1747,3323,2074
2564,21,ระยอง,2188,ท้องถิ่นเทศบาลตำบลชุมแสง,1764,1829,3593,1818,1878,3696,2297
2564,21,ระยอง,2189,ท้องถิ่นเทศบาลตำบลสุนทรภู่,6963,7812,14775,7176,7869,15045,10133
2564,21,ระยอง,2190,ท้องถิ่นเทศบาลตำบลปากน้ำประแส,2281,2456,4737,2299,2475,4774,2053
2564,21,ระยอง,2191,ท้องถิ่นเทศบาลตำบลทุ่งควายกิน,3138,3439,6577,3160,3452,6612,4025
2564,21,ระยอง,2192,ท้องถิ่นเทศบาลตำบลกองดิน,2386,2416,4802,2391,2426,4817,1851
2564,21,ระยอง,2193,ท้องถิ่นเทศบาลตำบลสำนักท้อน,5456,5658,11114,5485,5676,11161,6057
2564,21,ระยอง,2194,ท้องถิ่นเทศบาลเมืองบ้านฉาง,15064,15981,31045,15316,16094,31410,20964
2564,21,ระยอง,2195,ท้องถิ่นเทศบาลตำบลบ้านเพ,8367,9310,17677,8518,9338,17856,12115
2564,21,ระยอง,2196,ท้องถิ่นเทศบาลตำบลแกลงกะเฉด,3410,3694,7104,3438,3705,7143,3379
2564,21,ระยอง,2197,ท้องถิ่นเทศบาลนครมาบตาพุด,36989,36862,73851,37202,37065,74267,62004
2564,21,ระยอง,2198,ท้องถิ่นเทศบาลตำบลเมืองแกลง,8203,9247,17450,8828,9783,18611,11702
2564,21,ระยอง,2199,ท้องถิ่นเทศบาลนครระยอง,27494,31417,58911,28901,32712,61613,37949
2564,22,จันทบุรี,2201,อำเภอเมืองจันทบุรี,22196,24539,46735,22262,24586,46848,22385
2564,22,จันทบุรี,2202,อำเภอขลุง,12471,12914,25385,12492,12930,25422,10241
2564,22,จันทบุรี,2203,อำเภอท่าใหม่,23263,24332,47595,23334,24383,47717,18169
2564,22,จันทบุรี,2204,อำเภอโป่งน้ำร้อน,10866,10268,21134,10944,10388,21332,8633
2564,22,จันทบุรี,2205,อำเภอมะขาม,15076,15495,30571,15167,15601,30768,13576
2564,22,จันทบุรี,2206,อำเภอแหลมสิงห์,6840,7208,14048,6887,7259,14146,5352
2564,22,จันทบุรี,2207,อำเภอสอยดาว,18824,18569,37393,18910,18636,37546,15141
2564,22,จันทบุรี,2208,อำเภอแก่งหางแมว,21202,21007,42209,21306,21123,42429,21194
2564,22,จันทบุรี,2209,อำเภอนายายอาม,14739,15792,30531,14882,15942,30824,12103
2564,22,จันทบุรี,2210,อำเภอเขาคิชฌกูฏ,6280,6475,12755,6297,6494,12791,5570
2564,22,จันทบุรี,2272,ท้องถิ่นเทศบาลตำบลเขาบายศรี,3089,3211,6300,3115,3225,6340,2559
2564,22,จันทบุรี,2273,ท้องถิ่นเทศบาลตำบลคลองใหญ่,2619,2630,5249,2652,2668,5320,2102
2564,22,จันทบุรี,2274,ท้องถิ่นเทศบาลตำบลหนองตาคง,5092,4862,9954,5125,4904,10029,4034
2564,22,จันทบุรี,2275,ท้องถิ่นเทศบาลตำบลตกพรม,1981,2128,4109,2016,2147,4163,1627
2564,22,จันทบุรี,2276,ท้องถิ่นเทศบาลตำบลเกวียนหัก,2103,2449,4552,2104,2451,4555,2179
2564,22,จันทบุรี,2277,ท้องถิ่นเทศบาลตำบลบ่อ,3492,3639,7131,3496,3646,7142,2678
2564,22,จันทบุรี,2278,ท้องถิ่นเทศบาลตำบลชากไทย,2121,2236,4357,2140,2255,4395,1896
2564,22,จันทบุรี,2279,ท้องถิ่นเทศบาลตำบลตะเคียนทอง,2329,2269,4598,2334,2273,4607,1836
2564,22,จันทบุรี,2280,ท้องถิ่นเทศบาลเมืองเกาะขวาง,8000,8799,16799,8058,8832,16890,8170
2564,22,จันทบุรี,2281,ท้องถิ่นเทศบาลตำบลบ่อเวฬุ,2270,2070,4340,2290,2089,4379,2552
2564,22,จันทบุรี,2282,ท้องถิ่นเทศบาลตำบลพลวง,3510,3739,7249,3605,3830,7435,4192
2564,22,จันทบุรี,2283,ท้องถิ่นเทศบาลตำบลทับช้าง,8210,8104,16314,8226,8110,16336,6138
2564,22,จันทบุรี,2284,ท้องถิ่นเทศบาลตำบลนายายอาม,1682,1850,3532,1685,1860,3545,1979
2564,22,จันทบุรี,2285,ท้องถิ่นเทศบาลตำบลสอยดาว,5526,5677,11203,5575,5722,11297,6379
2564,22,จันทบุรี,2286,ท้องถิ่นเทศบาลตำบลพลิ้ว,3305,3761,7066,3312,3763,7075,3118
2564,22,จันทบุรี,2287,ท้องถิ่นเทศบาลตำบลปากน้ำแหลมสิงห์,4243,4478,8721,4253,4489,8742,3425
2564,22,จันทบุรี,2288,ท้องถิ่นเทศบาลตำบลมะขาม,795,899,1694,800,903,1703,1031
2564,22,จันทบุรี,2289,ท้องถิ่นเทศบาลตำบลโป่งน้ำร้อน,4760,4117,8877,4886,4225,9111,4267
2564,22,จันทบุรี,2290,ท้องถิ่นเทศบาลตำบลหนองคล้า,1763,1957,3720,1773,1972,3745,2167
2564,22,จันทบุรี,2291,ท้องถิ่นเทศบาลตำบลเนินสูง,1450,1570,3020,1455,1575,3030,1683
2564,22,จันทบุรี,2292,ท้องถิ่นเทศบาลตำบลหนองบัว,1047,1193,2240,1048,1193,2241,977
2564,22,จันทบุรี,2293,ท้องถิ่นเทศบาลตำบลพลับพลานารายณ์,4892,5413,10305,4900,5431,10331,6331
2564,22,จันทบุรี,2294,ท้องถิ่นเทศบาลตำบลบางกะจะ,2462,2623,5085,2469,2625,5094,2188
2564,22,จันทบุรี,2295,ท้องถิ่นเทศบาลเมืองท่าช้าง,6407,7695,14102,6439,7709,14148,10755
2564,22,จันทบุรี,2296,ท้องถิ่นเทศบาลเมืองจันทนิมิต,5570,6295,11865,5669,6404,12073,7893
2564,22,จันทบุรี,2297,ท้องถิ่นเทศบาลเมืองขลุง,4946,5614,10560,4967,5635,10602,4287
2564,22,จันทบุรี,2298,ท้องถิ่นเทศบาลเมืองท่าใหม่,4686,5380,10066,4715,5402,10117,4625
2564,22,จันทบุรี,2299,ท้องถิ่นเทศบาลเมืองจันทบุรี,10166,11196,21362,10669,11620,22289,14642
2564,23,ตราด,2301,อำเภอเมืองตราด,34933,37190,72123,36216,38410,74626,35718
2564,23,ตราด,2302,อำเภอคลองใหญ่,5940,5731,11671,7416,7308,14724,5476
2564,23,ตราด,2303,อำเภอเขาสมิง,19761,19969,39730,19898,20078,39976,17947
2564,23,ตราด,2304,อำเภอบ่อไร่,9484,8842,18326,9599,8961,18560,7665
2564,23,ตราด,2305,อำเภอแหลมงอบ,6923,6980,13903,6994,7052,14046,5857
2564,23,ตราด,2306,อำเภอเกาะกูด,1363,1252,2615,1398,1281,2679,2080
2564,23,ตราด,2307,อำเภอเกาะช้าง,4063,4120,8183,4261,4303,8564,6081
2564,23,ตราด,2389,ท้องถิ่นเทศบาลตำบลตะกาง,1254,1322,2576,1277,1345,2622,1362
2564,23,ตราด,2390,ท้องถิ่นเทศบาลตำบลหนองบอน,3772,3673,7445,3788,3703,7491,3941
2564,23,ตราด,2391,ท้องถิ่นเทศบาลตำบลแหลมงอบ,868,883,1751,876,895,1771,727
2564,23,ตราด,2392,ท้องถิ่นเทศบาลตำบลน้ำเชี่ยว,1552,1676,3228,1559,1684,3243,1331
2564,23,ตราด,2393,ท้องถิ่นเทศบาลตำบลบ่อพลอย,4211,4259,8470,4336,4388,8724,5693
2564,23,ตราด,2394,ท้องถิ่นเทศบาลตำบลแสนตุ้ง,1560,1613,3173,1593,1645,3238,2381
2564,23,ตราด,2395,ท้องถิ่นเทศบาลตำบลเขาสมิง,702,682,1384,704,684,1388,614
2564,23,ตราด,2396,ท้องถิ่นเทศบาลตำบลหาดเล็ก,2546,2409,4955,2747,2604,5351,1987
2564,23,ตราด,2397,ท้องถิ่นเทศบาลตำบลคลองใหญ่,2363,2406,4769,2588,2670,5258,2441
2564,23,ตราด,2398,ท้องถิ่นเทศบาลตำบลท่าพริกเนินทราย,3069,3367,6436,3146,3454,6600,3074
2564,23,ตราด,2399,ท้องถิ่นเทศบาลเมืองตราด,3765,4277,8042,4545,4970,9515,5515
2564,24,ฉะเชิงเทรา,2401,อำเภอเมืองฉะเชิงเทรา,59863,63179,123042,60057,63353,123410,52217
2564,24,ฉะเชิงเทรา,2402,อำเภอบางคล้า,14774,15780,30554,14812,15818,30630,12771
2564,24,ฉะเชิงเทรา,2403,อำเภอบางน้ำเปรี้ยว,36205,36703,72908,36331,36801,73132,22458
2564,24,ฉะเชิงเทรา,2404,อำเภอบางปะกง,27634,28819,56453,28037,29146,57183,27586
2564,24,ฉะเชิงเทรา,2405,อำเภอบ้านโพธิ์,22242,23903,46145,22280,23937,46217,21160
2564,24,ฉะเชิงเทรา,2406,อำเภอพนมสารคาม,34494,36424,70918,34622,36553,71175,30739
2564,24,ฉะเชิงเทรา,2407,อำเภอราชสาส์น,6205,6472,12677,6211,6485,12696,4806
2564,24,ฉะเชิงเทรา,2408,อำเภอสนามชัยเขต,35370,35244,70614,35446,35317,70763,23119
2564,24,ฉะเชิงเทรา,2409,อำเภอแปลงยาว,10970,10662,21632,11010,10706,21716,11475
2564,24,ฉะเชิงเทรา,2410,อำเภอท่าตะเกียบ,23708,23301,47009,23744,23333,47077,17363
2564,24,ฉะเชิงเทรา,2411,อำเภอคลองเขื่อน,6188,6482,12670,6195,6493,12688,4484
2564,24,ฉะเชิงเทรา,2474,ท้องถิ่นเทศบาลตำบลบางวัวคณารักษ์,5336,5795,11131,5349,5808,11157,8609
2564,24,ฉะเชิงเทรา,2475,ท้องถิ่นเทศบาลตำบลพิมพา,1637,1760,3397,1642,1762,3404,3500
2564,24,ฉะเชิงเทรา,2476,ท้องถิ่นเทศบาลตำบลวังเย็น,4637,4725,9362,4644,4735,9379,3519
2564,24,ฉะเชิงเทรา,2477,ท้องถิ่นเทศบาลตำบลดอนเกาะกา,4382,4293,8675,4401,4307,8708,2399
2564,24,ฉะเชิงเทรา,2478,ท้องถิ่นเทศบาลตำบลหัวสำโรง,3312,3467,6779,3315,3479,6794,3987
2564,24,ฉะเชิงเทรา,2479,ท้องถิ่นเทศบาลตำบลแปลงยาว,3007,3141,6148,3012,3144,6156,3519
2564,24,ฉะเชิงเทรา,2480,ท้องถิ่นเทศบาลตำบลทุ่งสะเดา,2901,2324,5225,3006,2428,5434,4511
2564,24,ฉะเชิงเทรา,2481,ท้องถิ่นเทศบาลตำบลสนามชัยเขต,1984,2212,4196,2029,2266,4295,2948
2564,24,ฉะเชิงเทรา,2482,ท้องถิ่นเทศบาลตำบลพนมสารคาม,2951,3431,6382,2961,3441,6402,4243
2564,24,ฉะเชิงเทรา,2483,ท้องถิ่นเทศบาลตำบลเขาหินซ้อน,1715,1798,3513,1717,1800,3517,2627
2564,24,ฉะเชิงเทรา,2484,ท้องถิ่นเทศบาลตำบลเกาะขนุน,1030,1105,2135,1034,1110,2144,1095
2564,24,ฉะเชิงเทรา,2485,ท้องถิ่นเทศบาลตำบลบ้านโพธิ์,1330,1379,2709,1391,1429,2820,1422
2564,24,ฉะเชิงเทรา,2486,ท้องถิ่นเทศบาลตำบลเทพราช,2085,2153,4238,2087,2157,4244,1267
2564,24,ฉะเชิงเทรา,2487,ท้องถิ่นเทศบาลตำบลบางวัว,1350,1473,2823,1355,1478,2833,1970
2564,24,ฉะเชิงเทรา,2488,ท้องถิ่นเทศบาลตำบลบางปะกง,2851,3172,6023,2862,3190,6052,2923
2564,24,ฉะเชิงเทรา,2489,ท้องถิ่นเทศบาลตำบลหอมศีล,635,630,1265,635,631,1266,328
2564,24,ฉะเชิงเทรา,2490,ท้องถิ่นเทศบาลตำบลท่าสะอ้าน,1598,1728,3326,1603,1728,3331,2457
2564,24,ฉะเชิงเทรา,2491,ท้องถิ่นเทศบาลตำบลท่าข้าม,3628,3890,7518,3635,3902,7537,8927
2564,24,ฉะเชิงเทรา,2492,ท้องถิ่นเทศบาลตำบลศาลาแดง,704,746,1450,706,749,1455,536
2564,24,ฉะเชิงเทรา,2493,ท้องถิ่นเทศบาลตำบลบางน้ำเปรี้ยว,1126,1179,2305,1136,1190,2326,1195
2564,24,ฉะเชิงเทรา,2494,ท้องถิ่นเทศบาลตำบลบางขนาก,1033,1021,2054,1043,1032,2075,789
2564,24,ฉะเชิงเทรา,2495,ท้องถิ่นเทศบาลตำบลดอนฉิมพลี,772,804,1576,785,807,1592,734
2564,24,ฉะเชิงเทรา,2496,ท้องถิ่นเทศบาลตำบลปากน้ำ,2572,2796,5368,2642,2876,5518,2626
2564,24,ฉะเชิงเทรา,2497,ท้องถิ่นเทศบาลตำบลนครเนื่องเขต,683,781,1464,686,785,1471,496
2564,24,ฉะเชิงเทรา,2498,ท้องถิ่นเทศบาลตำบลบางคล้า,4392,5137,9529,4419,5169,9588,4954
2564,24,ฉะเชิงเทรา,2499,ท้องถิ่นเทศบาลเมืองฉะเชิงเทรา,17452,19494,36946,17994,19999,37993,22170
2564,25,ปราจีนบุรี,2501,อำเภอเมืองปราจีนบุรี,45088,42693,87781,45214,42776,87990,35979
2564,25,ปราจีนบุรี,2502,อำเภอกบินทร์บุรี,66816,68961,135777,66915,69030,135945,53427
2564,25,ปราจีนบุรี,2503,อำเภอนาดี,21959,22107,44066,21985,22127,44112,17963
2564,25,ปราจีนบุรี,2506,อำเภอบ้านสร้าง,13533,14054,27587,13551,14080,27631,9746
2564,25,ปราจีนบุรี,2507,อำเภอประจันตคาม,24324,25610,49934,24342,25632,49974,17345
2564,25,ปราจีนบุรี,2508,อำเภอศรีมหาโพธิ,36589,38179,74768,36648,38220,74868,53589
2564,25,ปราจีนบุรี,2509,อำเภอศรีมโหสถ,6536,6740,13276,6543,6746,13289,6554
2564,25,ปราจีนบุรี,2587,ท้องถิ่นเทศบาลตำบลโคกมะกอก,1048,1155,2203,1051,1157,2208,832
2564,25,ปราจีนบุรี,2588,ท้องถิ่นเทศบาลตำบลโคกปีบ,2750,3070,5820,2765,3080,5845,2334
2564,25,ปราจีนบุรี,2589,ท้องถิ่นเทศบาลตำบลศรีมหาโพธิ,1748,1866,3614,1750,1868,3618,2439
2564,25,ปราจีนบุรี,2590,ท้องถิ่นเทศบาลตำบลกรอกสมบูรณ์,1734,1765,3499,1734,1765,3499,1287
2564,25,ปราจีนบุรี,2591,ท้องถิ่นเทศบาลตำบลประจันตคาม,2120,2363,4483,2121,2364,4485,2399
2564,25,ปราจีนบุรี,2592,ท้องถิ่นเทศบาลตำบลบ้านสร้าง,1587,1639,3226,1595,1647,3242,1650
2564,25,ปราจีนบุรี,2593,ท้องถิ่นเทศบาลตำบลนาดี,3869,4016,7885,3878,4033,7911,3342
2564,25,ปราจีนบุรี,2594,ท้องถิ่นเทศบาลตำบลสระบัว,883,921,1804,886,926,1812,641
2564,25,ปราจีนบุรี,2595,ท้องถิ่นเทศบาลตำบลเมืองเก่า,3041,3202,6243,3209,3318,6527,4480
2564,25,ปราจีนบุรี,2596,ท้องถิ่นเทศบาลตำบลบ้านนาปรือ,1118,1113,2231,1120,1113,2233,798
2564,25,ปราจีนบุรี,2598,ท้องถิ่นเทศบาลตำบลกบินทร์,1714,2012,3726,1718,2015,3733,2200
2564,25,ปราจีนบุรี,2599,ท้องถิ่นเทศบาลเมืองปราจีนบุรี,7579,8764,16343,7617,8786,16403,8944
2564,26,นครนายก,2601,อำเภอเมืองนครนายก,42449,42319,84768,42480,42340,84820,35219
2564,26,นครนายก,2602,อำเภอปากพลี,10921,11588,22509,10924,11595,22519,8662
2564,26,นครนายก,2603,อำเภอบ้านนา,32114,32208,64322,32196,32279,64475,24429
2564,26,นครนายก,2604,อำเภอองครักษ์,30471,31409,61880,30798,31704,62502,22400
2564,26,นครนายก,2695,ท้องถิ่นเทศบาลตำบลองครักษ์,1205,1296,2501,1261,1366,2627,1369
2564,26,นครนายก,2696,ท้องถิ่นเทศบาลตำบลบ้านนา,2234,2529,4763,2256,2538,4794,2507
2564,26,นครนายก,2697,ท้องถิ่นเทศบาลตำบลเกาะหวาย,826,943,1769,831,944,1775,754
2564,26,นครนายก,2698,ท้องถิ่นเทศบาลตำบลท่าช้าง,493,497,990,493,497,990,328
2564,26,นครนายก,2699,ท้องถิ่นเทศบาลเมืองนครนายก,7382,8138,15520,7615,8316,15931,8581
2564,27,สระแก้ว,2701,อำเภอเมืองสระแก้ว,43731,42988,86719,43824,43088,86912,29895
2564,27,สระแก้ว,2702,อำเภอคลองหาด,19506,19407,38913,19539,19453,38992,13736
2564,27,สระแก้ว,2703,อำเภอตาพระยา,27301,27043,54344,27452,27307,54759,16435
2564,27,สระแก้ว,2704,อำเภอวังน้ำเย็น,20278,20210,40488,20353,20267,40620,15145
2564,27,สระแก้ว,2705,อำเภอวัฒนานคร,38393,37913,76306,38514,38034,76548,27003
2564,27,สระแก้ว,2706,อำเภออรัญประเทศ,36347,37080,73427,36705,37812,74517,36739
2564,27,สระแก้ว,2707,อำเภอเขาฉกรรจ์,25532,25420,50952,25592,25458,51050,16425
2564,27,สระแก้ว,2708,อำเภอโคกสูง,13443,13602,27045,13536,13768,27304,8465
2564,27,สระแก้ว,2709,อำเภอวังสมบูรณ์,12716,12557,25273,12737,12593,25330,10477
2564,27,สระแก้ว,2791,ท้องถิ่นเทศบาลตำบลวังสมบูรณ์,5300,5403,10703,5310,5419,10729,5089
2564,27,สระแก้ว,2792,ท้องถิ่นเทศบาลตำบลเขาฉกรรจ์,2357,2413,4770,2399,2450,4849,2349
2564,27,สระแก้ว,2793,ท้องถิ่นเทศบาลตำบลวัฒนานคร,2648,3068,5716,2650,3073,5723,3061
2564,27,สระแก้ว,2794,ท้องถิ่นเทศบาลเมืองวังน้ำเย็น,9951,10564,20515,10016,10609,20625,9918
2564,27,สระแก้ว,2795,ท้องถิ่นเทศบาลตำบลตาพระยา,1253,1295,2548,1272,1305,2577,1153
2564,27,สระแก้ว,2796,ท้องถิ่นเทศบาลตำบลศาลาลำดวน,1274,1326,2600,1278,1330,2608,1198
2564,27,สระแก้ว,2797,ท้องถิ่นเทศบาลตำบลท่าเกษม,1691,1892,3583,1694,1895,3589,1639
2564,27,สระแก้ว,2798,ท้องถิ่นเทศบาลเมืองอรัญญประเทศ,8350,7247,15597,8979,7922,16901,11405
2564,27,สระแก้ว,2799,ท้องถิ่นเทศบาลเมืองสระแก้ว,8681,9423,18104,8823,9536,18359,11670
2564,30,นครราชสีมา,3001,อำเภอเมืองนครราชสีมา,111658,122978,234636,112008,123088,235096,113604
2564,30,นครราชสีมา,3002,อำเภอครบุรี,39715,40668,80383,39765,40682,80447,30740
2564,30,นครราชสีมา,3003,อำเภอเสิงสาง,28171,28607,56778,28255,28660,56915,17420
2564,30,นครราชสีมา,3004,อำเภอคง,36644,37687,74331,36684,37709,74393,21549
2564,30,นครราชสีมา,3005,อำเภอบ้านเหลื่อม,8542,8673,17215,8550,8677,17227,5169
2564,30,นครราชสีมา,3006,อำเภอจักราช,33621,33886,67507,33649,33897,67546,19420
2564,30,นครราชสีมา,3007,อำเภอโชคชัย,24193,25745,49938,24226,25752,49978,19362
2564,30,นครราชสีมา,3008,อำเภอด่านขุนทด,54176,55555,109731,54206,55572,109778,34942
2564,30,นครราชสีมา,3009,อำเภอโนนไทย,26733,27904,54637,26751,27912,54663,16931
2564,30,นครราชสีมา,3010,อำเภอโนนสูง,41640,43358,84998,41679,43370,85049,25339
2564,30,นครราชสีมา,3011,อำเภอขามสะแกแสง,16599,16711,33310,16625,16714,33339,9945
2564,30,นครราชสีมา,3012,อำเภอบัวใหญ่,33788,33712,67500,33815,33735,67550,19319
2564,30,นครราชสีมา,3013,อำเภอประทาย,35348,35874,71222,35370,35888,71258,19681
2564,30,นครราชสีมา,3014,อำเภอปักธงชัย,45144,47388,92532,45178,47401,92579,32621
2564,30,นครราชสีมา,3015,อำเภอพิมาย,59016,60984,120000,59096,61019,120115,39486
2564,30,นครราชสีมา,3016,อำเภอห้วยแถลง,35336,34995,70331,35347,35008,70355,19638
2564,30,นครราชสีมา,3017,อำเภอชุมพวง,36790,37101,73891,36818,37117,73935,20373
2564,30,นครราชสีมา,3018,อำเภอสูงเนิน,35414,37125,72539,35447,37141,72588,29838
2564,30,นครราชสีมา,3019,อำเภอขามทะเลสอ,12701,13255,25956,12713,13259,25972,8577
2564,30,นครราชสีมา,3020,อำเภอสีคิ้ว,42978,43678,86656,43013,43707,86720,32549
2564,30,นครราชสีมา,3021,อำเภอปากช่อง,61715,62939,124654,61989,63148,125137,68512
2564,30,นครราชสีมา,3022,อำเภอหนองบุญมาก,30018,30686,60704,30065,30699,60764,18709
2564,30,นครราชสีมา,3023,อำเภอแก้งสนามนาง,18247,18494,36741,18254,18500,36754,10801
2564,30,นครราชสีมา,3024,อำเภอโนนแดง,10239,10637,20876,10243,10643,20886,5643
2564,30,นครราชสีมา,3025,อำเภอวังน้ำเขียว,21693,21906,43599,21733,21935,43668,19500
2564,30,นครราชสีมา,3026,อำเภอเทพารักษ์,12725,12559,25284,12733,12564,25297,8603
2564,30,นครราชสีมา,3027,อำเภอเมืองยาง,9925,9769,19694,9929,9776,19705,5545
2564,30,นครราชสีมา,3028,อำเภอพระทองคำ,18218,18427,36645,18237,18435,36672,12224
2564,30,นครราชสีมา,3029,อำเภอลำทะเมนชัย,13967,14092,28059,13977,14098,28075,7627
2564,30,นครราชสีมา,3030,อำเภอบัวลาย,10668,10807,21475,10680,10814,21494,6473
2564,30,นครราชสีมา,3031,อำเภอสีดา,10012,10047,20059,10020,10051,20071,5991
2564,30,นครราชสีมา,3032,อำเภอเฉลิมพระเกียรติ,15165,15864,31029,15173,15870,31043,9512
2564,30,นครราชสีมา,3037,ท้องถิ่นเทศบาลตำบลเมืองยาง,4022,4077,8099,4023,4080,8103,2328
2564,30,นครราชสีมา,3038,ท้องถิ่นเทศบาลตำบลหนองน้ำใส,6668,6637,13305,6675,6641,13316,5075
2564,30,นครราชสีมา,3039,ท้องถิ่นเทศบาลตำบลด่านคล้า,4180,4373,8553,4185,4373,8558,2612
2564,30,นครราชสีมา,3040,ท้องถิ่นเทศบาลตำบลใหม่,6342,6451,12793,6351,6454,12805,3553
2564,30,นครราชสีมา,3041,ท้องถิ่นเทศบาลตำบลหนองบัวตะเกียด,4263,4516,8779,4264,4518,8782,2695
2564,30,นครราชสีมา,3042,ท้องถิ่นเทศบาลตำบลบัลลังก์,3874,3910,7784,3879,3912,7791,2469
2564,30,นครราชสีมา,3043,ท้องถิ่นเทศบาลตำบลหนองไข่น้ำ,3081,3064,6145,3085,3064,6149,1841
2564,30,นครราชสีมา,3044,ท้องถิ่นเทศบาลตำบลท่าเยี่ยม,5551,5723,11274,5556,5723,11279,5482
2564,30,นครราชสีมา,3045,ท้องถิ่นเทศบาลตำบลสีมามงคล,4476,4517,8993,4488,4520,9008,4308
2564,30,นครราชสีมา,3046,ท้องถิ่นเทศบาลตำบลลำนางแก้ว,2366,2405,4771,2367,2407,4774,1397
2564,30,นครราชสีมา,3047,ท้องถิ่นเทศบาลตำบลดอนหวาย,1736,1894,3630,1737,1895,3632,1314
2564,30,นครราชสีมา,3048,ท้องถิ่นเทศบาลตำบลหมูสี,6589,6709,13298,6630,6736,13366,11491
2564,30,นครราชสีมา,3049,ท้องถิ่นเทศบาลตำบลโพธิ์กลาง,15343,14095,29438,15363,14105,29468,13508
2564,30,นครราชสีมา,3050,ท้องถิ่นเทศบาลตำบลหัวทะเล,13155,14515,27670,13190,14539,27729,13858
2564,30,นครราชสีมา,3051,ท้องถิ่นเทศบาลตำบลวังไทร,5651,5845,11496,5665,5849,11514,5195
2564,30,นครราชสีมา,3052,ท้องถิ่นเทศบาลตำบลปรุใหญ่,4704,5144,9848,4715,5146,9861,5156
2564,30,นครราชสีมา,3053,ท้องถิ่นเทศบาลตำบลหนองไผ่ล้อม,10685,4493,15178,10688,4498,15186,11300
2564,30,นครราชสีมา,3054,ท้องถิ่นเทศบาลตำบลท่าช้าง,2417,2584,5001,2420,2584,5004,2096
2564,30,นครราชสีมา,3055,ท้องถิ่นเทศบาลตำบลสีดา,1781,1833,3614,1783,1839,3622,1470
2564,30,นครราชสีมา,3056,ท้องถิ่นเทศบาลตำบลหนองบัวลาย,1207,1227,2434,1208,1229,2437,872
2564,30,นครราชสีมา,3057,ท้องถิ่นเทศบาลตำบลหนองบัววง,2274,2352,4626,2276,2353,4629,1847
2564,30,นครราชสีมา,3058,ท้องถิ่นเทศบาลตำบลพระทองคำ,1965,2076,4041,1970,2078,4048,1652
2564,30,นครราชสีมา,3059,ท้องถิ่นเทศบาลตำบลศาลเจ้าพ่อ,891,1015,1906,892,1017,1909,955
2564,30,นครราชสีมา,3060,ท้องถิ่นเทศบาลตำบลโนนแดง,2092,2189,4281,2095,2193,4288,1586
2564,30,นครราชสีมา,3061,ท้องถิ่นเทศบาลตำบลกลางดง,2482,2564,5046,2486,2569,5055,2730
2564,30,นครราชสีมา,3062,ท้องถิ่นเทศบาลเมืองสีคิ้ว,7772,8691,16463,7794,8719,16513,9453
2564,30,นครราชสีมา,3063,ท้องถิ่นเทศบาลตำบลลาดบัวขาว,1961,2163,4124,1962,2164,4126,2244
2564,30,นครราชสีมา,3064,ท้องถิ่นเทศบาลตำบลคลองไผ่,1960,1660,3620,1972,1670,3642,1751
2564,30,นครราชสีมา,3065,ท้องถิ่นเทศบาลตำบลขามทะเลสอ,2097,2180,4277,2104,2186,4290,2198
2564,30,นครราชสีมา,3066,ท้องถิ่นเทศบาลตำบลสูงเนิน,4560,5137,9697,4640,5213,9853,6308
2564,30,นครราชสีมา,3067,ท้องถิ่นเทศบาลตำบลกุดจิก,1259,1431,2690,1260,1431,2691,1405
2564,30,นครราชสีมา,3068,ท้องถิ่นเทศบาลตำบลชุมพวง,4289,4531,8820,4293,4533,8826,3841
2564,30,นครราชสีมา,3069,ท้องถิ่นเทศบาลตำบลหินดาด,1396,1384,2780,1399,1385,2784,780
2564,30,นครราชสีมา,3070,ท้องถิ่นเทศบาลตำบลห้วยแถลง,1490,1657,3147,1492,1660,3152,1624
2564,30,นครราชสีมา,3071,ท้องถิ่นเทศบาลตำบลพิมาย,3586,4173,7759,3594,4174,7768,2903
2564,30,นครราชสีมา,3072,ท้องถิ่นเทศบาลเมืองเมืองปัก,6347,7215,13562,6364,7236,13600,7009
2564,30,นครราชสีมา,3073,ท้องถิ่นเทศบาลตำบลตะขบ,2542,2687,5229,2542,2689,5231,1913
2564,30,นครราชสีมา,3074,ท้องถิ่นเทศบาลตำบลประทาย,2930,3129,6059,2934,3130,6064,3104
2564,30,นครราชสีมา,3075,ท้องถิ่นเทศบาลตำบลหนองหัวฟาน,2259,2263,4522,2263,2266,4529,1419
2564,30,นครราชสีมา,3076,ท้องถิ่นเทศบาลตำบลขามสะแกแสง,2418,2675,5093,2422,2675,5097,1920
2564,30,นครราชสีมา,3077,ท้องถิ่นเทศบาลตำบลมะค่า,949,969,1918,949,969,1918,595
2564,30,นครราชสีมา,3078,ท้องถิ่นเทศบาลตำบลตลาดแค,1573,1728,3301,1575,1730,3305,1326
2564,30,นครราชสีมา,3079,ท้องถิ่นเทศบาลตำบลโนนไทย,1415,1642,3057,1423,1645,3068,1389
2564,30,นครราชสีมา,3080,ท้องถิ่นเทศบาลตำบลโคกสวาย,2556,2678,5234,2558,2678,5236,1785
2564,30,นครราชสีมา,3081,ท้องถิ่นเทศบาลตำบลหนองกราด,1953,2121,4074,1958,2122,4080,1352
2564,30,นครราชสีมา,3082,ท้องถิ่นเทศบาลตำบลด่านขุนทด,2867,3236,6103,2874,3242,6116,3962
2564,30,นครราชสีมา,3083,ท้องถิ่นเทศบาลตำบลด่านเกวียน,4796,5039,9835,4797,5039,9836,4405
2564,30,นครราชสีมา,3084,ท้องถิ่นเทศบาลตำบลโชคชัย,5817,6481,12298,5987,6661,12648,5554
2564,30,นครราชสีมา,3085,ท้องถิ่นเทศบาลตำบลจักราช,1917,2176,4093,1922,2179,4101,1617
2564,30,นครราชสีมา,3086,ท้องถิ่นเทศบาลตำบลบ้านเหลื่อม,1598,1824,3422,1599,1824,3423,1228
2564,30,นครราชสีมา,3087,ท้องถิ่นเทศบาลตำบลเมืองคง,1041,1140,2181,1049,1142,2191,1008
2564,30,นครราชสีมา,3088,ท้องถิ่นเทศบาลตำบลเทพาลัย,1326,1440,2766,1328,1442,2770,858
2564,30,นครราชสีมา,3089,ท้องถิ่นเทศบาลตำบลเสิงสาง,3657,3927,7584,3669,3936,7605,3207
2564,30,นครราชสีมา,3090,ท้องถิ่นเทศบาลตำบลโนนสมบูรณ์,2882,2943,5825,2890,2946,5836,1831
2564,30,นครราชสีมา,3091,ท้องถิ่นเทศบาลตำบลไทรโยง-ไชยวาล,1790,1853,3643,1795,1854,3649,1166
2564,30,นครราชสีมา,3092,ท้องถิ่นเทศบาลตำบลแชะ,2760,3177,5937,2771,3179,5950,3033
2564,30,นครราชสีมา,3093,ท้องถิ่นเทศบาลตำบลจระเข้หิน,2871,3219,6090,2874,3220,6094,2406
2564,30,นครราชสีมา,3094,ท้องถิ่นเทศบาลตำบลจอหอ,8353,8579,16932,8376,8592,16968,9909
2564,30,นครราชสีมา,3095,ท้องถิ่นเทศบาลตำบลโคกกรวด,3298,3738,7036,3330,3763,7093,4687
2564,30,นครราชสีมา,3096,ท้องถิ่นเทศบาลตำบลโนนสูง,4597,4970,9567,4605,4973,9578,4013
2564,30,นครราชสีมา,3097,ท้องถิ่นเทศบาลเมืองบัวใหญ่,6438,7050,13488,6464,7058,13522,7176
2564,30,นครราชสีมา,3098,ท้องถิ่นเทศบาลเมืองปากช่อง,15384,17336,32720,15663,17602,33265,18884
2564,30,นครราชสีมา,3099,ท้องถิ่นเทศบาลนครนครราชสีมา,55653,63933,119586,56073,64281,120354,72306
2564,31,บุรีรัมย์,3101,อำเภอเมืองบุรีรัมย์,86938,87534,174472,87130,87602,174732,53449
2564,31,บุรีรัมย์,3102,อำเภอคูเมือง,29618,29528,59146,29677,29555,59232,16374
2564,31,บุรีรัมย์,3103,อำเภอกระสัง,50051,51357,101408,50148,51398,101546,26527
2564,31,บุรีรัมย์,3104,อำเภอนางรอง,45795,47310,93105,45837,47336,93173,26618
2564,31,บุรีรัมย์,3105,อำเภอหนองกี่,28810,28507,57317,28838,28515,57353,15549
2564,31,บุรีรัมย์,3106,อำเภอละหานทราย,9725,9719,19444,9752,9726,19478,5823
2564,31,บุรีรัมย์,3107,อำเภอประโคนชัย,62285,62876,125161,62388,62937,125325,36671
2564,31,บุรีรัมย์,3108,อำเภอบ้านกรวด,20330,20545,40875,20421,20573,40994,11451
2564,31,บุรีรัมย์,3109,อำเภอพุทไธสง,20314,21257,41571,20326,21264,41590,12324
2564,31,บุรีรัมย์,3110,อำเภอลำปลายมาศ,57096,57378,114474,57163,57403,114566,31324
2564,31,บุรีรัมย์,3111,อำเภอสตึก,49246,49475,98721,49296,49488,98784,27374
2564,31,บุรีรัมย์,3112,อำเภอปะคำ,19169,19137,38306,19193,19143,38336,11878
2564,31,บุรีรัมย์,3113,อำเภอนาโพธิ์,14085,14404,28489,14100,14414,28514,8008
2564,31,บุรีรัมย์,3114,อำเภอหนองหงส์,17848,17578,35426,17856,17582,35438,9436
2564,31,บุรีรัมย์,3115,อำเภอพลับพลาชัย,14090,13661,27751,14134,13667,27801,7166
2564,31,บุรีรัมย์,3116,อำเภอห้วยราช,16115,16351,32466,16144,16355,32499,8283
2564,31,บุรีรัมย์,3117,อำเภอโนนสุวรรณ,10861,10944,21805,10867,10946,21813,6419
2564,31,บุรีรัมย์,3118,อำเภอชำนิ,17638,17709,35347,17664,17718,35382,9185
2564,31,บุรีรัมย์,3119,อำเภอบ้านใหม่ไชยพจน์,10887,11206,22093,10898,11214,22112,6102
2564,31,บุรีรัมย์,3120,อำเภอโนนดินแดง,9399,9292,18691,9428,9308,18736,5778
2564,31,บุรีรัมย์,3121,อำเภอบ้านด่าน,9249,9538,18787,9264,9541,18805,4615
2564,31,บุรีรัมย์,3122,อำเภอแคนดง,13334,13539,26873,13354,13547,26901,7417
2564,31,บุรีรัมย์,3123,อำเภอเฉลิมพระเกียรติ,5996,6065,12061,6005,6073,12078,3553
2564,31,บุรีรัมย์,3162,ท้องถิ่นเทศบาลตำบลจันดุม,5199,5333,10532,5211,5339,10550,2954
2564,31,บุรีรัมย์,3163,ท้องถิ่นเทศบาลตำบลห้วยหิน,4836,4891,9727,4838,4891,9729,2662
2564,31,บุรีรัมย์,3164,ท้องถิ่นเทศบาลตำบลสำโรงใหม่,6337,6321,12658,6348,6326,12674,3761
2564,31,บุรีรัมย์,3165,ท้องถิ่นเทศบาลตำบลจันทบเพชร,3882,3941,7823,3905,3946,7851,2404
2564,31,บุรีรัมย์,3166,ท้องถิ่นเทศบาลตำบลหนองแวง,8457,8348,16805,8463,8355,16818,4235
2564,31,บุรีรัมย์,3167,ท้องถิ่นเทศบาลตำบลหนองไม้งาม,5038,5019,10057,5055,5020,10075,2914
2564,31,บุรีรัมย์,3168,ท้องถิ่นเทศบาลตำบลบ้านกรวดปัญญาวัฒน์,4642,4663,9305,4667,4665,9332,2721
2564,31,บุรีรัมย์,3169,ท้องถิ่นเทศบาลตำบลบ้านด่าน,5876,6123,11999,5898,6123,12021,3314
2564,31,บุรีรัมย์,3170,ท้องถิ่นเทศบาลตำบลถาวร,3776,3879,7655,3784,3881,7665,2213
2564,31,บุรีรัมย์,3171,ท้องถิ่นเทศบาลตำบลยายแย้มวัฒนา,4314,4296,8610,4321,4299,8620,2349
2564,31,บุรีรัมย์,3172,ท้องถิ่นเทศบาลตำบลอิสาณ,10190,11270,21460,10239,11278,21517,12904
2564,31,บุรีรัมย์,3174,ท้องถิ่นเทศบาลตำบลศาลเจ้าพ่อขุนศรี,1662,1702,3364,1663,1703,3366,1305
2564,31,บุรีรัมย์,3175,ท้องถิ่นเทศบาลตำบลตาจง,8355,8250,16605,8372,8261,16633,4361
2564,31,บุรีรัมย์,3176,ท้องถิ่นเทศบาลตำบลพนมรุ้ง,5708,6096,11804,5717,6099,11816,3902
2564,31,บุรีรัมย์,3177,ท้องถิ่นเทศบาลตำบลแคนดง,2712,2750,5462,2718,2751,5469,1925
2564,31,บุรีรัมย์,3178,ท้องถิ่นเทศบาลตำบลโนนดินแดง,4605,4787,9392,4637,4795,9432,3617
2564,31,บุรีรัมย์,3179,ท้องถิ่นเทศบาลตำบลบ้านใหม่ไชยพจน์,2072,2196,4268,2083,2198,4281,1427
2564,31,บุรีรัมย์,3180,ท้องถิ่นเทศบาลตำบลโนนสุวรรณ,1608,1683,3291,1611,1684,3295,1069
2564,31,บุรีรัมย์,3181,ท้องถิ่นเทศบาลตำบลห้วยราช,2502,2555,5057,2506,2558,5064,1425
2564,31,บุรีรัมย์,3182,ท้องถิ่นเทศบาลตำบลพลับพลาชัย,3333,3277,6610,3342,3278,6620,1958
2564,31,บุรีรัมย์,3183,ท้องถิ่นเทศบาลตำบลหนองหงส์,2372,2377,4749,2376,2378,4754,1753
2564,31,บุรีรัมย์,3184,ท้องถิ่นเทศบาลตำบลนาโพธิ์,1757,1909,3666,1760,1910,3670,1665
2564,31,บุรีรัมย์,3185,ท้องถิ่นเทศบาลตำบลปะคำ,3500,3609,7109,3505,3611,7116,2813
2564,31,บุรีรัมย์,3186,ท้องถิ่นเทศบาลตำบลสตึก,5286,5678,10964,5312,5690,11002,5634
2564,31,บุรีรัมย์,3187,ท้องถิ่นเทศบาลเมืองลำปลายมาศ,6342,6938,13280,6353,6948,13301,6212
2564,31,บุรีรัมย์,3188,ท้องถิ่นเทศบาลตำบลทะเมนชัย,2137,2184,4321,2138,2185,4323,1251
2564,31,บุรีรัมย์,3189,ท้องถิ่นเทศบาลตำบลพุทไธสง,1986,2190,4176,1988,2192,4180,2260
2564,31,บุรีรัมย์,3190,ท้องถิ่นเทศบาลตำบลบ้านกรวด,1896,1980,3876,1916,1981,3897,1987
2564,31,บุรีรัมย์,3191,ท้องถิ่นเทศบาลตำบลตลาดนิคมปราสาท,2330,2470,4800,2347,2471,4818,1758
2564,31,บุรีรัมย์,3192,ท้องถิ่นเทศบาลเมืองประโคนชัย,4482,5018,9500,4493,5021,9514,4099
2564,31,บุรีรัมย์,3193,ท้องถิ่นเทศบาลตำบลละหานทราย,4169,4119,8288,4186,4126,8312,3434
2564,31,บุรีรัมย์,3194,ท้องถิ่นเทศบาลตำบลหนองกี่,4714,5037,9751,4719,5045,9764,4165
2564,31,บุรีรัมย์,3195,ท้องถิ่นเทศบาลตำบลกระสัง,1581,1784,3365,1599,1795,3394,1814
2564,31,บุรีรัมย์,3196,ท้องถิ่นเทศบาลตำบลหินเหล็กไฟ,2433,2527,4960,2436,2528,4964,1832
2564,31,บุรีรัมย์,3197,ท้องถิ่นเทศบาลตำบลคูเมือง,1802,1807,3609,1805,1811,3616,2008
2564,31,บุรีรัมย์,3198,ท้องถิ่นเทศบาลเมืองนางรอง,9641,10888,20529,9666,10904,20570,11417
2564,31,บุรีรัมย์,3199,ท้องถิ่นเทศบาลนครบุรีรัมย์,11620,12886,24506,11671,12923,24594,14503
2564,32,สุรินทร์,3201,อำเภอเมืองสุรินทร์,107236,109807,217043,107524,109884,217408,76910
2564,32,สุรินทร์,3202,อำเภอชุมพลบุรี,34411,34198,68609,34424,34213,68637,18913
2564,32,สุรินทร์,3203,อำเภอท่าตูม,45915,45624,91539,45942,45661,91603,23709
2564,32,สุรินทร์,3204,อำเภอจอมพระ,27335,27210,54545,27344,27220,54564,14031
2564,32,สุรินทร์,3205,อำเภอปราสาท,71135,72851,143986,71291,72892,144183,42416
2564,32,สุรินทร์,3206,อำเภอกาบเชิง,30119,29927,60046,30160,29944,60104,18734
2564,32,สุรินทร์,3207,อำเภอรัตนบุรี,43275,43565,86840,43299,43584,86883,23055
2564,32,สุรินทร์,3208,อำเภอสนม,19372,19146,38518,19387,19153,38540,10835
2564,32,สุรินทร์,3209,อำเภอศีขรภูมิ,64599,65479,130078,64631,65502,130133,32736
2564,32,สุรินทร์,3210,อำเภอสังขะ,63833,63296,127129,63895,63308,127203,34939
2564,32,สุรินทร์,3211,อำเภอลำดวน,13394,13397,26791,13406,13403,26809,7132
2564,32,สุรินทร์,3212,อำเภอสำโรงทาบ,25275,25043,50318,25282,25047,50329,11915
2564,32,สุรินทร์,3213,อำเภอบัวเชด,17821,17196,35017,17842,17204,35046,9865
2564,32,สุรินทร์,3214,อำเภอพนมดงรัก,19123,18733,37856,19178,18754,37932,12440
2564,32,สุรินทร์,3215,อำเภอศรีณรงค์,23517,23196,46713,23528,23201,46729,11682
2564,32,สุรินทร์,3216,อำเภอเขวาสินรินทร์,16927,17360,34287,16950,17373,34323,10105
2564,32,สุรินทร์,3217,อำเภอโนนนารายณ์,17376,17553,34929,17378,17555,34933,8692
2564,32,สุรินทร์,3286,ท้องถิ่นเทศบาลตำบลบัวเชด,3176,3294,6470,3178,3295,6473,2418
2564,32,สุรินทร์,3287,ท้องถิ่นเทศบาลตำบลสำโรงทาบ,1141,1178,2319,1145,1179,2324,1268
2564,32,สุรินทร์,3288,ท้องถิ่นเทศบาลตำบลลำดวนสุรพินท์,2062,2256,4318,2069,2259,4328,1876
2564,32,สุรินทร์,3289,ท้องถิ่นเทศบาลตำบลสังขะ,1739,1992,3731,1741,1997,3738,2314
2564,32,สุรินทร์,3290,ท้องถิ่นเทศบาลตำบลศีขรภูมิ,2238,2416,4654,2242,2421,4663,2815
2564,32,สุรินทร์,3291,ท้องถิ่นเทศบาลตำบลสนม,2424,2570,4994,2430,2572,5002,1616
2564,32,สุรินทร์,3292,ท้องถิ่นเทศบาลตำบลรัตนบุรี,2559,2754,5313,2562,2757,5319,2712
2564,32,สุรินทร์,3293,ท้องถิ่นเทศบาลตำบลนิคมปราสาท,1323,1342,2665,1325,1343,2668,863
2564,32,สุรินทร์,3294,ท้องถิ่นเทศบาลตำบลกังแอน,2638,3025,5663,2660,3031,5691,3419
2564,32,สุรินทร์,3295,ท้องถิ่นเทศบาลตำบลจอมพระ,1954,2179,4133,1960,2180,4140,1939
2564,32,สุรินทร์,3296,ท้องถิ่นเทศบาลตำบลท่าตูม,1934,2076,4010,1939,2079,4018,1819
2564,32,สุรินทร์,3297,ท้องถิ่นเทศบาลตำบลชุมพลบุรี,1097,1209,2306,1099,1211,2310,1097
2564,32,สุรินทร์,3298,ท้องถิ่นเทศบาลตำบลเมืองที,949,933,1882,950,934,1884,567
2564,32,สุรินทร์,3299,ท้องถิ่นเทศบาลเมืองสุรินทร์,17426,20593,38019,17593,20720,38313,17256
2564,33,ศรีสะเกษ,3301,อำเภอเมืองศรีสะเกษ,42820,44454,87274,42840,44475,87315,27219
2564,33,ศรีสะเกษ,3302,อำเภอยางชุมน้อย,14905,14763,29668,14908,14766,29674,7631
2564,33,ศรีสะเกษ,3303,อำเภอกันทรารมย์,46468,46841,93309,46484,46853,93337,24510
2564,33,ศรีสะเกษ,3304,อำเภอกันทรลักษ์,91799,91672,183471,91975,91817,183792,51639
2564,33,ศรีสะเกษ,3305,อำเภอขุขันธ์,72218,73065,145283,72298,73121,145419,35679
2564,33,ศรีสะเกษ,3306,อำเภอไพรบึง,18114,18386,36500,18117,18387,36504,9148
2564,33,ศรีสะเกษ,3307,อำเภอปรางค์กู่,31626,31863,63489,31646,31876,63522,15263
2564,33,ศรีสะเกษ,3308,อำเภอขุนหาญ,34215,34703,68918,34275,34737,69012,18260
2564,33,ศรีสะเกษ,3309,อำเภอราษีไศล,37840,38046,75886,37859,38058,75917,20272
2564,33,ศรีสะเกษ,3310,อำเภออุทุมพรพิสัย,50801,51449,102250,50840,51473,102313,26546
2564,33,ศรีสะเกษ,3311,อำเภอบึงบูรพ์,2179,2178,4357,2180,2178,4358,1085
2564,33,ศรีสะเกษ,3312,อำเภอห้วยทับทัน,19485,19418,38903,19501,19427,38928,9033
2564,33,ศรีสะเกษ,3313,อำเภอโนนคูณ,19861,19606,39467,19872,19613,39485,11220
2564,33,ศรีสะเกษ,3314,อำเภอศรีรัตนะ,24126,24393,48519,24141,24399,48540,11607
2564,33,ศรีสะเกษ,3315,อำเภอน้ำเกลี้ยง,22438,21927,44365,22456,21936,44392,11333
2564,33,ศรีสะเกษ,3316,อำเภอวังหิน,20247,19968,40215,20264,19984,40248,9587
2564,33,ศรีสะเกษ,3317,อำเภอภูสิงห์,27546,27201,54747,27561,27218,54779,16020
2564,33,ศรีสะเกษ,3318,อำเภอเมืองจันทร์,9006,8796,17802,9010,8802,17812,4434
2564,33,ศรีสะเกษ,3319,อำเภอเบญจลักษ์,18188,17829,36017,18194,17831,36025,9323
2564,33,ศรีสะเกษ,3320,อำเภอพยุห์,15388,15782,31170,15394,15786,31180,8302
2564,33,ศรีสะเกษ,3321,อำเภอโพธิ์ศรีสุวรรณ,11898,11799,23697,11902,11806,23708,5698
2564,33,ศรีสะเกษ,3322,อำเภอศิลาลาด,9925,9802,19727,9927,9807,19734,5400
2564,33,ศรีสะเกษ,3381,ท้องถิ่นเทศบาลตำบลบุสูง,5187,5089,10276,5196,5092,10288,2799
2564,33,ศรีสะเกษ,3382,ท้องถิ่นเทศบาลตำบลกันทรอม,4588,4432,9020,4590,4433,9023,2278
2564,33,ศรีสะเกษ,3383,ท้องถิ่นเทศบาลตำบลกระหวัน,4337,4485,8822,4342,4488,8830,2211
2564,33,ศรีสะเกษ,3384,ท้องถิ่นเทศบาลตำบลน้ำคำ,5166,5340,10506,5168,5342,10510,3066
2564,33,ศรีสะเกษ,3385,ท้องถิ่นเทศบาลตำบลโพธิ์กระสังข์,4612,4579,9191,4613,4581,9194,2071
2564,33,ศรีสะเกษ,3386,ท้องถิ่นเทศบาลตำบลพยุห์,1947,1974,3921,1948,1974,3922,1437
2564,33,ศรีสะเกษ,3387,ท้องถิ่นเทศบาลตำบลศรีรัตนะ,2310,2370,4680,2313,2370,4683,1467
2564,33,ศรีสะเกษ,3388,ท้องถิ่นเทศบาลตำบลห้วยทับทัน,1680,1634,3314,1680,1634,3314,1067
2564,33,ศรีสะเกษ,3389,ท้องถิ่นเทศบาลตำบลบึงบูรพ์,2981,3132,6113,2983,3133,6116,1838
2564,33,ศรีสะเกษ,3390,ท้องถิ่นเทศบาลตำบลกำแพง,1257,1369,2626,1262,1374,2636,1333
2564,33,ศรีสะเกษ,3391,ท้องถิ่นเทศบาลตำบลเมืองคง,1916,2025,3941,1920,2025,3945,2122
2564,33,ศรีสะเกษ,3392,ท้องถิ่นเทศบาลตำบลขุนหาญ,5345,5480,10825,5366,5482,10848,3784
2564,33,ศรีสะเกษ,3393,ท้องถิ่นเทศบาลตำบลปรางค์กู่,1331,1390,2721,1332,1391,2723,1251
2564,33,ศรีสะเกษ,3394,ท้องถิ่นเทศบาลตำบลไพรบึง,5455,5405,10860,5458,5406,10864,2915
2564,33,ศรีสะเกษ,3395,ท้องถิ่นเทศบาลตำบลเมืองขุขันธ์,2068,2191,4259,2072,2192,4264,2181
2564,33,ศรีสะเกษ,3396,ท้องถิ่นเทศบาลเมืองกันทรลักษ์,8490,9180,17670,8528,9201,17729,7622
2564,33,ศรีสะเกษ,3397,ท้องถิ่นเทศบาลตำบลกันทรารมย์,2915,3127,6042,2923,3129,6052,3219
2564,33,ศรีสะเกษ,3398,ท้องถิ่นเทศบาลตำบลยางชุมน้อย,3096,3203,6299,3097,3206,6303,2421
2564,33,ศรีสะเกษ,3399,ท้องถิ่นเทศบาลเมืองศรีสะเกษ,18905,21266,40171,18991,21327,40318,20984
2564,34,อุบลราชธานี,3401,อำเภอเมืองอุบลราชธานี,47688,48934,96622,47800,48986,96786,36128
2564,34,อุบลราชธานี,3402,อำเภอศรีเมืองใหม่,33558,32988,66546,33698,33205,66903,19482
2564,34,อุบลราชธานี,3403,อำเภอโขงเจียม,17769,17091,34860,18111,17724,35835,10245
2564,34,อุบลราชธานี,3404,อำเภอเขื่องใน,50765,51729,102494,50796,51752,102548,28149
2564,34,อุบลราชธานี,3405,อำเภอเขมราฐ,15729,15501,31230,15880,15844,31724,9139
2564,34,อุบลราชธานี,3407,อำเภอเดชอุดม,66351,65526,131877,66388,65547,131935,51589
2564,34,อุบลราชธานี,3408,อำเภอนาจะหลวย,26072,25409,51481,26106,25441,51547,18190
2564,34,อุบลราชธานี,3409,อำเภอน้ำยืน,31113,30239,61352,31141,30262,61403,20871
2564,34,อุบลราชธานี,3410,อำเภอบุณฑริก,39179,38006,77185,39480,38400,77880,24554
2564,34,อุบลราชธานี,3411,อำเภอตระการพืชผล,56522,56059,112581,56582,56136,112718,29955
2564,34,อุบลราชธานี,3412,อำเภอกุดข้าวปุ้น,18427,18422,36849,18435,18436,36871,9584
2564,34,อุบลราชธานี,3414,อำเภอม่วงสามสิบ,40757,40667,81424,40787,40698,81485,22951
2564,34,อุบลราชธานี,3415,อำเภอวารินชำราบ,46020,46651,92671,46105,46707,92812,30977
2564,34,อุบลราชธานี,3419,อำเภอพิบูลมังสาหาร,52469,51689,104158,52570,51826,104396,34474
2564,34,อุบลราชธานี,3420,อำเภอตาลสุม,15174,14756,29930,15188,14768,29956,8449
2564,34,อุบลราชธานี,3421,อำเภอโพธิ์ไทร,22375,21518,43893,22613,21911,44524,12033
2564,34,อุบลราชธานี,3422,อำเภอสำโรง,27163,27045,54208,27172,27048,54220,14887
2564,34,อุบลราชธานี,3424,อำเภอดอนมดแดง,13735,13529,27264,13748,13545,27293,8006
2564,34,อุบลราชธานี,3425,อำเภอสิรินธร,21967,21051,43018,22157,21375,43532,14622
2564,34,อุบลราชธานี,3426,อำเภอทุ่งศรีอุดม,14752,14458,29210,14759,14464,29223,9180
2564,34,อุบลราชธานี,3429,อำเภอนาเยีย,10840,10125,20965,10847,10129,20976,7197
2564,34,อุบลราชธานี,3430,อำเภอนาตาล,18947,18783,37730,19200,19215,38415,11428
2564,34,อุบลราชธานี,3431,อำเภอเหล่าเสือโก้ก,14033,13945,27978,14048,13949,27997,7965
2564,34,อุบลราชธานี,3432,อำเภอสว่างวีระวงศ์,15601,15517,31118,15619,15534,31153,9269
2564,34,อุบลราชธานี,3433,อำเภอน้ำขุ่น,16799,16511,33310,16816,16516,33332,11016
2564,34,อุบลราชธานี,3463,ท้องถิ่นเทศบาลตำบลกุดชมภู,5897,5837,11734,5922,5877,11799,4423
2564,34,อุบลราชธานี,3464,ท้องถิ่นเทศบาลตำบลคำน้ำแซบ,4019,4079,8098,4034,4086,8120,3228
2564,34,อุบลราชธานี,3465,ท้องถิ่นเทศบาลตำบลหัวนา,6558,6673,13231,6580,6694,13274,3586
2564,34,อุบลราชธานี,3466,ท้องถิ่นเทศบาลตำบลโพนงาม,4524,4589,9113,4528,4589,9117,3226
2564,34,อุบลราชธานี,3467,ท้องถิ่นเทศบาลตำบลเมืองศรีไค,3021,3158,6179,3026,3159,6185,3431
2564,34,อุบลราชธานี,3468,ท้องถิ่นเทศบาลตำบลหนองผือ,4856,5061,9917,4862,5081,9943,3419
2564,34,อุบลราชธานี,3469,ท้องถิ่นเทศบาลตำบลขามป้อม,4787,4673,9460,4820,4747,9567,3208
2564,34,อุบลราชธานี,3470,ท้องถิ่นเทศบาลเมืองเทพวงศา,5870,5656,11526,6031,5941,11972,4136
2564,34,อุบลราชธานี,3471,ท้องถิ่นเทศบาลตำบลปทุม,4959,5519,10478,4987,5532,10519,4190
2564,34,อุบลราชธานี,3472,ท้องถิ่นเทศบาลตำบลคอแลน,6645,6418,13063,6713,6547,13260,4113
2564,34,อุบลราชธานี,3473,ท้องถิ่น ทต.นิคมสร้างตนเองลำโดมน้อย,3859,3824,7683,3893,3875,7768,2926
2564,34,อุบลราชธานี,3474,ท้องถิ่นเทศบาลตำบลกุดประทาย,6920,6757,13677,6923,6764,13687,5116
2564,34,อุบลราชธานี,3475,ท้องถิ่นเทศบาลตำบลขามใหญ่,18733,20700,39433,18879,20739,39618,20913
2564,34,อุบลราชธานี,3476,ท้องถิ่นเทศบาลตำบลแสนสุข,13134,11186,24320,13188,11206,24394,11245
2564,34,อุบลราชธานี,3477,ท้องถิ่นเทศบาลตำบลนาเยีย,3199,3301,6500,3201,3302,6503,1858
2564,34,อุบลราชธานี,3478,ท้องถิ่นเทศบาลตำบลช่องเม็ก,1801,1768,3569,1825,1883,3708,1909
2564,34,อุบลราชธานี,3479,ท้องถิ่นเทศบาลตำบลโพธิ์ไทร,1500,1552,3052,1503,1554,3057,1189
2564,34,อุบลราชธานี,3480,ท้องถิ่นเทศบาลตำบลตาลสุม,1604,1619,3223,1604,1619,3223,1082
2564,34,อุบลราชธานี,3481,ท้องถิ่นเทศบาลตำบลอ่างศิลา,1471,1600,3071,1472,1602,3074,1017
2564,34,อุบลราชธานี,3482,ท้องถิ่นเทศบาลตำบลห้วยขะยุง,1535,1608,3143,1539,1608,3147,984
2564,34,อุบลราชธานี,3483,ท้องถิ่นเทศบาลตำบลม่วงสามสิบ,1475,1627,3102,1480,1629,3109,1604
2564,34,อุบลราชธานี,3484,ท้องถิ่นเทศบาลตำบลกุดข้าวปุ้น,2101,2053,4154,2103,2055,4158,1482
2564,34,อุบลราชธานี,3485,ท้องถิ่นเทศบาลตำบลตระการพืชผล,4396,4605,9001,4409,4617,9026,4367
2564,34,อุบลราชธานี,3486,ท้องถิ่นเทศบาลตำบลบุณฑริก,2159,2236,4395,2162,2242,4404,2096
2564,34,อุบลราชธานี,3487,ท้องถิ่นเทศบาลตำบลน้ำยืน,4417,4500,8917,4419,4503,8922,3407
2564,34,อุบลราชธานี,3488,ท้องถิ่นเทศบาลตำบลนาจะหลวย,3616,3622,7238,3628,3627,7255,2680
2564,34,อุบลราชธานี,3489,ท้องถิ่นเทศบาลเมืองเดชอุดม,6327,6942,13269,6340,6953,13293,6686
2564,34,อุบลราชธานี,3490,ท้องถิ่นเทศบาลตำบลบัวงาม,3337,3337,6674,3338,3338,6676,1879
2564,34,อุบลราชธานี,3491,ท้องถิ่นเทศบาลตำบลนาส่วง,1514,1613,3127,1514,1615,3129,1004
2564,34,อุบลราชธานี,3492,ท้องถิ่นเทศบาลตำบลเขมราฐ,2794,2982,5776,2827,3069,5896,2524
2564,34,อุบลราชธานี,3493,ท้องถิ่นเทศบาลตำบลเขื่องใน,2202,2336,4538,2203,2339,4542,2080
2564,34,อุบลราชธานี,3494,ท้องถิ่นเทศบาลตำบลบ้านด่านโขงเจียม,1394,1318,2712,1449,1439,2888,1316
2564,34,อุบลราชธานี,3495,ท้องถิ่นเทศบาลตำบลศรีเมืองใหม่,2083,2087,4170,2088,2095,4183,1967
2564,34,อุบลราชธานี,3496,ท้องถิ่นเทศบาลตำบลอุบล,2615,3092,5707,2637,3095,5732,3122
2564,34,อุบลราชธานี,3497,ท้องถิ่นเทศบาลเมืองพิบูลมังสาหาร,4991,5325,10316,5006,5339,10345,4590
2564,34,อุบลราชธานี,3498,ท้องถิ่นเทศบาลเมืองวารินชำราบ,12030,13596,25626,12070,13622,25692,10944
2564,34,อุบลราชธานี,3499,ท้องถิ่นเทศบาลนครอุบลราชธานี,32860,38332,71192,33217,38653,71870,32217
2564,35,ยโสธร,3501,อำเภอเมืองยโสธร,53609,53603,107212,53665,53629,107294,38967
2564,35,ยโสธร,3502,อำเภอทรายมูล,12287,12264,24551,12296,12269,24565,8015
2564,35,ยโสธร,3503,อำเภอกุดชุม,30893,30467,61360,30908,30479,61387,19962
2564,35,ยโสธร,3504,อำเภอคำเขื่อนแก้ว,30977,30879,61856,30998,30893,61891,19296
2564,35,ยโสธร,3505,อำเภอป่าติ้ว,15968,16016,31984,15983,16022,32005,10158
2564,35,ยโสธร,3506,อำเภอมหาชนะชัย,25715,25696,51411,25724,25709,51433,14578
2564,35,ยโสธร,3507,อำเภอค้อวัง,10284,10426,20710,10288,10432,20720,5519
2564,35,ยโสธร,3508,อำเภอเลิงนกทา,44527,44858,89385,44555,44887,89442,28897
2564,35,ยโสธร,3509,อำเภอไทยเจริญ,15185,15275,30460,15193,15284,30477,10653
2564,35,ยโสธร,3591,ท้องถิ่นเทศบาลตำบลสามแยก,1891,1996,3887,1896,1996,3892,2250
2564,35,ยโสธร,3592,ท้องถิ่นเทศบาลตำบลเลิงนกทา,1416,1502,2918,1417,1503,2920,1092
2564,35,ยโสธร,3593,ท้องถิ่นเทศบาลตำบลค้อวัง,2199,2291,4490,2200,2291,4491,1628
2564,35,ยโสธร,3594,ท้องถิ่นเทศบาลตำบลฟ้าหยาด,2300,2391,4691,2300,2396,4696,1860
2564,35,ยโสธร,3595,ท้องถิ่นเทศบาลตำบลป่าติ้ว,1491,1545,3036,1493,1545,3038,1250
2564,35,ยโสธร,3596,ท้องถิ่นเทศบาลตำบลคำเขื่อนแก้ว,1873,1937,3810,1874,1938,3812,1563
2564,35,ยโสธร,3597,ท้องถิ่นเทศบาลตำบลกุดชุมพัฒนา,2353,2469,4822,2356,2469,4825,2221
2564,35,ยโสธร,3598,ท้องถิ่นเทศบาลตำบลทรายมูล,3028,3208,6236,3029,3211,6240,2142
2564,35,ยโสธร,3599,ท้องถิ่นเทศบาลเมืองยโสธร,9749,10483,20232,9770,10496,20266,9178
2564,36,ชัยภูมิ,3601,อำเภอเมืองชัยภูมิ,66706,69900,136606,66810,69938,136748,55014
2564,36,ชัยภูมิ,3602,อำเภอบ้านเขว้า,20867,21295,42162,20877,21307,42184,14760
2564,36,ชัยภูมิ,3603,อำเภอคอนสวรรค์,23779,24214,47993,23805,24225,48030,18085
2564,36,ชัยภูมิ,3604,อำเภอเกษตรสมบูรณ์,42444,42920,85364,42490,42935,85425,25288
2564,36,ชัยภูมิ,3605,อำเภอหนองบัวแดง,46559,46377,92936,46657,46428,93085,29973
2564,36,ชัยภูมิ,3606,อำเภอจัตุรัส,32998,34946,67944,33031,34958,67989,25001
2564,36,ชัยภูมิ,3607,อำเภอบำเหน็จณรงค์,20100,20554,40654,20121,20565,40686,13633
2564,36,ชัยภูมิ,3608,อำเภอหนองบัวระเหว,16427,16233,32660,16446,16237,32683,11666
2564,36,ชัยภูมิ,3609,อำเภอเทพสถิต,33045,32462,65507,33104,32476,65580,24073
2564,36,ชัยภูมิ,3610,อำเภอภูเขียว,53252,55041,108293,53365,55072,108437,35494
2564,36,ชัยภูมิ,3611,อำเภอบ้านแท่น,20341,20639,40980,20358,20645,41003,11748
2564,36,ชัยภูมิ,3612,อำเภอแก้งคร้อ,36307,36436,72743,36326,36448,72774,25344
2564,36,ชัยภูมิ,3613,อำเภอคอนสาร,20222,20561,40783,20244,20571,40815,14068
2564,36,ชัยภูมิ,3614,อำเภอภักดีชุมพล,15543,15196,30739,15579,15222,30801,12258
2564,36,ชัยภูมิ,3615,อำเภอเนินสง่า,12805,13151,25956,12811,13157,25968,8547
2564,36,ชัยภูมิ,3616,อำเภอซับใหญ่,7933,7700,15633,7943,7704,15647,5762
2564,36,ชัยภูมิ,3653,สาขาตำบลวังชมภู หนองบัวแดง,0,0,0,0,0,0,0
2564,36,ชัยภูมิ,3676,ท้องถิ่นเทศบาลตำบลห้วยยาง,7725,7672,15397,7732,7679,15411,4646
2564,36,ชัยภูมิ,3677,ท้องถิ่นเทศบาลตำบลบ้านเดื่อ,7671,7811,15482,7674,7812,15486,4562
2564,36,ชัยภูมิ,3680,ท้องถิ่นเทศบาลตำบลคอนสาร,1994,2181,4175,1997,2182,4179,1456
2564,36,ชัยภูมิ,3681,ท้องถิ่นเทศบาลตำบลแก้งคร้อ,3978,4454,8432,3985,4458,8443,4606
2564,36,ชัยภูมิ,3682,ท้องถิ่นเทศบาลตำบลนาหนองทุ่ม,5199,5574,10773,5204,5574,10778,3314
2564,36,ชัยภูมิ,3683,ท้องถิ่นเทศบาลตำบลบ้านแท่น,1993,2067,4060,1996,2067,4063,1629
2564,36,ชัยภูมิ,3684,ท้องถิ่นเทศบาลตำบลภูเขียว,2844,3266,6110,2859,3271,6130,3047
2564,36,ชัยภูมิ,3685,ท้องถิ่นเทศบาลตำบลบ้านเพชรภูเขียว,2750,2832,5582,2755,2834,5589,1751
2564,36,ชัยภูมิ,3686,ท้องถิ่นเทศบาลตำบลเทพสถิต,1892,1921,3813,1898,1923,3821,2274
2564,36,ชัยภูมิ,3687,ท้องถิ่นเทศบาลตำบลหนองบัวระเหว,2892,2964,5856,2898,2967,5865,2642
2564,36,ชัยภูมิ,3688,ท้องถิ่นเทศบาลตำบลบำเหน็จณรงค์,3290,3570,6860,3296,3571,6867,3001
2564,36,ชัยภูมิ,3689,ท้องถิ่นเทศบาลตำบลบ้านเพชร,2336,2484,4820,2341,2488,4829,2229
2564,36,ชัยภูมิ,3690,ท้องถิ่นเทศบาลตำบลหนองบัวโคก,948,986,1934,949,986,1935,784
2564,36,ชัยภูมิ,3691,ท้องถิ่นเทศบาลตำบลจัตุรัส,1968,2186,4154,1972,2188,4160,2210
2564,36,ชัยภูมิ,3692,ท้องถิ่นเทศบาลตำบลหนองบัวแดง,4302,4480,8782,4315,4488,8803,4305
2564,36,ชัยภูมิ,3693,ท้องถิ่นเทศบาลตำบลบ้านเป้า,3756,3929,7685,3759,3930,7689,2377
2564,36,ชัยภูมิ,3694,ท้องถิ่นเทศบาลตำบลเกษตรสมบูรณ์,1396,1517,2913,1400,1521,2921,1329
2564,36,ชัยภูมิ,3695,ท้องถิ่นเทศบาลตำบลคอนสวรรค์,1962,2213,4175,1974,2214,4188,1893
2564,36,ชัยภูมิ,3696,ท้องถิ่นเทศบาลตำบลบ้านเขว้า,3810,4177,7987,3816,4178,7994,3415
2564,36,ชัยภูมิ,3697,ท้องถิ่นเทศบาลตำบลลาดใหญ่,2133,2398,4531,2135,2399,4534,1755
2564,36,ชัยภูมิ,3698,ท้องถิ่นเทศบาลตำบลบ้านค่ายหมื่นแผ้ว,2375,2509,4884,2382,2509,4891,1914
2564,36,ชัยภูมิ,3699,ท้องถิ่นเทศบาลเมืองชัยภูมิ,16928,18815,35743,16995,18839,35834,21090
2564,37,อำนาจเจริญ,3701,อำเภอเมืองอำนาจเจริญ,48646,48640,97286,48710,48684,97394,31526
2564,37,อำนาจเจริญ,3702,อำเภอชานุมาน,19296,19129,38425,19424,19348,38772,11835
2564,37,อำนาจเจริญ,3703,อำเภอปทุมราชวงศา,22944,22685,45629,22955,22690,45645,13643
2564,37,อำนาจเจริญ,3704,อำเภอพนา,9659,9503,19162,9661,9504,19165,6746
2564,37,อำนาจเจริญ,3705,อำเภอเสนางคนิคม,17396,17692,35088,17414,17708,35122,10868
2564,37,อำนาจเจริญ,3706,อำเภอหัวตะพาน,21181,21059,42240,21189,21084,42273,11048
2564,37,อำนาจเจริญ,3707,อำเภอลืออำนาจ,16913,17235,34148,16920,17243,34163,9802
2564,37,อำนาจเจริญ,3790,ท้องถิ่นเทศบาลตำบลนายม,2603,2659,5262,2605,2663,5268,1552
2564,37,อำนาจเจริญ,3791,ท้องถิ่นเทศบาลตำบลพระเหลา,2993,2996,5989,2996,2996,5992,2226
2564,37,อำนาจเจริญ,3792,ท้องถิ่นเทศบาลตำบลอำนาจ,997,1131,2128,997,1132,2129,997
2564,37,อำนาจเจริญ,3793,ท้องถิ่นเทศบาลตำบลหัวตะพาน,3309,3479,6788,3312,3486,6798,2221
2564,37,อำนาจเจริญ,3794,ท้องถิ่นเทศบาลตำบลเสนางคนิคม,2743,2950,5693,2750,2956,5706,1972
2564,37,อำนาจเจริญ,3795,ท้องถิ่นเทศบาลตำบลพนา,1261,1437,2698,1263,1437,2700,1117
2564,37,อำนาจเจริญ,3796,ท้องถิ่นเทศบาลตำบลปทุมราชวงศา,1701,1746,3447,1701,1747,3448,1711
2564,37,อำนาจเจริญ,3797,ท้องถิ่นเทศบาลตำบลชานุมาน,1481,1578,3059,1522,1645,3167,1441
2564,37,อำนาจเจริญ,3798,ท้องถิ่นเทศบาลตำบลน้ำปลีก,1804,1960,3764,1810,1961,3771,1246
2564,37,อำนาจเจริญ,3799,ท้องถิ่นเทศบาลเมืองอำนาจเจริญ,11855,12920,24775,11893,12944,24837,12850
2564,38,บึงกาฬ,3801,อำเภอเมืองบึงกาฬ,29349,29144,58493,29432,29232,58664,18867
2564,38,บึงกาฬ,3802,อำเภอพรเจริญ,14528,14350,28878,14537,14352,28889,8230
2564,38,บึงกาฬ,3803,อำเภอโซ่พิสัย,32728,32294,65022,32752,32314,65066,19300
2564,38,บึงกาฬ,3804,อำเภอเซกา,36886,36391,73277,36960,36429,73389,23157
2564,38,บึงกาฬ,3805,อำเภอปากคาด,14091,14066,28157,14121,14088,28209,9691
2564,38,บึงกาฬ,3806,อำเภอบึงโขงหลง,14027,13840,27867,14073,13869,27942,8992
2564,38,บึงกาฬ,3807,อำเภอศรีวิไล,14466,14293,28759,14471,14300,28771,9577
2564,38,บึงกาฬ,3808,อำเภอบุ่งคล้า,7004,6951,13955,7029,7025,14054,4265
2564,38,บึงกาฬ,3887,ท้องถิ่นเทศบาลตำบลหอคำ,3645,3607,7252,3651,3610,7261,2353
2564,38,บึงกาฬ,3888,ท้องถิ่นเทศบาลตำบลโนนสว่าง,3407,3483,6890,3409,3484,6893,2409
2564,38,บึงกาฬ,3889,ท้องถิ่นเทศบาลตำบลวิศิษฐ์,0,0,0,0,0,0,0
2564,38,บึงกาฬ,3890,ท้องถิ่นเทศบาลตำบลศรีวิไล,5478,5480,10958,5485,5482,10967,3940
2564,38,บึงกาฬ,3891,ท้องถิ่นเทศบาลตำบลบึงโขงหลง,4797,4927,9724,4820,4930,9750,3416
2564,38,บึงกาฬ,3892,ท้องถิ่นเทศบาลตำบลปากคาด,3306,3303,6609,3313,3306,6619,2733
2564,38,บึงกาฬ,3893,ท้องถิ่นเทศบาลตำบลศรีพนา,3276,3339,6615,3290,3340,6630,2713
2564,38,บึงกาฬ,3894,ท้องถิ่นเทศบาลตำบลท่าสะอาด,3384,3462,6846,3386,3469,6855,2007
2564,38,บึงกาฬ,3895,ท้องถิ่นเทศบาลตำบลโซ่พิสัย,3259,3262,6521,3269,3266,6535,2601
2564,38,บึงกาฬ,3896,ท้องถิ่นเทศบาลตำบลพรเจริญ,5039,5269,10308,5047,5280,10327,3560
2564,38,บึงกาฬ,3897,ท้องถิ่นเทศบาลตำบลดอนหญ้านาง,2523,2546,5069,2525,2547,5072,1508
2564,38,บึงกาฬ,3898,ท้องถิ่นเทศบาลเมืองบึงกาฬ,9882,10133,20015,9924,10178,20102,11193
2564,39,หนองบัวลำภู,3901,อำเภอเมืองหนองบัวลำภู,51056,50996,102052,51148,51027,102175,31401
2564,39,หนองบัวลำภู,3902,อำเภอนากลาง,33554,33252,66806,33605,33261,66866,18752
2564,39,หนองบัวลำภู,3903,อำเภอโนนสัง,26768,27112,53880,26793,27121,53914,13770
2564,39,หนองบัวลำภู,3904,อำเภอศรีบุญเรือง,45510,44851,90361,45577,44862,90439,25253
2564,39,หนองบัวลำภู,3905,อำเภอสุวรรณคูหา,26952,26864,53816,26984,26877,53861,15216
2564,39,หนองบัวลำภู,3906,อำเภอนาวัง,15181,15155,30336,15209,15165,30374,8742
2564,39,หนองบัวลำภู,3986,ท้องถิ่นเทศบาลตำบลยางหล่อ,4585,4676,9261,4588,4680,9268,2592
2564,39,หนองบัวลำภู,3987,ท้องถิ่นเทศบาลตำบลนาเหล่า,3353,3537,6890,3364,3539,6903,2430
2564,39,หนองบัวลำภู,3988,ท้องถิ่นเทศบาลตำบลสุวรรณคูหา,3785,3954,7739,3799,3956,7755,2875
2564,39,หนองบัวลำภู,3989,ท้องถิ่นเทศบาลตำบลบ้านโคก,3000,3279,6279,3008,3281,6289,1897
2564,39,หนองบัวลำภู,3990,ท้องถิ่นเทศบาลตำบลโนนสูงเปลือย,2223,2452,4675,2233,2456,4689,2635
2564,39,หนองบัวลำภู,3991,ท้องถิ่นเทศบาลตำบลจอมทอง,2525,2480,5005,2530,2482,5012,1522
2564,39,หนองบัวลำภู,3992,ท้องถิ่นเทศบาลตำบลโนนสัง,4135,4262,8397,4150,4265,8415,2840
2564,39,หนองบัวลำภู,3993,ท้องถิ่นเทศบาลตำบลกุดดู่,1375,1365,2740,1380,1365,2745,747
2564,39,หนองบัวลำภู,3994,ท้องถิ่นเทศบาลตำบลนากลาง,9829,10223,20052,9853,10228,20081,6680
2564,39,หนองบัวลำภู,3995,ท้องถิ่นเทศบาลตำบลกุดดินจี่,2727,2855,5582,2735,2855,5590,1835
2564,39,หนองบัวลำภู,3996,ท้องถิ่นเทศบาลตำบลหัวนา,1804,1793,3597,1808,1793,3601,1050
2564,39,หนองบัวลำภู,3997,ท้องถิ่นเทศบาลตำบลนามะเฟือง,1999,2140,4139,2005,2141,4146,1092
2564,39,หนองบัวลำภู,3998,ท้องถิ่นเทศบาลตำบลนาคำไฮ,2463,2501,4964,2472,2503,4975,1436
2564,39,หนองบัวลำภู,3999,ท้องถิ่นเทศบาลเมืองหนองบัวลำภู,10462,11356,21818,10516,11387,21903,12147
2564,40,ขอนแก่น,4001,อำเภอเมืองขอนแก่น,73110,76431,149541,73361,76486,149847,67991
2564,40,ขอนแก่น,4002,อำเภอบ้านฝาง,25029,25303,50332,25069,25310,50379,17432
2564,40,ขอนแก่น,4003,อำเภอพระยืน,12148,12711,24859,12168,12714,24882,7702
2564,40,ขอนแก่น,4004,อำเภอหนองเรือ,41208,42308,83516,41239,42321,83560,23207
2564,40,ขอนแก่น,4005,อำเภอชุมแพ,41804,41647,83451,41891,41663,83554,26002
2564,40,ขอนแก่น,4006,อำเภอสีชมพู,36610,37187,73797,36668,37197,73865,22555
2564,40,ขอนแก่น,4007,อำเภอน้ำพอง,36318,36876,73194,36352,36898,73250,22225
2564,40,ขอนแก่น,4008,อำเภออุบลรัตน์,15494,15900,31394,15513,15908,31421,8333
2564,40,ขอนแก่น,4009,อำเภอกระนวน,33859,34396,68255,33912,34401,68313,20390
2564,40,ขอนแก่น,4010,อำเภอบ้านไผ่,35814,36487,72301,35852,36493,72345,23118
2564,40,ขอนแก่น,4011,อำเภอเปือยน้อย,7202,7034,14236,7207,7037,14244,3914
2564,40,ขอนแก่น,4012,อำเภอพล,37346,38258,75604,37374,38271,75645,22961
2564,40,ขอนแก่น,4013,อำเภอแวงใหญ่,11963,12182,24145,11969,12190,24159,6457
2564,40,ขอนแก่น,4014,อำเภอแวงน้อย,19269,19399,38668,19282,19404,38686,11440
2564,40,ขอนแก่น,4015,อำเภอหนองสองห้อง,35258,35758,71016,35294,35776,71070,20852
2564,40,ขอนแก่น,4016,อำเภอภูเวียง,34207,34672,68879,34245,34685,68930,20551
2564,40,ขอนแก่น,4017,อำเภอมัญจาคีรี,32967,33592,66559,32995,33600,66595,21884
2564,40,ขอนแก่น,4018,อำเภอชนบท,19510,20254,39764,19530,20260,39790,11724
2564,40,ขอนแก่น,4019,อำเภอเขาสวนกวาง,10698,10727,21425,10721,10729,21450,6439
2564,40,ขอนแก่น,4020,อำเภอภูผาม่าน,9825,9772,19597,9833,9777,19610,5863
2564,40,ขอนแก่น,4021,อำเภอซำสูง,8977,9241,18218,8983,9244,18227,5318
2564,40,ขอนแก่น,4022,อำเภอโคกโพธิ์ไชย,10542,10567,21109,10551,10574,21125,6654
2564,40,ขอนแก่น,4023,อำเภอหนองนาคำ,11767,11940,23707,11781,11944,23725,6753
2564,40,ขอนแก่น,4024,อำเภอบ้านแฮด,12925,13178,26103,12935,13185,26120,8346
2564,40,ขอนแก่น,4025,อำเภอโนนศิลา,10493,10554,21047,10495,10557,21052,6491
2564,40,ขอนแก่น,4029,อำเภอเวียงเก่า,9857,10050,19907,9863,10051,19914,5696
2564,40,ขอนแก่น,4055,ท้องถิ่นเทศบาลตำบลโคกสูง,4472,4358,8830,4494,4363,8857,2469
2564,40,ขอนแก่น,4056,ท้องถิ่นเทศบาลตำบลสะอาด,4966,5027,9993,4971,5029,10000,2706
2564,40,ขอนแก่น,4057,ท้องถิ่นเทศบาลเมืองบ้านทุ่ม,9065,9755,18820,9102,9765,18867,8572
2564,40,ขอนแก่น,4058,ท้องถิ่นเทศบาลตำบลโนนสมบูรณ์,2952,2964,5916,2956,2965,5921,1779
2564,40,ขอนแก่น,4060,ท้องถิ่นเทศบาลตำบลม่วงหวาน,5002,5175,10177,5010,5177,10187,3539
2564,40,ขอนแก่น,4061,ท้องถิ่นเทศบาลตำบลหนองตูม,3694,3978,7672,3701,3980,7681,2229
2564,40,ขอนแก่น,4062,ท้องถิ่นเทศบาลตำบลเมืองเก่า,14537,16793,31330,14721,16810,31531,17412
2564,40,ขอนแก่น,4063,ท้องถิ่นเทศบาลตำบลโนนท่อน,4825,4977,9802,4827,4979,9806,3158
2564,40,ขอนแก่น,4064,ท้องถิ่นเทศบาลตำบลบ้านค้อ,8438,8689,17127,8451,8693,17144,6896
2564,40,ขอนแก่น,4065,ท้องถิ่นเทศบาลตำบลกุดน้ำใส,4165,4329,8494,4177,4338,8515,2635
2564,40,ขอนแก่น,4067,ท้องถิ่นเทศบาลตำบลสาวะถี,8920,9191,18111,8940,9202,18142,5780
2564,40,ขอนแก่น,4068,ท้องถิ่นเทศบาลเมืองบ้านเป็ด,21313,24600,45913,21557,24636,46193,27738
2564,40,ขอนแก่น,4069,ท้องถิ่นเทศบาลตำบลโนนศิลา,2815,2779,5594,2816,2782,5598,1820
2564,40,ขอนแก่น,4070,ท้องถิ่นเทศบาลตำบลบ้านแฮด,3288,3361,6649,3291,3363,6654,2262
2564,40,ขอนแก่น,4071,ท้องถิ่นเทศบาลตำบลบ้านโคก,1975,2134,4109,1976,2135,4111,1467
2564,40,ขอนแก่น,4072,ท้องถิ่นเทศบาลตำบลซำสูง,2569,2691,5260,2572,2692,5264,1927
2564,40,ขอนแก่น,4073,ท้องถิ่นเทศบาลตำบลภูผาม่าน,1685,1778,3463,1686,1779,3465,1284
2564,40,ขอนแก่น,4074,ท้องถิ่นเทศบาลตำบลเขาสวนกวาง,5343,5440,10783,5359,5448,10807,3731
2564,40,ขอนแก่น,4075,ท้องถิ่นเทศบาลตำบลชนบท,3727,4198,7925,3732,4199,7931,3328
2564,40,ขอนแก่น,4076,ท้องถิ่นเทศบาลตำบลมัญจาคีรี,1671,1863,3534,1676,1866,3542,1934
2564,40,ขอนแก่น,4077,ท้องถิ่นเทศบาลตำบลภูเวียง,1401,1552,2953,1406,1554,2960,1745
2564,40,ขอนแก่น,4078,ท้องถิ่นเทศบาลตำบลหนองสองห้อง,2826,2932,5758,2834,2935,5769,2774
2564,40,ขอนแก่น,4079,ท้องถิ่นเทศบาลตำบลแวงน้อย,1471,1599,3070,1471,1600,3071,1327
2564,40,ขอนแก่น,4080,ท้องถิ่นเทศบาลตำบลแวงใหญ่,2472,2677,5149,2478,2678,5156,1774
2564,40,ขอนแก่น,4081,ท้องถิ่นเทศบาลตำบลเปือยน้อย,2835,3016,5851,2841,3017,5858,1998
2564,40,ขอนแก่น,4082,ท้องถิ่นเทศบาลเมืองกระนวน,4716,5159,9875,4745,5168,9913,4533
2564,40,ขอนแก่น,4083,ท้องถิ่นเทศบาลตำบลเขื่อนอุบลรัตน์,1976,2063,4039,1985,2064,4049,2108
2564,40,ขอนแก่น,4084,ท้องถิ่นเทศบาลตำบลวังชัย,3065,3284,6349,3072,3285,6357,2915
2564,40,ขอนแก่น,4085,ท้องถิ่นเทศบาลตำบลน้ำพอง,2343,2548,4891,2351,2551,4902,2442
2564,40,ขอนแก่น,4086,ท้องถิ่นเทศบาลตำบลสีชมพู,1647,1703,3350,1658,1704,3362,1558
2564,40,ขอนแก่น,4087,ท้องถิ่นเทศบาลตำบลโนนหัน,2178,2415,4593,2185,2417,4602,1538
2564,40,ขอนแก่น,4088,ท้องถิ่นเทศบาลตำบลโคกสูงสัมพันธ์,2065,2310,4375,2078,2310,4388,1320
2564,40,ขอนแก่น,4089,ท้องถิ่นเทศบาลตำบลหนองเรือ,2118,2112,4230,2126,2116,4242,2176
2564,40,ขอนแก่น,4090,ท้องถิ่นเทศบาลตำบลหนองแก,718,703,1421,719,705,1424,699
2564,40,ขอนแก่น,4091,ท้องถิ่นเทศบาลตำบลดอนโมง,1680,1738,3418,1686,1740,3426,1837
2564,40,ขอนแก่น,4092,ท้องถิ่นเทศบาลตำบลพระยืน,1583,1728,3311,1584,1732,3316,1491
2564,40,ขอนแก่น,4093,ท้องถิ่นเทศบาลตำบลบ้านโต้น,3117,3361,6478,3126,3362,6488,2049
2564,40,ขอนแก่น,4094,ท้องถิ่นเทศบาลตำบลบ้านฝาง,2194,2330,4524,2212,2342,4554,1846
2564,40,ขอนแก่น,4095,ท้องถิ่นเทศบาลตำบลท่าพระ,4202,4618,8820,4225,4622,8847,4111
2564,40,ขอนแก่น,4096,ท้องถิ่นเทศบาลเมืองชุมแพ,14860,16135,30995,15014,16183,31197,15683
2564,40,ขอนแก่น,4097,ท้องถิ่นเทศบาลเมืองบ้านไผ่,12869,14069,26938,13083,14176,27259,12818
2564,40,ขอนแก่น,4098,ท้องถิ่นเทศบาลเมืองเมืองพล,4927,5432,10359,4937,5441,10378,5410
2564,40,ขอนแก่น,4099,ท้องถิ่นเทศบาลนครขอนแก่น,50318,56035,106353,50935,56436,107371,67228
2564,41,อุดรธานี,4101,อำเภอเมืองอุดรธานี,89885,94481,184366,90377,94570,184947,72248
2564,41,อุดรธานี,4102,อำเภอกุดจับ,21926,21797,43723,22006,21818,43824,13313
2564,41,อุดรธานี,4103,อำเภอหนองวัวซอ,22380,22421,44801,22444,22432,44876,11752
2564,41,อุดรธานี,4104,อำเภอกุมภวาปี,36771,37408,74179,36844,37432,74276,21806
2564,41,อุดรธานี,4105,อำเภอโนนสะอาด,22551,22699,45250,22585,22713,45298,12162
2564,41,อุดรธานี,4106,อำเภอหนองหาน,44305,44428,88733,44381,44461,88842,27539
2564,41,อุดรธานี,4107,อำเภอทุ่งฝน,12626,12398,25024,12664,12407,25071,7279
2564,41,อุดรธานี,4108,อำเภอไชยวาน,12038,11774,23812,12056,11778,23834,6084
2564,41,อุดรธานี,4109,อำเภอศรีธาตุ,11807,11916,23723,11817,11919,23736,6711
2564,41,อุดรธานี,4110,อำเภอวังสามหมอ,15795,15562,31357,15802,15573,31375,8832
2564,41,อุดรธานี,4111,อำเภอบ้านดุง,55758,55711,111469,55893,55749,111642,32855
2564,41,อุดรธานี,4117,อำเภอบ้านผือ,51112,51034,102146,51167,51065,102232,31259
2564,41,อุดรธานี,4118,อำเภอน้ำโสม,20770,20335,41105,20807,20360,41167,13398
2564,41,อุดรธานี,4119,อำเภอเพ็ญ,48119,48220,96339,48205,48250,96455,29608
2564,41,อุดรธานี,4120,อำเภอสร้างคอม,10971,10939,21910,10985,10947,21932,6625
2564,41,อุดรธานี,4121,อำเภอหนองแสง,11550,11638,23188,11593,11643,23236,6851
2564,41,อุดรธานี,4122,อำเภอนายูง,14474,14184,28658,14487,14191,28678,9841
2564,41,อุดรธานี,4123,อำเภอพิบูลย์รักษ์,12269,12402,24671,12287,12410,24697,8417
2564,41,อุดรธานี,4124,อำเภอกู่แก้ว,11099,10943,22042,11117,10948,22065,6899
2564,41,อุดรธานี,4125,อำเภอประจักษ์ศิลปาคม,12751,12736,25487,12789,12747,25536,7330
2564,41,อุดรธานี,4158,ท้องถิ่นเทศบาลตำบลหนองหว้า,4065,4107,8172,4074,4107,8181,2037
2564,41,อุดรธานี,4159,ท้องถิ่นเทศบาลตำบลหัวนาคำ,5743,5572,11315,5744,5574,11318,3194
2564,41,อุดรธานี,4160,ท้องถิ่นเทศบาลตำบลผาสุก,8048,7758,15806,8059,7765,15824,4787
2564,41,อุดรธานี,4161,ท้องถิ่นเทศบาลตำบลโพนสูง,3758,3676,7434,3758,3676,7434,1882
2564,41,อุดรธานี,4162,ท้องถิ่นเทศบาลตำบลจำปี,4135,4058,8193,4137,4060,8197,2185
2564,41,อุดรธานี,4163,ท้องถิ่นเทศบาลตำบลสร้างคอม,3600,3737,7337,3605,3740,7345,2666
2564,41,อุดรธานี,4164,ท้องถิ่นเทศบาลตำบลบ้านธาตุ,8240,8562,16802,8274,8581,16855,5186
2564,41,อุดรธานี,4165,ท้องถิ่นเทศบาลตำบลเวียงคำ,5209,5284,10493,5216,5286,10502,3229
2564,41,อุดรธานี,4166,ท้องถิ่นเทศบาลตำบลลำพันชาด,2828,2764,5592,2830,2764,5594,2041
2564,41,อุดรธานี,4167,ท้องถิ่นเทศบาลตำบลหนองไผ่,4646,4760,9406,4659,4766,9425,2753
2564,41,อุดรธานี,4168,ท้องถิ่นเทศบาลตำบลหนองไผ่,4063,4716,8779,4075,4720,8795,2729
2564,41,อุดรธานี,4169,ท้องถิ่นเทศบาลตำบลปะโค,5621,5643,11264,5634,5645,11279,3454
2564,41,อุดรธานี,4170,ท้องถิ่นเทศบาลตำบลแสงสว่าง,1998,2001,3999,2011,2001,4012,976
2564,41,อุดรธานี,4171,ท้องถิ่นเทศบาลตำบลเพ็ญ,1360,1373,2733,1364,1374,2738,1600
2564,41,อุดรธานี,4172,ท้องถิ่นเทศบาลตำบลน้ำโสม,4225,4383,8608,4226,4384,8610,2573
2564,41,อุดรธานี,4173,ท้องถิ่นเทศบาลตำบลนางัว,4440,4560,9000,4458,4567,9025,3453
2564,41,อุดรธานี,4174,ท้องถิ่นเทศบาลตำบลบ้านผือ,3648,3904,7552,3659,3920,7579,4104
2564,41,อุดรธานี,4175,ท้องถิ่นเทศบาลเมืองบ้านดุง,7314,7956,15270,7372,7979,15351,6394
2564,41,อุดรธานี,4176,ท้องถิ่นเทศบาลตำบลวังสามหมอ,2896,3068,5964,2900,3070,5970,2848
2564,41,อุดรธานี,4177,ท้องถิ่นเทศบาลตำบลศรีธาตุ,2665,2741,5406,2667,2741,5408,1910
2564,41,อุดรธานี,4178,ท้องถิ่นเทศบาลตำบลไชยวาน,4029,4222,8251,4036,4224,8260,2400
2564,41,อุดรธานี,4179,ท้องถิ่นเทศบาลตำบลทุ่งฝน,3410,3721,7131,3423,3725,7148,2206
2564,41,อุดรธานี,4180,ท้องถิ่นเทศบาลตำบลหนองหาน,1977,2203,4180,1987,2209,4196,1896
2564,41,อุดรธานี,4181,ท้องถิ่นเทศบาลตำบลหนองเม็ก,4064,4124,8188,4079,4127,8206,2279
2564,41,อุดรธานี,4182,ท้องถิ่นเทศบาลตำบลบ้านเชียง,2897,2938,5835,2918,2942,5860,1988
2564,41,อุดรธานี,4183,ท้องถิ่นเทศบาลตำบลโนนสะอาด,2166,2269,4435,2169,2270,4439,1747
2564,41,อุดรธานี,4184,ท้องถิ่นเทศบาลตำบลห้วยเกิ้ง,2561,2666,5227,2572,2666,5238,1700
2564,41,อุดรธานี,4185,ท้องถิ่นเทศบาลตำบลพันดอน,2603,2876,5479,2616,2892,5508,2660
2564,41,อุดรธานี,4186,ท้องถิ่นเทศบาลตำบลกุมภวาปี,3880,4217,8097,3915,4233,8148,4491
2564,41,อุดรธานี,4187,ท้องถิ่นเทศบาลตำบลภูผาแดง,3938,4132,8070,3963,4138,8101,2369
2564,41,อุดรธานี,4188,ท้องถิ่นเทศบาลตำบลหนองวัวซอ,4644,4892,9536,4675,4896,9571,2887
2564,41,อุดรธานี,4189,ท้องถิ่นเทศบาลตำบลสร้างก่อ,1981,1975,3956,1982,1975,3957,1090
2564,41,อุดรธานี,4190,ท้องถิ่นเทศบาลตำบลตาลเลียน,1864,1842,3706,1865,1842,3707,884
2564,41,อุดรธานี,4191,ท้องถิ่นเทศบาลตำบลเชียงเพ็ง,1981,2018,3999,1982,2018,4000,1181
2564,41,อุดรธานี,4192,ท้องถิ่นเทศบาลตำบลกุดจับ,4907,5236,10143,4932,5239,10171,3922
2564,41,อุดรธานี,4193,ท้องถิ่นเทศบาลตำบลหนองบัว,15326,17198,32524,15731,17257,32988,16104
2564,41,อุดรธานี,4194,ท้องถิ่นเทศบาลเมืองหนองสำโรง,13944,15044,28988,14138,15096,29234,15126
2564,41,อุดรธานี,4195,ท้องถิ่นเทศบาลตำบลบ้านจั่น,3209,3766,6975,3262,3774,7036,3370
2564,41,อุดรธานี,4196,ท้องถิ่นเทศบาลเมืองโนนสูง-น้ำคำ,4534,3945,8479,4561,3952,8513,3572
2564,41,อุดรธานี,4197,ท้องถิ่นเทศบาลตำบลนิคมสงเคราะห์,1780,1895,3675,1792,1896,3688,1315
2564,41,อุดรธานี,4198,ท้องถิ่นเทศบาลตำบลนาข่า,3076,3302,6378,3086,3306,6392,2615
2564,41,อุดรธานี,4199,ท้องถิ่นเทศบาลนครอุดรธานี,54265,60473,114738,56645,62343,118988,61665
2564,42,เลย,4201,อำเภอเมืองเลย,30113,29119,59232,30199,29212,59411,23952
2564,42,เลย,4202,อำเภอนาด้วง,4915,4865,9780,4951,4901,9852,3658
2564,42,เลย,4203,อำเภอเชียงคาน,18710,18646,37356,18979,19216,38195,14168
2564,42,เลย,4204,อำเภอปากชม,16917,16264,33181,17110,16533,33643,11343
2564,42,เลย,4205,อำเภอด่านซ้าย,24387,23777,48164,24455,23852,48307,16248
2564,42,เลย,4206,อำเภอนาแห้ว,4815,4798,9613,4843,4832,9675,3110
2564,42,เลย,4207,อำเภอภูเรือ,9969,9592,19561,10048,9721,19769,7339
2564,42,เลย,4208,อำเภอท่าลี่,12576,12252,24828,13013,12992,26005,10081
2564,42,เลย,4209,อำเภอวังสะพุง,49746,50406,100152,49803,50453,100256,34405
2564,42,เลย,4210,อำเภอภูกระดึง,13776,13583,27359,13788,13593,27381,8824
2564,42,เลย,4211,อำเภอภูหลวง,12646,12379,25025,12656,12390,25046,7833
2564,42,เลย,4212,อำเภอผาขาว,15503,15429,30932,15516,15437,30953,8501
2564,42,เลย,4213,อำเภอเอราวัณ,16959,17005,33964,16987,17017,34004,11526
2564,42,เลย,4214,อำเภอหนองหิน,10372,10155,20527,10391,10172,20563,6126
2564,42,เลย,4279,ท้องถิ่นเทศบาลตำบลโนนปอแดง,5555,5535,11090,5564,5538,11102,3490
2564,42,เลย,4280,ท้องถิ่นเทศบาลตำบลนาดอกคำ,5051,4862,9913,5076,4896,9972,3058
2564,42,เลย,4281,ท้องถิ่นเทศบาลตำบลธาตุ,4791,4836,9627,4815,4885,9700,3435
2564,42,เลย,4282,ท้องถิ่นเทศบาลตำบลนาดินดำ,5330,5275,10605,5340,5297,10637,3714
2564,42,เลย,4283,ท้องถิ่นเทศบาลตำบลนาโป่ง,5118,5177,10295,5122,5181,10303,3511
2564,42,เลย,4284,ท้องถิ่นเทศบาลตำบลนาอาน,6298,6505,12803,6318,6517,12835,5996
2564,42,เลย,4285,ท้องถิ่นเทศบาลตำบลเขาแก้ว,3908,3864,7772,3915,3878,7793,2176
2564,42,เลย,4286,ท้องถิ่นเทศบาลตำบลหนองหิน,2166,2255,4421,2169,2256,4425,2048
2564,42,เลย,4287,ท้องถิ่นเทศบาลตำบลภูกระดึง,3543,3599,7142,3546,3599,7145,2745
2564,42,เลย,4288,ท้องถิ่นเทศบาลเมืองวังสะพุง,5200,5641,10841,5210,5650,10860,4553
2564,42,เลย,4289,ท้องถิ่นเทศบาลตำบลท่าลี่,912,1003,1915,915,1012,1927,818
2564,42,เลย,4290,ท้องถิ่นเทศบาลตำบลภูเรือ,1410,1383,2793,1426,1392,2818,1587
2564,42,เลย,4291,ท้องถิ่นเทศบาลตำบลนาแห้ว,1012,972,1984,1019,995,2014,907
2564,42,เลย,4292,ท้องถิ่นเทศบาลตำบลด่านซ้าย,1652,1731,3383,1654,1732,3386,1963
2564,42,เลย,4293,ท้องถิ่นเทศบาลตำบลปากชม,1659,1736,3395,1684,1784,3468,1565
2564,42,เลย,4294,ท้องถิ่นเทศบาลตำบลเชียงกลม,2539,2588,5127,2552,2613,5165,1631
2564,42,เลย,4295,ท้องถิ่นเทศบาลตำบลเชียงคาน,2446,2639,5085,2470,2670,5140,2774
2564,42,เลย,4296,ท้องถิ่นเทศบาลตำบลนาด้วง,3284,3305,6589,3294,3314,6608,2379
2564,42,เลย,4297,ท้องถิ่นเทศบาลตำบลน้ำสวย,1770,1803,3573,1772,1807,3579,1228
2564,42,เลย,4298,ท้องถิ่นเทศบาลตำบลนาอ้อ,2953,3103,6056,2960,3107,6067,2288
2564,42,เลย,4299,ท้องถิ่นเทศบาลเมืองเลย,10335,10271,20606,10389,10339,20728,11783
2564,43,หนองคาย,4301,อำเภอเมืองหนองคาย,36944,37583,74527,37155,37845,75000,24580
2564,43,หนองคาย,4302,อำเภอท่าบ่อ,30098,30924,61022,30196,31054,61250,18735
2564,43,หนองคาย,4305,อำเภอโพนพิสัย,47401,47814,95215,47568,48073,95641,31934
2564,43,หนองคาย,4307,อำเภอศรีเชียงใหม่,11481,11733,23214,11600,11878,23478,7449
2564,43,หนองคาย,4308,อำเภอสังคม,11281,10967,22248,11307,11011,22318,7274
2564,43,หนองคาย,4314,อำเภอสระใคร,13336,13180,26516,13355,13210,26565,8427
2564,43,หนองคาย,4315,อำเภอเฝ้าไร่,19914,19935,39849,19943,19944,39887,11514
2564,43,หนองคาย,4316,อำเภอรัตนวาปี,19072,18957,38029,19084,18973,38057,13118
2564,43,หนองคาย,4317,อำเภอโพธิ์ตาก,7607,7563,15170,7629,7617,15246,5158
2564,43,หนองคาย,4378,ท้องถิ่นเทศบาลตำบลเฝ้าไร่,5456,5506,10962,5463,5508,10971,4029
2564,43,หนองคาย,4381,ท้องถิ่นเทศบาลตำบลโพธิ์ชัย,3778,4005,7783,3796,4026,7822,3848
2564,43,หนองคาย,4382,ท้องถิ่นเทศบาลตำบลหาดคำ,4514,4583,9097,4622,4784,9406,3002
2564,43,หนองคาย,4388,ท้องถิ่นเทศบาลตำบลสังคม,1623,1683,3306,1627,1688,3315,1448
2564,43,หนองคาย,4389,ท้องถิ่นเทศบาลตำบลศรีเชียงใหม่,3079,3194,6273,3125,3238,6363,2843
2564,43,หนองคาย,4391,ท้องถิ่นเทศบาลตำบลโพนพิสัย,1296,1299,2595,1305,1312,2617,1230
2564,43,หนองคาย,4395,ท้องถิ่นเทศบาลตำบลโพนสา,1736,1959,3695,1746,1978,3724,1157
2564,43,หนองคาย,4396,ท้องถิ่นเทศบาลเมืองท่าบ่อ,8331,8779,17110,8423,8885,17308,7374
2564,43,หนองคาย,4397,ท้องถิ่นเทศบาลตำบลหนองสองห้อง,2590,2628,5218,2628,2637,5265,2077
2564,43,หนองคาย,4398,ท้องถิ่นเทศบาลตำบลเวียงคุก,2832,3080,5912,2844,3093,5937,1920
2564,43,หนองคาย,4399,ท้องถิ่นเทศบาลเมืองหนองคาย,21637,22677,44314,22852,23821,46673,24635
2564,44,มหาสารคาม,4401,อำเภอเมืองมหาสารคาม,49812,52139,101951,49897,52158,102055,36315
2564,44,มหาสารคาม,4402,อำเภอแกดำ,12235,12146,24381,12242,12148,24390,6600
2564,44,มหาสารคาม,4403,อำเภอโกสุมพิสัย,53929,55658,109587,53984,55681,109665,31784
2564,44,มหาสารคาม,4404,อำเภอกันทรวิชัย,27306,28320,55626,27333,28329,55662,16467
2564,44,มหาสารคาม,4405,อำเภอเชียงยืน,27552,28344,55896,27586,28355,55941,18209
2564,44,มหาสารคาม,4406,อำเภอบรบือ,50581,50858,101439,50620,50878,101498,34424
2564,44,มหาสารคาม,4407,อำเภอนาเชือก,28482,28617,57099,28496,28629,57125,17392
2564,44,มหาสารคาม,4408,อำเภอพยัคฆภูมิพิสัย,39542,40030,79572,39554,40043,79597,22089
2564,44,มหาสารคาม,4409,อำเภอวาปีปทุม,53372,54077,107449,53409,54096,107505,30705
2564,44,มหาสารคาม,4410,อำเภอนาดูน,16274,16339,32613,16283,16353,32636,8702
2564,44,มหาสารคาม,4411,อำเภอยางสีสุราช,17416,17623,35039,17422,17632,35054,9809
2564,44,มหาสารคาม,4412,อำเภอกุดรัง,18599,18429,37028,18618,18435,37053,10708
2564,44,มหาสารคาม,4413,อำเภอชื่นชม,12110,12502,24612,12118,12510,24628,6999
2564,44,มหาสารคาม,4487,ท้องถิ่นเทศบาลตำบลขามเรียง,6139,8606,14745,6156,8610,14766,5698
2564,44,มหาสารคาม,4488,ท้องถิ่นเทศบาลตำบลท่าขอนยาง,4259,4597,8856,4267,4601,8868,6489
2564,44,มหาสารคาม,4489,ท้องถิ่นเทศบาลตำบลนาดูน,2395,2356,4751,2397,2357,4754,1816
2564,44,มหาสารคาม,4490,ท้องถิ่นเทศบาลตำบลวาปีปทุม,2225,2475,4700,2230,2479,4709,2380
2564,44,มหาสารคาม,4491,ท้องถิ่นเทศบาลตำบลพยัคฆภูมิพิสัย,3773,4203,7976,3783,4209,7992,4258
2564,44,มหาสารคาม,4492,ท้องถิ่นเทศบาลตำบลนาเชือก,1826,1943,3769,1829,1943,3772,2115
2564,44,มหาสารคาม,4493,ท้องถิ่นเทศบาลตำบลบรบือ,2563,3015,5578,2569,3017,5586,2336
2564,44,มหาสารคาม,4494,ท้องถิ่นเทศบาลตำบลเชียงยืน,2265,2399,4664,2269,2402,4671,2397
2564,44,มหาสารคาม,4495,ท้องถิ่นเทศบาลตำบลกันทรวิชัย,1595,1783,3378,1601,1783,3384,1476
2564,44,มหาสารคาม,4496,ท้องถิ่นเทศบาลตำบลโกสุมพิสัย,4348,4785,9133,4364,4787,9151,4332
2564,44,มหาสารคาม,4497,ท้องถิ่นเทศบาลตำบลแกดำ,2675,2664,5339,2677,2664,5341,1617
2564,44,มหาสารคาม,4498,ท้องถิ่นเทศบาลตำบลแวงน่าง,2709,2896,5605,2716,2896,5612,2226
2564,44,มหาสารคาม,4499,ท้องถิ่นเทศบาลเมืองมหาสารคาม,20478,26281,46759,20556,26339,46895,21604
2564,45,ร้อยเอ็ด,4501,อำเภอเมืองร้อยเอ็ด,54158,56113,110271,54321,56156,110477,41807
2564,45,ร้อยเอ็ด,4502,อำเภอเกษตรวิสัย,36660,36770,73430,36677,36778,73455,21087
2564,45,ร้อยเอ็ด,4503,อำเภอปทุมรัตต์,23442,23828,47270,23452,23834,47286,12971
2564,45,ร้อยเอ็ด,4504,อำเภอจตุรพักตรพิมาน,25294,25650,50944,25314,25664,50978,13912
2564,45,ร้อยเอ็ด,4505,อำเภอธวัชบุรี,18727,18727,37454,18745,18737,37482,11413
2564,45,ร้อยเอ็ด,4506,อำเภอพนมไพร,30009,30232,60241,30027,30243,60270,17899
2564,45,ร้อยเอ็ด,4507,อำเภอโพนทอง,47998,48563,96561,48050,48583,96633,28778
2564,45,ร้อยเอ็ด,4508,อำเภอโพธิ์ชัย,13454,13581,27035,13459,13585,27044,7539
2564,45,ร้อยเอ็ด,4509,อำเภอหนองพอก,30059,29933,59992,30087,29947,60034,16633
2564,45,ร้อยเอ็ด,4510,อำเภอเสลภูมิ,44672,45302,89974,44692,45325,90017,25231
2564,45,ร้อยเอ็ด,4511,อำเภอสุวรรณภูมิ,52273,52988,105261,52311,53011,105322,29971
2564,45,ร้อยเอ็ด,4512,อำเภอเมืองสรวง,6787,6823,13610,6794,6830,13624,3786
2564,45,ร้อยเอ็ด,4513,อำเภอโพนทราย,11184,11200,22384,11191,11203,22394,5192
2564,45,ร้อยเอ็ด,4514,อำเภออาจสามารถ,34781,34867,69648,34807,34883,69690,19076
2564,45,ร้อยเอ็ด,4515,อำเภอเมยวดี,11411,11729,23140,11417,11737,23154,6974
2564,45,ร้อยเอ็ด,4516,อำเภอศรีสมเด็จ,18597,17338,35935,18619,17348,35967,11127
2564,45,ร้อยเอ็ด,4517,อำเภอจังหาร,18893,19476,38369,18910,19486,38396,12230
2564,45,ร้อยเอ็ด,4518,อำเภอเชียงขวัญ,13420,13919,27339,13438,13927,27365,8270
2564,45,ร้อยเอ็ด,4519,อำเภอหนองฮี,12159,12205,24364,12164,12211,24375,6543
2564,45,ร้อยเอ็ด,4520,อำเภอทุ่งเขาหลวง,11458,11712,23170,11473,11716,23189,6499
2564,45,ร้อยเอ็ด,4565,ท้องถิ่นเทศบาลตำบลนิเวศน์,3329,3422,6751,3341,3426,6767,3051
2564,45,ร้อยเอ็ด,4566,ท้องถิ่นเทศบาลตำบลมะอึ,2590,2750,5340,2599,2751,5350,2139
2564,45,ร้อยเอ็ด,4569,ท้องถิ่นเทศบาลตำบลโพธิ์ชัย,3329,3353,6682,3330,3354,6684,1754
2564,45,ร้อยเอ็ด,4570,ท้องถิ่นเทศบาลตำบลดินดำ,3375,3473,6848,3378,3474,6852,2015
2564,45,ร้อยเอ็ด,4571,ท้องถิ่นเทศบาลตำบลเมืองไพร,3154,3084,6238,3157,3084,6241,1600
2564,45,ร้อยเอ็ด,4572,ท้องถิ่นเทศบาลตำบลขวาว,4367,4526,8893,4369,4528,8897,2216
2564,45,ร้อยเอ็ด,4573,ท้องถิ่นเทศบาลตำบลดงแดง,4276,4465,8741,4277,4470,8747,2435
2564,45,ร้อยเอ็ด,4574,ท้องถิ่นเทศบาลตำบลโคกล่าม,3656,3734,7390,3658,3737,7395,2094
2564,45,ร้อยเอ็ด,4575,ท้องถิ่นเทศบาลตำบลหัวช้าง,3990,4220,8210,3995,4224,8219,2686
2564,45,ร้อยเอ็ด,4576,ท้องถิ่นเทศบาลตำบลอุ่มเม้า,3575,3724,7299,3582,3728,7310,2042
2564,45,ร้อยเอ็ด,4577,ท้องถิ่นเทศบาลตำบลปอภาร,3458,3789,7247,3465,3790,7255,2455
2564,45,ร้อยเอ็ด,4578,ท้องถิ่นเทศบาลตำบลเมืองบัว,4150,4316,8466,4160,4319,8479,2817
2564,45,ร้อยเอ็ด,4579,ท้องถิ่นเทศบาลตำบลคำพอุง,4670,4598,9268,4681,4599,9280,2631
2564,45,ร้อยเอ็ด,4580,ท้องถิ่นเทศบาลตำบลอัคคะคำ,4114,4105,8219,4116,4106,8222,2142
2564,45,ร้อยเอ็ด,4581,ท้องถิ่นเทศบาลตำบลโนนตาล,2643,2636,5279,2644,2639,5283,1459
2564,45,ร้อยเอ็ด,4583,ท้องถิ่นเทศบาลตำบลอาจสามารถ,1948,2075,4023,1950,2077,4027,1800
2564,45,ร้อยเอ็ด,4584,ท้องถิ่นเทศบาลตำบลโพนทราย,2768,2816,5584,2768,2816,5584,1981
2564,45,ร้อยเอ็ด,4585,ท้องถิ่นเทศบาลตำบลเมืองสรวง,4702,4795,9497,4713,4796,9509,2873
2564,45,ร้อยเอ็ด,4586,ท้องถิ่นเทศบาลตำบลสุวรรณภูมิ,4224,4742,8966,4227,4747,8974,4235
2564,45,ร้อยเอ็ด,4587,ท้องถิ่นเทศบาลตำบลเสลภูมิ,6295,6748,13043,6310,6756,13066,5041
2564,45,ร้อยเอ็ด,4588,ท้องถิ่นเทศบาลตำบลหนองพอก,3123,3299,6422,3135,3300,6435,2671
2564,45,ร้อยเอ็ด,4589,ท้องถิ่นเทศบาลตำบลเชียงใหม่,4068,4186,8254,4071,4187,8258,2483
2564,45,ร้อยเอ็ด,4590,ท้องถิ่นเทศบาลตำบลชัยวารี,2580,2693,5273,2583,2693,5276,1674
2564,45,ร้อยเอ็ด,4591,ท้องถิ่นเทศบาลตำบลโพนทอง,5545,5742,11287,5564,5747,11311,5045
2564,45,ร้อยเอ็ด,4592,ท้องถิ่นเทศบาลตำบลพนมไพร,2026,2127,4153,2031,2129,4160,1796
2564,45,ร้อยเอ็ด,4593,ท้องถิ่นเทศบาลตำบลบ้านนิเวศน์,1184,1313,2497,1187,1313,2500,1180
2564,45,ร้อยเอ็ด,4594,ท้องถิ่นเทศบาลตำบลธงธานี,3718,4010,7728,3731,4011,7742,2521
2564,45,ร้อยเอ็ด,4595,ท้องถิ่นเทศบาลตำบลจตุรพักตรพิมาน,1765,2054,3819,1773,2059,3832,1595
2564,45,ร้อยเอ็ด,4596,ท้องถิ่นเทศบาลตำบลปทุมรัตต์,3082,3293,6375,3084,3294,6378,2145
2564,45,ร้อยเอ็ด,4597,ท้องถิ่นเทศบาลตำบลเกษตรวิสัย,5273,5630,10903,5277,5637,10914,4864
2564,45,ร้อยเอ็ด,4598,ท้องถิ่นเทศบาลตำบลกู่กาสิงห์,2244,2345,4589,2245,2346,4591,1615
2564,45,ร้อยเอ็ด,4599,ท้องถิ่นเทศบาลเมืองร้อยเอ็ด,16415,18735,35150,16534,18789,35323,16818
2564,46,กาฬสินธุ์,4601,อำเภอเมืองกาฬสินธุ์,39723,41048,80771,39820,41075,80895,26259
2564,46,กาฬสินธุ์,4602,อำเภอนามน,14659,14843,29502,14674,14845,29519,9448
2564,46,กาฬสินธุ์,4603,อำเภอกมลาไสย,22361,23270,45631,22377,23275,45652,12557
2564,46,กาฬสินธุ์,4604,อำเภอร่องคำ,5153,5273,10426,5156,5273,10429,3304
2564,46,กาฬสินธุ์,4605,อำเภอกุฉินารายณ์,30901,30840,61741,30938,30865,61803,21214
2564,46,กาฬสินธุ์,4606,อำเภอเขาวง,10416,10544,20960,10422,10552,20974,8633
2564,46,กาฬสินธุ์,4607,อำเภอยางตลาด,39930,41542,81472,39963,41554,81517,24432
2564,46,กาฬสินธุ์,4608,อำเภอห้วยเม็ก,20081,19993,40074,20106,19998,40104,12207
2564,46,กาฬสินธุ์,4609,อำเภอสหัสขันธ์,17173,17415,34588,17201,17423,34624,10448
2564,46,กาฬสินธุ์,4610,อำเภอคำม่วง,13450,13412,26862,13460,13413,26873,7468
2564,46,กาฬสินธุ์,4611,อำเภอท่าคันโท,14361,14425,28786,14379,14429,28808,8228
2564,46,กาฬสินธุ์,4612,อำเภอหนองกุงศรี,25504,25608,51112,25529,25619,51148,15467
2564,46,กาฬสินธุ์,4613,อำเภอสมเด็จ,27203,27777,54980,27250,27793,55043,17833
2564,46,กาฬสินธุ์,4614,อำเภอห้วยผึ้ง,6946,7110,14056,6957,7112,14069,3982
2564,46,กาฬสินธุ์,4615,อำเภอสามชัย,12880,12530,25410,12886,12535,25421,7670
2564,46,กาฬสินธุ์,4616,อำเภอนาคู,12860,12849,25709,12864,12853,25717,8236
2564,46,กาฬสินธุ์,4617,อำเภอดอนจาน,12948,13125,26073,12962,13131,26093,7707
2564,46,กาฬสินธุ์,4618,อำเภอฆ้องชัย,13217,13491,26708,13226,13495,26721,7578
2564,46,กาฬสินธุ์,4651,สาขาตำบลคำใหญ่ อำเภอห้วยเม็ก,0,0,0,0,0,0,0
2564,46,กาฬสินธุ์,4665,ท้องถิ่นเทศบาลตำบลจุมจัง,4754,4804,9558,4755,4804,9559,2506
2564,46,กาฬสินธุ์,4666,ท้องถิ่นเทศบาลตำบลนาทัน,7207,7057,14264,7207,7058,14265,3738
2564,46,กาฬสินธุ์,4667,ท้องถิ่นเทศบาลตำบลอิตื้อ,4296,4401,8697,4297,4406,8703,2517
2564,46,กาฬสินธุ์,4668,ท้องถิ่นเทศบาลตำบลภูสิงห์,1435,1359,2794,1435,1361,2796,827
2564,46,กาฬสินธุ์,4669,ท้องถิ่นเทศบาลตำบลหัวนาคำ,6191,6503,12694,6194,6506,12700,3762
2564,46,กาฬสินธุ์,4670,ท้องถิ่นเทศบาลตำบลบัวบาน,6294,6648,12942,6300,6651,12951,4477
2564,46,กาฬสินธุ์,4671,ท้องถิ่นเทศบาลตำบลนาขาม,6406,6574,12980,6408,6576,12984,3399
2564,46,กาฬสินธุ์,4672,ท้องถิ่นเทศบาลตำบลลำคลอง,2047,2187,4234,2050,2188,4238,1335
2564,46,กาฬสินธุ์,4673,ท้องถิ่นเทศบาลตำบลคำบง,5233,5182,10415,5236,5185,10421,3018
2564,46,กาฬสินธุ์,4674,ท้องถิ่นเทศบาลตำบลสระพังทอง,1403,1382,2785,1404,1383,2787,1007
2564,46,กาฬสินธุ์,4675,ท้องถิ่นเทศบาลตำบลห้วยโพธิ์,5775,5954,11729,5789,5956,11745,3427
2564,46,กาฬสินธุ์,4676,ท้องถิ่นเทศบาลตำบลนาคู,2513,2753,5266,2517,2756,5273,1926
2564,46,กาฬสินธุ์,4677,ท้องถิ่นเทศบาลตำบลห้วยผึ้ง,2815,2941,5756,2822,2943,5765,2267
2564,46,กาฬสินธุ์,4678,ท้องถิ่นเทศบาลตำบลสมเด็จ,3285,3499,6784,3295,3503,6798,3366
2564,46,กาฬสินธุ์,4679,ท้องถิ่นเทศบาลตำบลหนองหิน,2652,2713,5365,2655,2714,5369,1621
2564,46,กาฬสินธุ์,4680,ท้องถิ่นเทศบาลตำบลหนองกุงศรี,4368,4512,8880,4376,4515,8891,3433
2564,46,กาฬสินธุ์,4681,ท้องถิ่นเทศบาลตำบลท่าคันโท,4500,4603,9103,4506,4606,9112,2949
2564,46,กาฬสินธุ์,4682,ท้องถิ่นเทศบาลตำบลโพน,1874,1916,3790,1874,1916,3790,1101
2564,46,กาฬสินธุ์,4683,ท้องถิ่นเทศบาลตำบลคำม่วง,1936,1985,3921,1939,1986,3925,1722
2564,46,กาฬสินธุ์,4684,ท้องถิ่นเทศบาลตำบลโนนบุรี,2469,2728,5197,2479,2728,5207,2006
2564,46,กาฬสินธุ์,4685,ท้องถิ่นเทศบาลตำบลห้วยเม็ก,2756,2899,5655,2764,2901,5665,2209
2564,46,กาฬสินธุ์,4686,ท้องถิ่นเทศบาลตำบลคำใหญ่,2445,2537,4982,2449,2538,4987,1627
2564,46,กาฬสินธุ์,4687,ท้องถิ่นเทศบาลตำบลยางตลาด,4031,4448,8479,4041,4453,8494,3826
2564,46,กาฬสินธุ์,4688,ท้องถิ่นเทศบาลตำบลโคกศรี,1542,1615,3157,1543,1615,3158,1275
2564,46,กาฬสินธุ์,4689,ท้องถิ่นเทศบาลตำบลกุดสิม,4901,5206,10107,4911,5213,10124,4510
2564,46,กาฬสินธุ์,4690,ท้องถิ่นเทศบาลเมืองกุฉินารายณ์,5498,5810,11308,5511,5813,11324,4970
2564,46,กาฬสินธุ์,4691,ท้องถิ่นเทศบาลตำบลกุดหว้า,2503,2715,5218,2507,2717,5224,2075
2564,46,กาฬสินธุ์,4692,ท้องถิ่นเทศบาลตำบลร่องคำ,2957,3102,6059,2959,3104,6063,2220
2564,46,กาฬสินธุ์,4693,ท้องถิ่นเทศบาลตำบลหนองแปน,3232,3537,6769,3234,3537,6771,2180
2564,46,กาฬสินธุ์,4694,ท้องถิ่นเทศบาลตำบลธัญญา,3116,3212,6328,3123,3214,6337,1711
2564,46,กาฬสินธุ์,4695,ท้องถิ่นเทศบาลตำบลกมลาไสย,4608,5145,9753,4626,5149,9775,3664
2564,46,กาฬสินธุ์,4696,ท้องถิ่นเทศบาลตำบลนามน,3489,3487,6976,3490,3488,6978,2380
2564,46,กาฬสินธุ์,4697,ท้องถิ่นเทศบาลตำบลหนองสอ,3498,3770,7268,3506,3772,7278,2293
2564,46,กาฬสินธุ์,4698,ท้องถิ่นเทศบาลตำบลนาจารย์,4210,4238,8448,4216,4243,8459,2519
2564,46,กาฬสินธุ์,4699,ท้องถิ่นเทศบาลเมืองกาฬสินธุ์,15319,16816,32135,15400,16844,32244,16070
2564,47,สกลนคร,4701,อำเภอเมืองสกลนคร,56083,57567,113650,56134,57588,113722,42102
2564,47,สกลนคร,4702,อำเภอกุสุมาลย์,21784,21902,43686,21807,21911,43718,13998
2564,47,สกลนคร,4703,อำเภอกุดบาก,14001,13742,27743,14005,13743,27748,9057
2564,47,สกลนคร,4704,อำเภอพรรณานิคม,38625,39307,77932,38655,39335,77990,26984
2564,47,สกลนคร,4705,อำเภอพังโคน,22673,23250,45923,22720,23279,45999,17641
2564,47,สกลนคร,4706,อำเภอวาริชภูมิ,17696,18251,35947,17713,18261,35974,12383
2564,47,สกลนคร,4707,อำเภอนิคมน้ำอูน,7443,7436,14879,7447,7440,14887,4634
2564,47,สกลนคร,4708,อำเภอวานรนิวาส,59937,60547,120484,59990,60575,120565,34814
2564,47,สกลนคร,4709,อำเภอคำตากล้า,16338,16467,32805,16352,16473,32825,11707
2564,47,สกลนคร,4710,อำเภอบ้านม่วง,33939,33429,67368,33987,33445,67432,20127
2564,47,สกลนคร,4711,อำเภออากาศอำนวย,27203,26893,54096,27215,26910,54125,19274
2564,47,สกลนคร,4712,อำเภอสว่างแดนดิน,63458,64306,127764,63496,64339,127835,37531
2564,47,สกลนคร,4713,อำเภอส่องดาว,15026,14564,29590,15036,14571,29607,7746
2564,47,สกลนคร,4714,อำเภอเต่างอย,12188,12151,24339,12196,12155,24351,8728
2564,47,สกลนคร,4715,อำเภอโคกศรีสุพรรณ,10826,10946,21772,10830,10949,21779,7688
2564,47,สกลนคร,4716,อำเภอเจริญศิลป์,19317,19025,38342,19331,19031,38362,10663
2564,47,สกลนคร,4717,อำเภอโพนนาแก้ว,18491,18466,36957,18504,18474,36978,13905
2564,47,สกลนคร,4718,อำเภอภูพาน,18123,17788,35911,18144,17796,35940,12511
2564,47,สกลนคร,4751,สาขาตำบลกุดเรือคำ อำเภอวานรนิวาส,0,0,0,0,0,0,0
2564,47,สกลนคร,4779,ท้องถิ่นเทศบาลตำบลคำบ่อ,6807,6999,13806,6809,7001,13810,4152
2564,47,สกลนคร,4780,ท้องถิ่นเทศบาลตำบลตองโขบ,6217,6397,12614,6223,6399,12622,5782
2564,47,สกลนคร,4781,ท้องถิ่นเทศบาลตำบลบงใต้,5101,5057,10158,5104,5058,10162,3014
2564,47,สกลนคร,4782,ท้องถิ่นเทศบาลตำบลสามัคคีพัฒนา,4475,4558,9033,4477,4558,9035,2418
2564,47,สกลนคร,4783,ท้องถิ่นเทศบาลตำบลเชียงเครือ,8217,8653,16870,8222,8656,16878,6121
2564,47,สกลนคร,4784,ท้องถิ่นเทศบาลตำบลเจริญศิลป์,3343,3499,6842,3345,3500,6845,2314
2564,47,สกลนคร,4785,ท้องถิ่นเทศบาลตำบลส่องดาว,2455,2444,4899,2456,2445,4901,1576
2564,47,สกลนคร,4786,ท้องถิ่นเทศบาลตำบลสว่างแดนดิน,3881,4253,8134,3890,4274,8164,4872
2564,47,สกลนคร,4787,ท้องถิ่นเทศบาลตำบลดอนเขือง,2054,2100,4154,2055,2101,4156,1272
2564,47,สกลนคร,4788,ท้องถิ่นเทศบาลตำบลอากาศอำนวย,4369,4612,8981,4371,4612,8983,3063
2564,47,สกลนคร,4789,ท้องถิ่นเทศบาลตำบลบ้านม่วง,1711,1845,3556,1717,1847,3564,1497
2564,47,สกลนคร,4790,ท้องถิ่นเทศบาลตำบลคำตากล้า,3561,3712,7273,3571,3716,7287,2330
2564,47,สกลนคร,4791,ท้องถิ่นเทศบาลตำบลวานรนิวาส,2729,3015,5744,2732,3018,5750,2377
2564,47,สกลนคร,4792,ท้องถิ่นเทศบาลตำบลวาริชภูมิ,1392,1455,2847,1394,1455,2849,1359
2564,47,สกลนคร,4793,ท้องถิ่นเทศบาลตำบลพังโคน,3127,3262,6389,3149,3274,6423,3993
2564,47,สกลนคร,4794,ท้องถิ่นเทศบาลตำบลพรรณานิคม,1134,1268,2402,1136,1269,2405,1475
2564,47,สกลนคร,4795,ท้องถิ่นเทศบาลตำบลกุดบาก,2470,2625,5095,2472,2627,5099,1890
2564,47,สกลนคร,4796,ท้องถิ่นเทศบาลตำบลกุสุมาลย์,1978,2076,4054,1983,2077,4060,1718
2564,47,สกลนคร,4797,ท้องถิ่นเทศบาลตำบลท่าแร่,3191,3449,6640,3201,3454,6655,2337
2564,47,สกลนคร,4798,ท้องถิ่นเทศบาลตำบลดงมะไฟ,2798,3096,5894,2800,3100,5900,2283
2564,47,สกลนคร,4799,ท้องถิ่นเทศบาลนครสกลนคร,24562,26077,50639,24695,26206,50901,28841
2564,48,นครพนม,4801,อำเภอเมืองนครพนม,59205,58440,117645,59343,58603,117946,36560
2564,48,นครพนม,4802,อำเภอปลาปาก,25411,25101,50512,25437,25120,50557,16461
2564,48,นครพนม,4803,อำเภอท่าอุเทน,27469,27136,54605,27538,27232,54770,15925
2564,48,นครพนม,4804,อำเภอบ้านแพง,13369,13127,26496,13402,13186,26588,8193
2564,48,นครพนม,4805,อำเภอธาตุพนม,35545,36252,71797,35657,36351,72008,22165
2564,48,นครพนม,4806,อำเภอเรณูนคร,20793,20721,41514,20824,20735,41559,13081
2564,48,นครพนม,4807,อำเภอนาแก,35829,36420,72249,35876,36445,72321,21724
2564,48,นครพนม,4808,อำเภอศรีสงคราม,32053,32349,64402,32085,32395,64480,19500
2564,48,นครพนม,4809,อำเภอนาหว้า,19969,19974,39943,19982,19990,39972,13344
2564,48,นครพนม,4810,อำเภอโพนสวรรค์,26265,26343,52608,26277,26351,52628,17091
2564,48,นครพนม,4811,อำเภอนาทม,11910,11790,23700,11923,11797,23720,7546
2564,48,นครพนม,4812,อำเภอวังยาง,7818,7695,15513,7821,7695,15516,4766
2564,48,นครพนม,4890,ท้องถิ่นเทศบาลตำบลปลาปาก,1875,1993,3868,1876,1994,3870,1574
2564,48,นครพนม,4891,ท้องถิ่นเทศบาลตำบลโพนสวรรค์,2692,2673,5365,2696,2674,5370,1864
2564,48,นครพนม,4892,ท้องถิ่นเทศบาลตำบลนาหว้า,5970,6172,12142,5989,6176,12165,4282
2564,48,นครพนม,4893,ท้องถิ่นเทศบาลตำบลศรีสงคราม,2447,2574,5021,2453,2582,5035,2537
2564,48,นครพนม,4894,ท้องถิ่นเทศบาลตำบลนาแก,2037,2300,4337,2042,2300,4342,2347
2564,48,นครพนม,4895,ท้องถิ่นเทศบาลตำบลเรณูนคร,2085,2358,4443,2093,2366,4459,1715
2564,48,นครพนม,4896,ท้องถิ่นเทศบาลตำบลธาตุพนม,4829,5126,9955,4841,5136,9977,4149
2564,48,นครพนม,4897,ท้องถิ่นเทศบาลตำบลบ้านแพง,4303,4397,8700,4325,4449,8774,3615
2564,48,นครพนม,4898,ท้องถิ่นเทศบาลตำบลท่าอุเทน,2322,2428,4750,2340,2476,4816,1978
2564,48,นครพนม,4899,ท้องถิ่นเทศบาลเมืองนครพนม,12125,13706,25831,12276,13891,26167,15256
2564,49,มุกดาหาร,4901,อำเภอเมืองมุกดาหาร,40116,39549,79665,40278,39731,80009,27054
2564,49,มุกดาหาร,4902,อำเภอนิคมคำสร้อย,16999,17068,34067,17028,17077,34105,10180
2564,49,มุกดาหาร,4903,อำเภอดอนตาล,19456,19186,38642,19544,19336,38880,11726
2564,49,มุกดาหาร,4904,อำเภอดงหลวง,19675,19359,39034,19684,19369,39053,12311
2564,49,มุกดาหาร,4905,อำเภอคำชะอี,22215,22316,44531,22242,22330,44572,14615
2564,49,มุกดาหาร,4906,อำเภอหว้านใหญ่,9880,9865,19745,9928,9917,19845,6354
2564,49,มุกดาหาร,4907,อำเภอหนองสูง,10374,10419,20793,10381,10424,20805,7306
2564,49,มุกดาหาร,4989,ท้องถิ่นเทศบาลตำบลร่มเกล้า,1703,1628,3331,1706,1629,3335,1069
2564,49,มุกดาหาร,4993,ท้องถิ่นเทศบาลตำบลบ้านแก้ง,1493,1518,3011,1523,1557,3080,951
2564,49,มุกดาหาร,4994,ท้องถิ่นเทศบาลตำบลคำอาฮวน,6496,6409,12905,6518,6419,12937,4746
2564,49,มุกดาหาร,4995,ท้องถิ่นเทศบาลตำบลดงเย็น,5463,5300,10763,5470,5311,10781,3076
2564,49,มุกดาหาร,4996,ท้องถิ่นเทศบาลตำบลคำชะอี,1166,1172,2338,1169,1174,2343,1131
2564,49,มุกดาหาร,4997,ท้องถิ่นเทศบาลตำบลดอนตาล,1155,1331,2486,1181,1357,2538,958
2564,49,มุกดาหาร,4998,ท้องถิ่นเทศบาลตำบลนิคมคำสร้อย,3036,3176,6212,3044,3178,6222,2339
2564,49,มุกดาหาร,4999,ท้องถิ่นเทศบาลเมืองมุกดาหาร,14997,16082,31079,15937,17042,32979,16156
2564,50,เชียงใหม่,5001,อำเภอเมืองเชียงใหม่,6587,7484,14071,6746,7590,14336,11439
2564,50,เชียงใหม่,5002,อำเภอจอมทอง,27872,28790,56662,28064,28932,56996,20173
2564,50,เชียงใหม่,5003,อำเภอแม่แจ่ม,28959,28166,57125,29170,28310,57480,18336
2564,50,เชียงใหม่,5004,อำเภอเชียงดาว,10931,11464,22395,13468,14052,27520,11569
2564,50,เชียงใหม่,5005,อำเภอดอยสะเก็ด,21863,24008,45871,22290,24280,46570,22613
2564,50,เชียงใหม่,5006,อำเภอแม่แตง,24972,25567,50539,29727,30180,59907,24837
2564,50,เชียงใหม่,5007,อำเภอแม่ริม,37565,39694,77259,41611,43318,84929,38305
2564,50,เชียงใหม่,5008,อำเภอสะเมิง,9224,8869,18093,9357,8992,18349,6151
2564,50,เชียงใหม่,5009,อำเภอฝาง,40474,41981,82455,55621,56511,112132,41226
2564,50,เชียงใหม่,5010,อำเภอแม่อาย,28442,28827,57269,33856,33826,67682,28372
2564,50,เชียงใหม่,5011,อำเภอพร้าว,18067,18462,36529,18343,18732,37075,15684
2564,50,เชียงใหม่,5012,อำเภอสันป่าตอง,27783,31367,59150,27993,31548,59541,25867
2564,50,เชียงใหม่,5013,อำเภอสันกำแพง,19947,22579,42526,20265,22773,43038,22905
2564,50,เชียงใหม่,5014,อำเภอสันทราย,9145,10431,19576,9682,10943,20625,10391
2564,50,เชียงใหม่,5015,อำเภอหางดง,35096,40076,75172,35917,40482,76399,44629
2564,50,เชียงใหม่,5016,อำเภอฮอด,12519,12834,25353,12563,12874,25437,9735
2564,50,เชียงใหม่,5017,อำเภอดอยเต่า,11386,11451,22837,11400,11468,22868,8767
2564,50,เชียงใหม่,5018,อำเภออมก๋อย,30815,30256,61071,30952,30391,61343,22855
2564,50,เชียงใหม่,5019,อำเภอสารภี,21627,24862,46489,22026,25170,47196,23256
2564,50,เชียงใหม่,5020,อำเภอเวียงแหง,9865,9243,19108,27148,26651,53799,9605
2564,50,เชียงใหม่,5021,อำเภอไชยปราการ,11767,11795,23562,17623,17705,35328,11745
2564,50,เชียงใหม่,5022,อำเภอแม่วาง,13449,13595,27044,13661,13791,27452,9956
2564,50,เชียงใหม่,5023,อำเภอแม่ออน,10282,10526,20808,10399,10622,21021,9577
2564,50,เชียงใหม่,5024,อำเภอดอยหล่อ,11930,12687,24617,12133,12877,25010,11627
2564,50,เชียงใหม่,5025,อำเภอกัลยาณิวัฒนา,6574,6204,12778,6596,6213,12809,4401
2564,50,เชียงใหม่,5040,ท้องถิ่นเทศบาลตำบลบวกค้าง,4020,4471,8491,4100,4527,8627,4037
2564,50,เชียงใหม่,5041,ท้องถิ่นเทศบาลตำบลบ่อหลวง,6003,5996,11999,6032,6031,12063,3868
2564,50,เชียงใหม่,5042,ท้องถิ่นเทศบาลตำบลป่าไผ่,6611,7410,14021,6736,7489,14225,6383
2564,50,เชียงใหม่,5043,ท้องถิ่นเทศบาลตำบลสันนาเม็ง,5831,6989,12820,6008,7113,13121,8345
2564,50,เชียงใหม่,5044,ท้องถิ่นเทศบาลตำบลสันพระเนตร,2779,3310,6089,2837,3349,6186,3382
2564,50,เชียงใหม่,5046,ท้องถิ่นเทศบาลตำบลสันปูเลย,7764,9083,16847,7914,9149,17063,9460
2564,50,เชียงใหม่,5049,ท้องถิ่นเทศบาลตำบลเชิงดอย,3627,3966,7593,3726,4037,7763,3713
2564,50,เชียงใหม่,5050,ท้องถิ่นเทศบาลตำบลเมืองนะ,11355,11263,22618,18587,19318,37905,9397
2564,50,เชียงใหม่,5054,ท้องถิ่นเทศบาลตำบลทุ่งข้าวพวง,3271,3218,6489,5565,5475,11040,3075
2564,50,เชียงใหม่,5055,ท้องถิ่นเทศบาลตำบลปิงโค้ง,6654,5597,12251,7678,6604,14282,4549
2564,50,เชียงใหม่,5056,ท้องถิ่นเทศบาลตำบลพระธาตุปู่ก่ำ,973,1008,1981,1162,1198,2360,1129
2564,50,เชียงใหม่,5057,ท้องถิ่นเทศบาลเมืองแม่เหียะ,8686,10710,19396,8896,10811,19707,13974
2564,50,เชียงใหม่,5058,ท้องถิ่นเทศบาลตำบลสารภี,2883,3307,6190,3349,3766,7115,2708
2564,50,เชียงใหม่,5059,ท้องถิ่นเทศบาลตำบลฟ้าฮ่าม,3154,3690,6844,3233,3752,6985,9650
2564,50,เชียงใหม่,5060,ท้องถิ่นเทศบาลตำบลหนองจ๊อม,7611,9200,16811,7839,9374,17213,9331
2564,50,เชียงใหม่,5061,ท้องถิ่นเทศบาลตำบลหนองหอย,3466,4257,7723,3546,4305,7851,5543
2564,50,เชียงใหม่,5062,ท้องถิ่นเทศบาลตำบลแม่แฝก,4205,4766,8971,4239,4799,9038,3941
2564,50,เชียงใหม่,5063,ท้องถิ่นเทศบาลตำบลท่าศาลา,3150,3748,6898,3276,3820,7096,5481
2564,50,เชียงใหม่,5064,ท้องถิ่นเทศบาลตำบลหนองผึ้ง,7186,8468,15654,7305,8539,15844,8895
2564,50,เชียงใหม่,5065,ท้องถิ่นเทศบาลตำบลเจดีย์แม่ครัว,3826,4268,8094,3874,4299,8173,4010
2564,50,เชียงใหม่,5066,ท้องถิ่นเทศบาลตำบลแม่ปั๋ง,2975,3052,6027,3008,3094,6102,2642
2564,50,เชียงใหม่,5067,ท้องถิ่นเทศบาลตำบลชมภู,3594,3938,7532,3629,3985,7614,3159
2564,50,เชียงใหม่,5068,ท้องถิ่นเทศบาลตำบลป่าแดด,8013,9432,17445,8163,9537,17700,11136
2564,50,เชียงใหม่,5069,ท้องถิ่นเทศบาลเมืองสุเทพ,8331,8448,16779,8518,8587,17105,11480
2564,50,เชียงใหม่,5070,ท้องถิ่นเทศบาลตำบลหนองป่าครั่ง,3236,3806,7042,3390,3931,7321,6108
2564,50,เชียงใหม่,5071,ท้องถิ่นเทศบาลตำบลแม่วาง,2128,2386,4514,2152,2409,4561,2230
2564,50,เชียงใหม่,5072,ท้องถิ่นเทศบาลตำบลไชยปราการ,7099,7857,14956,7465,8201,15666,6636
2564,50,เชียงใหม่,5073,ท้องถิ่นเทศบาลตำบลยางเนิ้ง,4791,5736,10527,4827,5756,10583,5664
2564,50,เชียงใหม่,5074,ท้องถิ่นเทศบาลตำบลอมก๋อย,525,507,1032,531,509,1040,834
2564,50,เชียงใหม่,5075,ท้องถิ่นเทศบาลตำบลท่าเดื่อ-มืดกา,2052,2178,4230,2064,2186,4250,1879
2564,50,เชียงใหม่,5076,ท้องถิ่นเทศบาลตำบลท่าข้าม,2713,2966,5679,2727,2979,5706,3529
2564,50,เชียงใหม่,5077,ท้องถิ่นเทศบาลตำบลหางดง,2644,3310,5954,3304,3923,7227,3881
2564,50,เชียงใหม่,5078,ท้องถิ่นเทศบาลตำบลหนองตองพัฒนา,3872,4464,8336,3890,4472,8362,3542
2564,50,เชียงใหม่,5079,ท้องถิ่นเทศบาลตำบลสันทรายหลวง,12652,15415,28067,12979,15595,28574,15478
2564,50,เชียงใหม่,5080,ท้องถิ่นเทศบาลเมืองแม่โจ้,9605,11710,21315,10700,12621,23321,14337
2564,50,เชียงใหม่,5081,ท้องถิ่นเทศบาลตำบลสันกำแพง,8023,9423,17446,8161,9473,17634,9123
2564,50,เชียงใหม่,5082,ท้องถิ่นเทศบาลเมืองต้นเปา,8718,10561,19279,8875,10690,19565,13474
2564,50,เชียงใหม่,5083,ท้องถิ่นเทศบาลตำบลสันป่าตอง,2016,2385,4401,2026,2392,4418,2782
2564,50,เชียงใหม่,5084,ท้องถิ่นเทศบาลตำบลบ้านกลาง,4798,5454,10252,4818,5470,10288,5415
2564,50,เชียงใหม่,5085,ท้องถิ่นเทศบาลตำบลเวียงพร้าว,2154,2493,4647,2193,2528,4721,2851
2564,50,เชียงใหม่,5086,ท้องถิ่นเทศบาลตำบลแม่อาย,4372,4771,9143,5084,5495,10579,4913
2564,50,เชียงใหม่,5087,ท้องถิ่นเทศบาลตำบลเวียงฝาง,2818,3228,6046,4079,4506,8585,3964
2564,50,เชียงใหม่,5088,ท้องถิ่นเทศบาลตำบลบ้านแม่ข่า,904,941,1845,918,956,1874,888
2564,50,เชียงใหม่,5089,ท้องถิ่นเทศบาลตำบลสะเมิงใต้,2516,2550,5066,2677,2702,5379,2622
2564,50,เชียงใหม่,5090,ท้องถิ่นเทศบาลตำบลแม่ริม,4305,4968,9273,4364,4998,9362,5813
2564,50,เชียงใหม่,5091,ท้องถิ่นเทศบาลตำบลสันมหาพน,3765,4211,7976,3945,4402,8347,5091
2564,50,เชียงใหม่,5092,ท้องถิ่นเทศบาลเมืองเมืองแกนพัฒนา,5963,6459,12422,6029,6512,12541,5739
2564,50,เชียงใหม่,5093,ท้องถิ่นเทศบาลตำบลดอยสะเก็ด,1828,2108,3936,1977,2258,4235,2143
2564,50,เชียงใหม่,5094,ท้องถิ่นเทศบาลตำบลเมืองงาย,1717,1963,3680,1798,2028,3826,1966
2564,50,เชียงใหม่,5095,ท้องถิ่นเทศบาลตำบลเชียงดาว,1814,2042,3856,1833,2062,3895,2328
2564,50,เชียงใหม่,5096,ท้องถิ่นเทศบาลตำบลแม่แจ่ม,1278,1313,2591,1289,1320,2609,1623
2564,50,เชียงใหม่,5097,ท้องถิ่นเทศบาลตำบลจอมทอง,4215,4895,9110,4234,4908,9142,4576
2564,50,เชียงใหม่,5098,ท้องถิ่นเทศบาลตำบลช้างเผือก,4054,4667,8721,4217,4766,8983,9040
2564,50,เชียงใหม่,5099,ท้องถิ่นเทศบาลนครเชียงใหม่,53155,61289,114444,55987,63784,119771,90742
2564,51,ลำพูน,5101,อำเภอเมืองลำพูน,27559,30734,58293,28100,31179,59279,28052
2564,51,ลำพูน,5102,อำเภอแม่ทา,12233,12573,24806,12269,12595,24864,10779
2564,51,ลำพูน,5103,อำเภอบ้านโฮ่ง,12567,13218,25785,12610,13248,25858,10335
2564,51,ลำพูน,5104,อำเภอลี้,30833,30508,61341,30911,30613,61524,21445
2564,51,ลำพูน,5105,อำเภอทุ่งหัวช้าง,8851,8801,17652,8852,8801,17653,6498
2564,51,ลำพูน,5106,อำเภอป่าซาง,13587,14503,28090,13785,14714,28499,12950
2564,51,ลำพูน,5107,อำเภอบ้านธิ,3773,4161,7934,3855,4225,8080,3416
2564,51,ลำพูน,5108,อำเภอเวียงหนองล่อง,0,0,0,0,0,0,0
2564,51,ลำพูน,5176,ท้องถิ่นเทศบาลตำบลศรีเตี้ย,2607,2844,5451,2612,2851,5463,2239
2564,51,ลำพูน,5177,ท้องถิ่นเทศบาลตำบลทาสบชัย,2392,2522,4914,2420,2545,4965,2292
2564,51,ลำพูน,5178,ท้องถิ่นเทศบาลตำบลหนองล่อง,2666,2881,5547,2674,2888,5562,2540
2564,51,ลำพูน,5179,ท้องถิ่นเทศบาลตำบลหนองยวง,1726,1884,3610,1746,1899,3645,1800
2564,51,ลำพูน,5180,ท้องถิ่นเทศบาลตำบลมะกอก,2456,2730,5186,2465,2732,5197,2376
2564,51,ลำพูน,5181,ท้องถิ่นเทศบาลตำบลมะเขือแจ้,7598,8359,15957,7656,8413,16069,8747
2564,51,ลำพูน,5182,ท้องถิ่นเทศบาลตำบลเวียงยอง,3182,3675,6857,3220,3701,6921,3572
2564,51,ลำพูน,5183,ท้องถิ่นเทศบาลตำบลบ้านกลาง,5295,6154,11449,5330,6180,11510,11220
2564,51,ลำพูน,5184,ท้องถิ่นเทศบาลตำบลเหมืองง่า,7254,8676,15930,7288,8698,15986,8370
2564,51,ลำพูน,5185,ท้องถิ่นเทศบาลตำบลแม่แรง,3369,3654,7023,3382,3659,7041,2916
2564,51,ลำพูน,5186,ท้องถิ่นเทศบาลตำบลบ้านธิ,4364,4857,9221,4482,4967,9449,4380
2564,51,ลำพูน,5187,ท้องถิ่นเทศบาลตำบลวังผาง,3580,4012,7592,3591,4019,7610,3258
2564,51,ลำพูน,5188,ท้องถิ่นเทศบาลตำบลม่วงน้อย,1928,2254,4182,1932,2255,4187,1994
2564,51,ลำพูน,5189,ท้องถิ่นเทศบาลตำบลป่าซาง,3835,4555,8390,3852,4565,8417,4218
2564,51,ลำพูน,5190,ท้องถิ่นเทศบาลตำบลทุ่งหัวช้าง,1258,1265,2523,1259,1268,2527,1242
2564,51,ลำพูน,5191,ท้องถิ่นเทศบาลตำบลวังดิน,2077,2224,4301,2085,2239,4324,2723
2564,51,ลำพูน,5192,ท้องถิ่นเทศบาลตำบลแม่ตืน,1605,1751,3356,1637,1785,3422,1352
2564,51,ลำพูน,5193,ท้องถิ่นเทศบาลตำบลบ้านโฮ่ง,3472,4064,7536,3494,4082,7576,3637
2564,51,ลำพูน,5194,ท้องถิ่นเทศบาลตำบลทาสบเส้า,2538,2713,5251,2567,2736,5303,2542
2564,51,ลำพูน,5195,ท้องถิ่นเทศบาลตำบลทากาศ,1386,1529,2915,1393,1532,2925,1406
2564,51,ลำพูน,5196,ท้องถิ่นเทศบาลตำบลอุโมงค์,5904,6782,12686,5966,6832,12798,6013
2564,51,ลำพูน,5197,ท้องถิ่นเทศบาลตำบลริมปิง,3137,3575,6712,3154,3596,6750,2918
2564,51,ลำพูน,5198,ท้องถิ่นเทศบาลตำบลบ้านแป้น,2862,3327,6189,2880,3345,6225,2807
2564,51,ลำพูน,5199,ท้องถิ่นเทศบาลเมืองลำพูน,5214,6244,11458,5245,6265,11510,7216
2564,52,ลำปาง,5201,อำเภอเมืองลำปาง,44390,45944,90334,44491,46013,90504,38702
2564,52,ลำปาง,5202,อำเภอแม่เมาะ,12115,11961,24076,12130,11977,24107,9083
2564,52,ลำปาง,5203,อำเภอเกาะคา,17382,18594,35976,17409,18612,36021,13312
2564,52,ลำปาง,5204,อำเภอเสริมงาม,11032,11008,22040,11056,11027,22083,7684
2564,52,ลำปาง,5205,อำเภองาว,24179,24217,48396,24348,24410,48758,18159
2564,52,ลำปาง,5206,อำเภอแจ้ห่ม,17119,17581,34700,17196,17636,34832,13217
2564,52,ลำปาง,5207,อำเภอวังเหนือ,18003,17854,35857,18437,18344,36781,13357
2564,52,ลำปาง,5208,อำเภอเถิน,16477,16876,33353,16489,16908,33397,11484
2564,52,ลำปาง,5209,อำเภอแม่พริก,4600,4750,9350,4600,4757,9357,3225
2564,52,ลำปาง,5210,อำเภอแม่ทะ,13851,14101,27952,13861,14110,27971,10772
2564,52,ลำปาง,5211,อำเภอสบปราบ,10398,10731,21129,10404,10744,21148,6655
2564,52,ลำปาง,5212,อำเภอห้างฉัตร,23073,24182,47255,23135,24219,47354,19514
2564,52,ลำปาง,5213,อำเภอเมืองปาน,16321,16326,32647,16333,16343,32676,12107
2564,52,ลำปาง,5275,ท้องถิ่นเทศบาลตำบลน้ำโจ้,4696,4845,9541,4701,4848,9549,3528
2564,52,ลำปาง,5276,ท้องถิ่นเทศบาลตำบลแม่ทะ,3233,3315,6548,3238,3318,6556,2988
2564,52,ลำปาง,5279,ท้องถิ่นเทศบาลตำบลนาแก้ว,4325,4550,8875,4329,4552,8881,3139
2564,52,ลำปาง,5280,ท้องถิ่นเทศบาลตำบลลำปางหลวง,4379,4820,9199,4384,4824,9208,3348
2564,52,ลำปาง,5281,ท้องถิ่นเทศบาลตำบลสิริราช,2352,2234,4586,2355,2235,4590,1593
2564,52,ลำปาง,5282,ท้องถิ่นเทศบาลตำบลแม่เมาะ,7471,7797,15268,7480,7804,15284,8719
2564,52,ลำปาง,5283,ท้องถิ่นเทศบาลตำบลเวียงมอก,5075,5146,10221,5079,5153,10232,3528
2564,52,ลำปาง,5284,ท้องถิ่นเทศบาลตำบลห้างฉัตร,1238,1516,2754,1239,1518,2757,1298
2564,52,ลำปาง,5285,ท้องถิ่นเทศบาลตำบลสบปราบ,2617,2885,5502,2618,2886,5504,2080
2564,52,ลำปาง,5286,ท้องถิ่นเทศบาลตำบลป่าตันนาครัว,3782,4012,7794,3785,4012,7797,2982
2564,52,ลำปาง,5287,ท้องถิ่นเทศบาลตำบลแม่พริก,1227,1345,2572,1227,1345,2572,1128
2564,52,ลำปาง,5288,ท้องถิ่นเทศบาลตำบลแม่ปุ,1805,2018,3823,1808,2019,3827,1342
2564,52,ลำปาง,5289,ท้องถิ่นเทศบาลเมืองล้อมแรด,6543,7556,14099,6575,7584,14159,7139
2564,52,ลำปาง,5290,ท้องถิ่นเทศบาลตำบลวังเหนือ,2001,2000,4001,2012,2006,4018,1982
2564,52,ลำปาง,5291,ท้องถิ่นเทศบาลตำบลบ้านใหม่,1261,1281,2542,1264,1283,2547,892
2564,52,ลำปาง,5292,ท้องถิ่นเทศบาลตำบลแจ้ห่ม,1633,1815,3448,1635,1815,3450,1679
2564,52,ลำปาง,5293,ท้องถิ่นเทศบาลตำบลเสริมงาม,4087,4164,8251,4091,4166,8257,3020
2564,52,ลำปาง,5294,ท้องถิ่นเทศบาลตำบลหลวงเหนือ,1955,2176,4131,1959,2178,4137,2347
2564,52,ลำปาง,5295,ท้องถิ่นเทศบาลตำบลเกาะคา,2085,2387,4472,2107,2406,4513,2359
2564,52,ลำปาง,5296,ท้องถิ่นเทศบาลเมืองพิชัย,6165,7019,13184,6190,7026,13216,6477
2564,52,ลำปาง,5297,ท้องถิ่นเทศบาลตำบลบ่อแฮ้ว,4290,4847,9137,4304,4857,9161,4230
2564,52,ลำปาง,5298,ท้องถิ่นเทศบาลเมืองเขลางค์นคร,27996,31165,59161,28063,31202,59265,26086
2564,52,ลำปาง,5299,ท้องถิ่นเทศบาลนครลำปาง,22326,27458,49784,22562,27647,50209,29693
2564,53,อุตรดิตถ์,5301,อำเภอเมืองอุตรดิตถ์,22293,23496,45789,22311,23513,45824,17924
2564,53,อุตรดิตถ์,5302,อำเภอตรอน,14424,15324,29748,14431,15330,29761,10248
2564,53,อุตรดิตถ์,5303,อำเภอท่าปลา,14362,14504,28866,14376,14517,28893,10256
2564,53,อุตรดิตถ์,5304,อำเภอน้ำปาด,16550,16522,33072,16588,16610,33198,12043
2564,53,อุตรดิตถ์,5305,อำเภอฟากท่า,6493,6811,13304,6499,6828,13327,5110
2564,53,อุตรดิตถ์,5306,อำเภอบ้านโคก,5215,4961,10176,5331,5187,10518,4516
2564,53,อุตรดิตถ์,5307,อำเภอพิชัย,34703,36785,71488,34727,36804,71531,25867
2564,53,อุตรดิตถ์,5308,อำเภอลับแล,17949,18303,36252,17956,18310,36266,15126
2564,53,อุตรดิตถ์,5309,อำเภอทองแสนขัน,13151,13410,26561,13156,13412,26568,9532
2564,53,อุตรดิตถ์,5377,ท้องถิ่นเทศบาลตำบลท่าเสา,7545,7195,14740,7556,7199,14755,7599
2564,53,อุตรดิตถ์,5378,ท้องถิ่นเทศบาลตำบลน้ำริด,3387,3512,6899,3389,3513,6902,2613
2564,53,อุตรดิตถ์,5379,ท้องถิ่นเทศบาลตำบลหาดกรวด,3645,3897,7542,3654,3901,7555,2650
2564,53,อุตรดิตถ์,5380,ท้องถิ่นเทศบาลตำบลจริม,4307,4149,8456,4309,4149,8458,2381
2564,53,อุตรดิตถ์,5381,ท้องถิ่นเทศบาลตำบลคุ้งตะเภา,4237,4570,8807,4244,4574,8818,3508
2564,53,อุตรดิตถ์,5382,ท้องถิ่นเทศบาลตำบลผาจุก,3880,4120,8000,3883,4123,8006,3063
2564,53,อุตรดิตถ์,5383,ท้องถิ่นเทศบาลตำบลบ้านเกาะ,4300,4906,9206,4314,4912,9226,3833
2564,53,อุตรดิตถ์,5384,ท้องถิ่นเทศบาลตำบลทองแสนขัน,2206,2351,4557,2209,2353,4562,1818
2564,53,อุตรดิตถ์,5385,ท้องถิ่นเทศบาลตำบลหัวดง,2680,2828,5508,2681,2828,5509,2159
2564,53,อุตรดิตถ์,5386,ท้องถิ่นเทศบาลตำบลทุ่งยั้ง,4570,5241,9811,4579,5243,9822,4119
2564,53,อุตรดิตถ์,5387,ท้องถิ่นเทศบาลตำบลในเมือง,829,988,1817,836,989,1825,1010
2564,53,อุตรดิตถ์,5388,ท้องถิ่นเทศบาลตำบลท่าสัก,564,630,1194,566,632,1198,572
2564,53,อุตรดิตถ์,5389,ท้องถิ่นเทศบาลตำบลบ้านโคก,1864,1742,3606,1942,1917,3859,1902
2564,53,อุตรดิตถ์,5390,ท้องถิ่นเทศบาลตำบลฟากท่า,374,347,721,374,347,721,426
2564,53,อุตรดิตถ์,5391,ท้องถิ่นเทศบาลตำบลน้ำปาด,1387,1517,2904,1389,1521,2910,1596
2564,53,อุตรดิตถ์,5392,ท้องถิ่นเทศบาลตำบลร่วมจิต,1588,1775,3363,1588,1776,3364,1218
2564,53,อุตรดิตถ์,5393,ท้องถิ่นเทศบาลตำบลท่าปลา,1072,1176,2248,1076,1176,2252,949
2564,53,อุตรดิตถ์,5394,ท้องถิ่นเทศบาลตำบลบ้านแก่ง,997,1088,2085,997,1089,2086,883
2564,53,อุตรดิตถ์,5395,ท้องถิ่นเทศบาลตำบลตรอน,815,866,1681,816,866,1682,683
2564,53,อุตรดิตถ์,5396,ท้องถิ่นเทศบาลตำบลวังกะพี้,4490,5078,9568,4496,5082,9578,3429
2564,53,อุตรดิตถ์,5397,ท้องถิ่นเทศบาลตำบลบ้านด่านนาขาม,1878,1958,3836,1879,1959,3838,1386
2564,53,อุตรดิตถ์,5398,ท้องถิ่นเทศบาลตำบลศรีพนมมาศ,1356,1576,2932,1357,1576,2933,1199
2564,53,อุตรดิตถ์,5399,ท้องถิ่นเทศบาลเมืองอุตรดิตถ์,13849,16451,30300,13904,16499,30403,14822
2564,54,แพร่,5401,อำเภอเมืองแพร่,29441,32860,62301,29488,32882,62370,27605
2564,54,แพร่,5402,อำเภอร้องกวาง,16995,18349,35344,17032,18397,35429,12706
2564,54,แพร่,5403,อำเภอลอง,15119,15326,30445,15138,15334,30472,11455
2564,54,แพร่,5404,อำเภอสูงเม่น,32826,35940,68766,32848,35963,68811,28058
2564,54,แพร่,5405,อำเภอเด่นชัย,10109,9581,19690,10116,9591,19707,8441
2564,54,แพร่,5406,อำเภอสอง,20537,21436,41973,20578,21462,42040,16235
2564,54,แพร่,5407,อำเภอวังชิ้น,21113,21247,42360,21167,21300,42467,15388
2564,54,แพร่,5408,อำเภอหนองม่วงไข่,5980,6776,12756,5984,6780,12764,5078
2564,54,แพร่,5482,ท้องถิ่นเทศบาลตำบลแม่ลานนา,3176,3321,6497,3179,3324,6503,2645
2564,54,แพร่,5483,ท้องถิ่นเทศบาลตำบลแม่ปาน,1464,1446,2910,1464,1446,2910,1152
2564,54,แพร่,5484,ท้องถิ่นเทศบาลตำบลเวียงต้า,3158,3131,6289,3159,3132,6291,2457
2564,54,แพร่,5485,ท้องถิ่นเทศบาลตำบลป่าแมต,5602,6419,12021,5611,6421,12032,4982
2564,54,แพร่,5486,ท้องถิ่นเทศบาลตำบลแม่คำมี,3504,3654,7158,3505,3654,7159,2718
2564,54,แพร่,5487,ท้องถิ่นเทศบาลตำบลหนองม่วงไข่,2036,2360,4396,2036,2362,4398,1894
2564,54,แพร่,5488,ท้องถิ่นเทศบาลตำบลวังชิ้น,1407,1493,2900,1412,1493,2905,1428
2564,54,แพร่,5489,ท้องถิ่นเทศบาลตำบลสอง,2992,3600,6592,3000,3605,6605,3125
2564,54,แพร่,5490,ท้องถิ่นเทศบาลตำบลแม่จั๊วะ,1807,1954,3761,1813,1956,3769,1562
2564,54,แพร่,5491,ท้องถิ่นเทศบาลตำบลเด่นชัย,5169,5751,10920,5181,5755,10936,5182
2564,54,แพร่,5492,ท้องถิ่นเทศบาลตำบลสูงเม่น,1738,2013,3751,1740,2016,3756,1911
2564,54,แพร่,5493,ท้องถิ่นเทศบาลตำบลห้วยอ้อ,2230,2551,4781,2236,2551,4787,2230
2564,54,แพร่,5494,ท้องถิ่นเทศบาลตำบลบ้านปิน,1012,1212,2224,1014,1213,2227,818
2564,54,แพร่,5495,ท้องถิ่นเทศบาลตำบลร้องกวาง,5831,6493,12324,5840,6497,12337,6065
2564,54,แพร่,5496,ท้องถิ่นเทศบาลตำบลแม่หล่าย,2022,2332,4354,2026,2341,4367,2020
2564,54,แพร่,5497,ท้องถิ่นเทศบาลตำบลทุ่งโฮ้ง,2853,3291,6144,2858,3296,6154,3192
2564,54,แพร่,5498,ท้องถิ่นเทศบาลตำบลช่อแฮ,4253,4523,8776,4255,4525,8780,3678
2564,54,แพร่,5499,ท้องถิ่นเทศบาลเมืองแพร่,6673,7838,14511,6723,7881,14604,8808
2564,55,น่าน,5501,อำเภอเมืองน่าน,31304,31372,62676,31396,31470,62866,24990
2564,55,น่าน,5502,อำเภอแม่จริม,8282,8013,16295,8307,8041,16348,4951
2564,55,น่าน,5503,อำเภอบ้านหลวง,5783,5719,11502,5785,5726,11511,3971
2564,55,น่าน,5504,อำเภอนาน้อย,14888,14788,29676,14903,14803,29706,10457
2564,55,น่าน,5505,อำเภอปัว,26702,27013,53715,26754,27104,53858,16109
2564,55,น่าน,5506,อำเภอท่าวังผา,22586,22571,45157,22652,22668,45320,14739
2564,55,น่าน,5507,อำเภอเวียงสา,33437,33128,66565,33532,33239,66771,24707
2564,55,น่าน,5508,อำเภอทุ่งช้าง,7756,7591,15347,7869,7776,15645,5255
2564,55,น่าน,5509,อำเภอเชียงกลาง,8677,8786,17463,8702,8808,17510,5846
2564,55,น่าน,5510,อำเภอนาหมื่น,7199,7049,14248,7202,7054,14256,4496
2564,55,น่าน,5511,อำเภอสันติสุข,8053,7606,15659,8063,7618,15681,5181
2564,55,น่าน,5512,อำเภอบ่อเกลือ,7791,7469,15260,7819,7497,15316,5041
2564,55,น่าน,5513,อำเภอสองแคว,6356,5896,12252,6440,6026,12466,3849
2564,55,น่าน,5514,อำเภอภูเพียง,17742,18135,35877,17769,18160,35929,13744
2564,55,น่าน,5515,อำเภอเฉลิมพระเกียรติ,4961,4762,9723,5020,4812,9832,3414
2564,55,น่าน,5592,ท้องถิ่นเทศบาลตำบลเชียงกลาง,4687,4879,9566,4700,4887,9587,3972
2564,55,น่าน,5593,ท้องถิ่นเทศบาลตำบลทุ่งช้าง,1674,1609,3283,1678,1612,3290,1431
2564,55,น่าน,5594,ท้องถิ่นเทศบาลตำบลเวียงสา,1293,1515,2808,1293,1517,2810,1310
2564,55,น่าน,5595,ท้องถิ่นเทศบาลตำบลท่าวังผา,2455,2694,5149,2463,2712,5175,2741
2564,55,น่าน,5596,ท้องถิ่นเทศบาลตำบลปัว,4991,5354,10345,5018,5383,10401,4940
2564,55,น่าน,5597,ท้องถิ่นเทศบาลตำบลนาน้อย,1133,1265,2398,1135,1268,2403,1233
2564,55,น่าน,5598,ท้องถิ่นเทศบาลตำบลหนองแดง,0,0,0,0,0,0,0
2564,55,น่าน,5599,ท้องถิ่นเทศบาลเมืองน่าน,9418,9699,19117,9459,9735,19194,10839
2564,56,พะเยา,5601,อำเภอเมืองพะเยา,20871,22226,43097,20916,22268,43184,17491
2564,56,พะเยา,5602,อำเภอจุน,8608,9522,18130,8637,9540,18177,7277
2564,56,พะเยา,5603,อำเภอเชียงคำ,27273,27366,54639,27682,27815,55497,21595
2564,56,พะเยา,5604,อำเภอเชียงม่วน,4770,4868,9638,4798,4906,9704,3950
2564,56,พะเยา,5605,อำเภอดอกคำใต้,18546,19504,38050,18589,19547,38136,14931
2564,56,พะเยา,5606,อำเภอปง,19628,19553,39181,19722,19648,39370,12537
2564,56,พะเยา,5607,อำเภอแม่ใจ,9765,10388,20153,9777,10401,20178,9550
2564,56,พะเยา,5608,อำเภอภูซาง,11943,12057,24000,12063,12262,24325,9569
2564,56,พะเยา,5609,อำเภอภูกามยาว,6055,6562,12617,6073,6573,12646,5057
2564,56,พะเยา,5677,ท้องถิ่นเทศบาลตำบลบ้านต๋อม,5679,6720,12399,5796,6823,12619,7321
2564,56,พะเยา,5678,ท้องถิ่นเทศบาลตำบลห้วยลาน,4211,4605,8816,4220,4617,8837,3348
2564,56,พะเยา,5679,ท้องถิ่นเทศบาลตำบลฝายกวาง,4268,4489,8757,4286,4511,8797,3780
2564,56,พะเยา,5680,ท้องถิ่นเทศบาลตำบลเวียงลอ,2959,3188,6147,2964,3195,6159,2691
2564,56,พะเยา,5681,ท้องถิ่นเทศบาลตำบลหงส์หิน,3256,3446,6702,3263,3450,6713,2791
2564,56,พะเยา,5682,ท้องถิ่นเทศบาลตำบลจุน,4388,4653,9041,4400,4659,9059,3976
2564,56,พะเยา,5683,ท้องถิ่นเทศบาลตำบลบ้านเหล่า,3798,3944,7742,3803,3949,7752,2965
2564,56,พะเยา,5684,ท้องถิ่นเทศบาลตำบลแม่กา,6154,6726,12880,6177,6750,12927,6867
2564,56,พะเยา,5685,ท้องถิ่นเทศบาลตำบลแม่ปืม,4392,4604,8996,4394,4613,9007,3451
2564,56,พะเยา,5686,ท้องถิ่นเทศบาลตำบลบ้านต๊ำ,3416,3639,7055,3423,3645,7068,3267
2564,56,พะเยา,5687,ท้องถิ่นเทศบาลตำบลท่าวังทอง,7925,7672,15597,7948,7683,15631,9672
2564,56,พะเยา,5688,ท้องถิ่นเทศบาลตำบลดงเจน,3851,4367,8218,3860,4371,8231,3587
2564,56,พะเยา,5689,ท้องถิ่นเทศบาลตำบลสบบง,3803,4108,7911,3826,4159,7985,3455
2564,56,พะเยา,5690,ท้องถิ่นเทศบาลตำบลแม่ใจ,2367,2582,4949,2370,2584,4954,2198
2564,56,พะเยา,5691,ท้องถิ่นเทศบาลตำบลปง,2630,2926,5556,2638,2932,5570,2819
2564,56,พะเยา,5692,ท้องถิ่นเทศบาลตำบลงิม,3295,3399,6694,3298,3405,6703,2488
2564,56,พะเยา,5693,ท้องถิ่นเทศบาลเมืองดอกคำใต้,5774,6714,12488,5785,6726,12511,5392
2564,56,พะเยา,5694,ท้องถิ่นเทศบาลตำบลบ้านถ้ำ,4112,4079,8191,4116,4081,8197,3258
2564,56,พะเยา,5695,ท้องถิ่นเทศบาลตำบลเชียงม่วน,4269,4339,8608,4278,4346,8624,3880
2564,56,พะเยา,5696,ท้องถิ่นเทศบาลตำบลเวียง,2633,2790,5423,2637,2795,5432,2275
2564,56,พะเยา,5697,ท้องถิ่นเทศบาลตำบลเชียงคำ,2791,3363,6154,2803,3382,6185,3709
2564,56,พะเยา,5698,ท้องถิ่นเทศบาลตำบลห้วยข้าวก่ำ,3917,4246,8163,3926,4258,8184,4188
2564,56,พะเยา,5699,ท้องถิ่นเทศบาลเมืองพะเยา,7442,8647,16089,7475,8668,16143,8258
2564,57,เชียงราย,5701,อำเภอเมืองเชียงราย,49153,54019,103172,51923,57059,108982,52663
2564,57,เชียงราย,5702,อำเภอเวียงชัย,18809,19909,38718,18939,20017,38956,15645
2564,57,เชียงราย,5703,อำเภอเชียงของ,11994,12108,24102,12369,12815,25184,10607
2564,57,เชียงราย,5704,อำเภอเทิง,36465,37074,73539,37073,37711,74784,29079
2564,57,เชียงราย,5705,อำเภอพาน,53541,56687,110228,54363,57555,111918,48441
2564,57,เชียงราย,5706,อำเภอป่าแดด,5843,5969,11812,5849,5976,11825,4095
2564,57,เชียงราย,5707,อำเภอแม่จัน,29196,31055,60251,33970,36475,70445,28550
2564,57,เชียงราย,5708,อำเภอเชียงแสน,21155,21747,42902,23967,25214,49181,21673
2564,57,เชียงราย,5709,อำเภอแม่สาย,22267,23763,46030,34189,38263,72452,29509
2564,57,เชียงราย,5710,อำเภอแม่สรวย,36810,36346,73156,39265,38785,78050,29495
2564,57,เชียงราย,5711,อำเภอเวียงป่าเป้า,28719,29277,57996,30248,30801,61049,24770
2564,57,เชียงราย,5712,อำเภอพญาเม็งราย,13426,13691,27117,13586,13876,27462,9856
2564,57,เชียงราย,5713,อำเภอเวียงแก่น,17302,16612,33914,18803,18478,37281,13418
2564,57,เชียงราย,5714,อำเภอขุนตาล,6884,7141,14025,6896,7150,14046,5574
2564,57,เชียงราย,5715,อำเภอแม่ฟ้าหลวง,28962,28115,57077,38669,38986,77655,25337
2564,57,เชียงราย,5716,อำเภอแม่ลาว,11899,12594,24493,11981,12666,24647,11074
2564,57,เชียงราย,5717,อำเภอเวียงเชียงรุ้ง,11760,12076,23836,11807,12109,23916,9167
2564,57,เชียงราย,5718,อำเภอดอยหลวง,9228,9145,18373,9351,9301,18652,8714
2564,57,เชียงราย,5764,ท้องถิ่นเทศบาลตำบลแม่ยาว,8736,8867,17603,10828,11059,21887,9195
2564,57,เชียงราย,5765,ท้องถิ่นเทศบาลตำบลห้วยซ้อ,6044,5933,11977,6175,6177,12352,5276
2564,57,เชียงราย,5766,ท้องถิ่นเทศบาลตำบลไม้ยา,5286,5295,10581,5291,5302,10593,3814
2564,57,เชียงราย,5767,ท้องถิ่นเทศบาลตำบลครึ่ง,3166,3158,6324,3181,3174,6355,2698
2564,57,เชียงราย,5768,ท้องถิ่นเทศบาลตำบลป่าอ้อดอนชัย,5245,5814,11059,5391,5943,11334,5495
2564,57,เชียงราย,5769,ท้องถิ่นเทศบาลตำบลยางฮอม,5339,5537,10876,5368,5571,10939,4034
2564,57,เชียงราย,5770,ท้องถิ่นเทศบาลตำบลเวียง,4517,4571,9088,4736,4870,9606,4302
2564,57,เชียงราย,5771,ท้องถิ่นเทศบาลตำบลนางแล,5033,5567,10600,5678,6194,11872,6087
2564,57,เชียงราย,5772,ท้องถิ่นเทศบาลตำบลป่าซาง,4819,5384,10203,5476,6130,11606,5623
2564,57,เชียงราย,5773,ท้องถิ่นเทศบาลตำบลเวียงพางคำ,4950,5072,10022,10507,12042,22549,9856
2564,57,เชียงราย,5774,ท้องถิ่นเทศบาลตำบลบ้านดู่,8738,10080,18818,9747,11085,20832,14323
2564,57,เชียงราย,5775,ท้องถิ่นเทศบาลตำบลบ้านเหล่า,2004,2025,4029,2005,2027,4032,1720
2564,57,เชียงราย,5776,ท้องถิ่นเทศบาลตำบลแม่ลาว,845,952,1797,851,956,1807,814
2564,57,เชียงราย,5777,ท้องถิ่นเทศบาลตำบลป่าก่อดำ,1993,2187,4180,2009,2202,4211,2010
2564,57,เชียงราย,5778,ท้องถิ่นเทศบาลตำบลบ้านต้า,2912,3134,6046,2917,3140,6057,2270
2564,57,เชียงราย,5779,ท้องถิ่นเทศบาลตำบลพญาเม็งราย,1945,2141,4086,2006,2182,4188,2230
2564,57,เชียงราย,5780,ท้องถิ่นเทศบาลตำบลเวียงป่าเป้า,2020,2378,4398,2062,2432,4494,2398
2564,57,เชียงราย,5781,ท้องถิ่นเทศบาลตำบลแม่ขะจาน,1359,1548,2907,1364,1552,2916,1601
2564,57,เชียงราย,5782,ท้องถิ่นเทศบาลตำบลเจดีย์หลวง,2321,2386,4707,2338,2400,4738,2140
2564,57,เชียงราย,5783,ท้องถิ่นเทศบาลตำบลแม่สรวย,678,708,1386,727,755,1482,1117
2564,57,เชียงราย,5784,ท้องถิ่นเทศบาลตำบลห้วยไคร้,2083,2339,4422,2322,2682,5004,2530
2564,57,เชียงราย,5785,ท้องถิ่นเทศบาลตำบลแม่สาย,8429,8833,17262,13068,14993,28061,13706
2564,57,เชียงราย,5786,ท้องถิ่นเทศบาลตำบลเวียงเชียงแสน,2289,2600,4889,3056,3440,6496,3356
2564,57,เชียงราย,5787,ท้องถิ่นเทศบาลตำบลสันทราย,1192,1341,2533,1247,1381,2628,1266
2564,57,เชียงราย,5788,ท้องถิ่นเทศบาลตำบลแม่จัน,1471,1669,3140,1675,1921,3596,2432
2564,57,เชียงราย,5789,ท้องถิ่นเทศบาลตำบลแม่คำ,2115,2362,4477,2151,2402,4553,2170
2564,57,เชียงราย,5790,ท้องถิ่นเทศบาลตำบลจันจว้า,6652,7394,14046,6736,7496,14232,6226
2564,57,เชียงราย,5791,ท้องถิ่นเทศบาลตำบลป่าแดด,3074,3218,6292,3081,3231,6312,2436
2564,57,เชียงราย,5792,ท้องถิ่นเทศบาลตำบลป่าแงะ,3720,3839,7559,3725,3847,7572,3129
2564,57,เชียงราย,5793,ท้องถิ่นเทศบาลตำบลเมืองพาน,2948,3434,6382,2975,3457,6432,3518
2564,57,เชียงราย,5794,ท้องถิ่นเทศบาลตำบลเวียงเทิง,2255,2644,4899,2292,2689,4981,2781
2564,57,เชียงราย,5795,ท้องถิ่นเทศบาลตำบลบ้านปล้อง,1931,2046,3977,1933,2048,3981,1596
2564,57,เชียงราย,5796,ท้องถิ่นเทศบาลตำบลเวียงเชียงของ,1758,1979,3737,1771,2003,3774,2359
2564,57,เชียงราย,5797,ท้องถิ่นเทศบาลตำบลบุญเรือง,2899,3033,5932,2907,3047,5954,2536
2564,57,เชียงราย,5798,ท้องถิ่นเทศบาลตำบลเวียงชัย,3137,3583,6720,3169,3601,6770,3133
2564,57,เชียงราย,5799,ท้องถิ่นเทศบาลนครเชียงราย,33140,37548,70688,36855,40889,77744,51617
2564,58,แม่ฮ่องสอน,5801,อำเภอเมืองแม่ฮ่องสอน,19858,19223,39081,28432,28087,56519,23443
2564,58,แม่ฮ่องสอน,5802,อำเภอขุนยวม,9691,9222,18913,10394,9835,20229,7812
2564,58,แม่ฮ่องสอน,5803,อำเภอปาย,15438,14433,29871,18216,16959,35175,15308
2564,58,แม่ฮ่องสอน,5804,อำเภอแม่สะเรียง,25032,24789,49821,26423,26051,52474,21731
2564,58,แม่ฮ่องสอน,5805,อำเภอแม่ลาน้อย,16157,15977,32134,16260,16046,32306,10880
2564,58,แม่ฮ่องสอน,5806,อำเภอสบเมย,18461,17989,36450,23647,22947,46594,17359
2564,58,แม่ฮ่องสอน,5807,อำเภอปางมะผ้า,8879,8400,17279,11364,10663,22027,8891
2564,58,แม่ฮ่องสอน,5895,ท้องถิ่นเทศบาลตำบลแม่ลาน้อย,1752,1782,3534,1779,1804,3583,1802
2564,58,แม่ฮ่องสอน,5896,ท้องถิ่นเทศบาลตำบลแม่สะเรียง,1150,1362,2512,1314,1502,2816,1962
2564,58,แม่ฮ่องสอน,5897,ท้องถิ่นเทศบาลตำบลปาย,1075,1165,2240,1731,1796,3527,1900
2564,58,แม่ฮ่องสอน,5898,ท้องถิ่นเทศบาลตำบลขุนยวม,1572,1642,3214,1695,1772,3467,1733
2564,58,แม่ฮ่องสอน,5899,ท้องถิ่นเทศบาลเมืองแม่ฮ่องสอน,3225,3400,6625,3556,3643,7199,4676
2564,60,นครสวรรค์,6001,อำเภอเมืองนครสวรรค์,77669,82608,160277,77842,82704,160546,71388
2564,60,นครสวรรค์,6002,อำเภอโกรกพระ,13003,13607,26610,13016,13616,26632,9752
2564,60,นครสวรรค์,6003,อำเภอชุมแสง,25794,27422,53216,25820,27436,53256,19448
2564,60,นครสวรรค์,6004,อำเภอหนองบัว,26857,27377,54234,26876,27384,54260,23489
2564,60,นครสวรรค์,6005,อำเภอบรรพตพิสัย,39628,41305,80933,39696,41333,81029,28809
2564,60,นครสวรรค์,6006,อำเภอเก้าเลี้ยว,13873,14577,28450,13892,14588,28480,10614
2564,60,นครสวรรค์,6007,อำเภอตาคลี,38005,39034,77039,38051,39069,77120,30136
2564,60,นครสวรรค์,6008,อำเภอท่าตะโก,29456,30798,60254,29488,30812,60300,23725
2564,60,นครสวรรค์,6009,อำเภอไพศาลี,29434,30031,59465,29445,30049,59494,21256
2564,60,นครสวรรค์,6010,อำเภอพยุหะคีรี,24256,25722,49978,24293,25741,50034,21322
2564,60,นครสวรรค์,6011,อำเภอลาดยาว,35975,37445,73420,36007,37476,73483,27981
2564,60,นครสวรรค์,6012,อำเภอตากฟ้า,16731,17274,34005,16739,17279,34018,12752
2564,60,นครสวรรค์,6013,อำเภอแม่วงก์,24778,25070,49848,24804,25081,49885,18832
2564,60,นครสวรรค์,6014,อำเภอแม่เปิน,10515,10393,20908,10521,10394,20915,7008
2564,60,นครสวรรค์,6015,อำเภอชุมตาบง,8915,9052,17967,8917,9053,17970,6487
2564,60,นครสวรรค์,6082,ท้องถิ่นเทศบาลตำบลตากฟ้า,2589,2778,5367,2601,2785,5386,2764
2564,60,นครสวรรค์,6083,ท้องถิ่นเทศบาลตำบลลาดยาว,2790,3138,5928,2800,3148,5948,3480
2564,60,นครสวรรค์,6084,ท้องถิ่นเทศบาลตำบลศาลเจ้าไก่ต่อ,1540,1744,3284,1541,1747,3288,1469
2564,60,นครสวรรค์,6085,ท้องถิ่นเทศบาลตำบลพยุหะ,2528,2939,5467,2541,2947,5488,2974
2564,60,นครสวรรค์,6086,ท้องถิ่นเทศบาลตำบลท่าน้ำอ้อยม่วงหัก,2381,2594,4975,2387,2597,4984,2750
2564,60,นครสวรรค์,6087,ท้องถิ่นเทศบาลตำบลไพศาลี,4856,5419,10275,4865,5424,10289,5008
2564,60,นครสวรรค์,6088,ท้องถิ่นเทศบาลตำบลท่าตะโก,2590,2944,5534,2600,2959,5559,2889
2564,60,นครสวรรค์,6089,ท้องถิ่นเทศบาลตำบลช่องแค,1442,1556,2998,1444,1556,3000,1071
2564,60,นครสวรรค์,6090,ท้องถิ่นเทศบาลตำบลเก้าเลี้ยว,2715,2971,5686,2729,2977,5706,2322
2564,60,นครสวรรค์,6091,ท้องถิ่นเทศบาลตำบลบรรพตพิสัย,1815,1968,3783,1820,1968,3788,1844
2564,60,นครสวรรค์,6092,ท้องถิ่นเทศบาลเมืองหนองบัว,5503,6085,11588,5507,6097,11604,5046
2564,60,นครสวรรค์,6093,ท้องถิ่นเทศบาลตำบลทับกฤช,1019,1109,2128,1021,1110,2131,830
2564,60,นครสวรรค์,6094,ท้องถิ่นเทศบาลตำบลบางประมุง,2460,2541,5001,2466,2542,5008,1592
2564,60,นครสวรรค์,6095,ท้องถิ่นเทศบาลตำบลโกรกพระ,1067,1156,2223,1069,1158,2227,1001
2564,60,นครสวรรค์,6096,ท้องถิ่นเทศบาลตำบลหนองเบน,1335,1601,2936,1336,1607,2943,1505
2564,60,นครสวรรค์,6097,ท้องถิ่นเทศบาลเมืองตาคลี,10918,11921,22839,10964,11950,22914,9983
2564,60,นครสวรรค์,6098,ท้องถิ่นเทศบาลเมืองชุมแสง,3486,3942,7428,3494,3953,7447,3628
2564,60,นครสวรรค์,6099,ท้องถิ่นเทศบาลนครนครสวรรค์,37576,41438,79014,38065,41831,79896,42893
2564,61,อุทัยธานี,6101,อำเภอเมืองอุทัยธานี,17006,18452,35458,17018,18467,35485,13816
2564,61,อุทัยธานี,6102,อำเภอทัพทัน,7746,8158,15904,7750,8163,15913,5475
2564,61,อุทัยธานี,6103,อำเภอสว่างอารมณ์,14926,14960,29886,14934,14980,29914,11077
2564,61,อุทัยธานี,6104,อำเภอหนองฉาง,16510,17527,34037,16524,17539,34063,11925
2564,61,อุทัยธานี,6105,อำเภอหนองขาหย่าง,7259,8074,15333,7263,8075,15338,5871
2564,61,อุทัยธานี,6106,อำเภอบ้านไร่,31490,31804,63294,31556,31872,63428,24918
2564,61,อุทัยธานี,6107,อำเภอลานสัก,27546,27782,55328,27589,27831,55420,19077
2564,61,อุทัยธานี,6108,อำเภอห้วยคต,9933,10171,20104,9951,10180,20131,7500
2564,61,อุทัยธานี,6189,ท้องถิ่นเทศบาลตำบลหนองสระ,1006,1129,2135,1006,1129,2135,674
2564,61,อุทัยธานี,6190,ท้องถิ่นเทศบาลตำบลลานสัก,1673,1711,3384,1676,1714,3390,2149
2564,61,อุทัยธานี,6191,ท้องถิ่นเทศบาลตำบลเมืองการุ้ง,1009,1129,2138,1012,1131,2143,1011
2564,61,อุทัยธานี,6192,ท้องถิ่นเทศบาลตำบลบ้านไร่,1245,1292,2537,1247,1293,2540,1399
2564,61,อุทัยธานี,6193,ท้องถิ่นเทศบาลตำบลหนองขาหย่าง,280,317,597,280,317,597,332
2564,61,อุทัยธานี,6194,ท้องถิ่นเทศบาลตำบลหนองฉาง,1270,1447,2717,1271,1449,2720,1914
2564,61,อุทัยธานี,6195,ท้องถิ่นเทศบาลตำบลเขาบางแกรก,2970,3237,6207,2974,3238,6212,2398
2564,61,อุทัยธานี,6196,ท้องถิ่นเทศบาลตำบลสว่างอารมณ์,773,830,1603,777,832,1609,974
2564,61,อุทัยธานี,6197,ท้องถิ่นเทศบาลตำบลทัพทัน,4195,4581,8776,4200,4589,8789,3662
2564,61,อุทัยธานี,6198,ท้องถิ่นเทศบาลตำบลตลุกดู่,5454,5775,11229,5456,5781,11237,3677
2564,61,อุทัยธานี,6199,ท้องถิ่นเทศบาลเมืองอุทัยธานี,6403,7583,13986,6442,7610,14052,9657
2564,62,กำแพงเพชร,6201,อำเภอเมืองกำแพงเพชร,66612,68785,135397,66688,68836,135524,53280
2564,62,กำแพงเพชร,6202,อำเภอไทรงาม,22447,22745,45192,22468,22758,45226,15091
2564,62,กำแพงเพชร,6203,อำเภอคลองลาน,20205,19517,39722,20258,19560,39818,15157
2564,62,กำแพงเพชร,6204,อำเภอขาณุวรลักษบุรี,34098,34587,68685,34128,34601,68729,26007
2564,62,กำแพงเพชร,6205,อำเภอคลองขลุง,27333,28462,55795,27411,28521,55932,23665
2564,62,กำแพงเพชร,6206,อำเภอพรานกระต่าย,24363,24418,48781,24370,24425,48795,16379
2564,62,กำแพงเพชร,6207,อำเภอลานกระบือ,16328,16390,32718,16338,16409,32747,11268
2564,62,กำแพงเพชร,6208,อำเภอทรายทองวัฒนา,6954,6951,13905,6959,6953,13912,4203
2564,62,กำแพงเพชร,6209,อำเภอปางศิลาทอง,15121,15156,30277,15145,15174,30319,11203
2564,62,กำแพงเพชร,6210,อำเภอบึงสามัคคี,9090,9154,18244,9105,9165,18270,7337
2564,62,กำแพงเพชร,6211,อำเภอโกสัมพีนคร,14096,14106,28202,14111,14111,28222,10814
2564,62,กำแพงเพชร,6278,ท้องถิ่นเทศบาลเมืองปางมะค่า,8818,8827,17645,8826,8837,17663,6816
2564,62,กำแพงเพชร,6279,ท้องถิ่นเทศบาลตำบลบ้านพราน,3532,3505,7037,3554,3524,7078,2901
2564,62,กำแพงเพชร,6280,ท้องถิ่นเทศบาลตำบลระหาน,3522,3653,7175,3549,3679,7228,3583
2564,62,กำแพงเพชร,6281,ท้องถิ่นเทศบาลตำบลคลองพิไกร,2861,3029,5890,2863,3031,5894,2247
2564,62,กำแพงเพชร,6282,ท้องถิ่นเทศบาลตำบลนิคมทุ่งโพธิ์ทะเล,4518,4659,9177,4526,4669,9195,3669
2564,62,กำแพงเพชร,6283,ท้องถิ่นเทศบาลตำบลวังยาง,2708,2759,5467,2716,2769,5485,2141
2564,62,กำแพงเพชร,6284,ท้องถิ่นเทศบาลตำบลทุ่งทราย,4303,4443,8746,4309,4447,8756,3271
2564,62,กำแพงเพชร,6285,ท้องถิ่นเทศบาลตำบลเทพนคร,9738,10253,19991,9748,10261,20009,8468
2564,62,กำแพงเพชร,6286,ท้องถิ่นเทศบาลตำบลคลองลานพัฒนา,10985,11442,22427,11041,11496,22537,8568
2564,62,กำแพงเพชร,6287,ท้องถิ่นเทศบาลตำบลช่องลม,2834,2860,5694,2836,2862,5698,1786
2564,62,กำแพงเพชร,6288,ท้องถิ่นเทศบาลตำบลลานกระบือ,2073,2140,4213,2089,2158,4247,2542
2564,62,กำแพงเพชร,6289,ท้องถิ่นเทศบาลตำบลพรานกระต่าย,4137,4486,8623,4142,4489,8631,3707
2564,62,กำแพงเพชร,6290,ท้องถิ่นเทศบาลตำบลท่ามะเขือ,1750,1879,3629,1762,1886,3648,2024
2564,62,กำแพงเพชร,6291,ท้องถิ่นเทศบาลตำบลท่าพุทรา,731,766,1497,733,766,1499,629
2564,62,กำแพงเพชร,6292,ท้องถิ่นเทศบาลตำบลคลองขลุง,917,1003,1920,934,1015,1949,1025
2564,62,กำแพงเพชร,6293,ท้องถิ่นเทศบาลตำบลสลกบาตร,3877,4233,8110,3893,4261,8154,4448
2564,62,กำแพงเพชร,6294,ท้องถิ่นเทศบาลตำบลขาณุวรลักษบุรี,3815,4096,7911,3880,4165,8045,3436
2564,62,กำแพงเพชร,6295,ท้องถิ่นเทศบาลตำบลไทรงาม,2366,2552,4918,2373,2567,4940,2476
2564,62,กำแพงเพชร,6296,ท้องถิ่นเทศบาลตำบลปากดง,1536,1677,3213,1539,1679,3218,1331
2564,62,กำแพงเพชร,6297,ท้องถิ่นเทศบาลตำบลนครชุม,3183,3632,6815,3192,3637,6829,3496
2564,62,กำแพงเพชร,6298,ท้องถิ่นเทศบาลตำบลคลองแม่ลาย,2823,2987,5810,2828,2993,5821,2445
2564,62,กำแพงเพชร,6299,ท้องถิ่นเทศบาลเมืองกำแพงเพชร,13026,14738,27764,13225,14900,28125,16416
2564,63,ตาก,6301,อำเภอเมืองตาก,36987,37459,74446,37081,37533,74614,29646
2564,63,ตาก,6302,อำเภอบ้านตาก,15503,15752,31255,15545,15787,31332,10961
2564,63,ตาก,6303,อำเภอสามเงา,12583,12979,25562,12595,12993,25588,9545
2564,63,ตาก,6304,อำเภอแม่ระมาด,21157,20581,41738,25724,24441,50165,17011
2564,63,ตาก,6305,อำเภอท่าสองยาง,35545,33987,69532,47222,44532,91754,24262
2564,63,ตาก,6306,อำเภอแม่สอด,38483,38657,77140,49705,48819,98524,36877
2564,63,ตาก,6307,อำเภอพบพระ,30297,29665,59962,43505,41787,85292,20497
2564,63,ตาก,6308,อำเภออุ้มผาง,15921,14925,30846,22923,21191,44114,11377
2564,63,ตาก,6309,อำเภอวังเจ้า,14557,14426,28983,15134,15022,30156,9218
2564,63,ตาก,6386,ท้องถิ่นเทศบาลตำบลไม้งาม,6441,5210,11651,6455,5220,11675,6394
2564,63,ตาก,6387,ท้องถิ่นเทศบาลตำบลวังเจ้า,2086,2119,4205,2088,2122,4210,1954
2564,63,ตาก,6388,ท้องถิ่นเทศบาลตำบลอุ้มผาง,840,869,1709,1968,1853,3821,918
2564,63,ตาก,6389,ท้องถิ่นเทศบาลตำบลพบพระ,2505,2415,4920,3325,3125,6450,2751
2564,63,ตาก,6390,ท้องถิ่นเทศบาลตำบลแม่กุ,3114,3232,6346,3203,3334,6537,2967
2564,63,ตาก,6391,ท้องถิ่นเทศบาลตำบลท่าสายลวด,3013,2987,6000,12653,11931,24584,4736
2564,63,ตาก,6392,ท้องถิ่นเทศบาลตำบลแม่ต้าน,1288,1339,2627,1957,2006,3963,1391
2564,63,ตาก,6393,ท้องถิ่นเทศบาลตำบลแม่ระมาด,1851,1869,3720,1990,1994,3984,1871
2564,63,ตาก,6394,ท้องถิ่นเทศบาลตำบลแม่จะเรา,2513,2655,5168,2552,2703,5255,2165
2564,63,ตาก,6395,ท้องถิ่นเทศบาลตำบลสามเงา,2154,2404,4558,2160,2406,4566,2139
2564,63,ตาก,6396,ท้องถิ่นเทศบาลตำบลบ้านตาก,2970,3468,6438,2994,3483,6477,2726
2564,63,ตาก,6397,ท้องถิ่นเทศบาลตำบลทุ่งกระเชาะ,2982,3046,6028,2985,3052,6037,2125
2564,63,ตาก,6398,ท้องถิ่นเทศบาลนครแม่สอด,13051,14049,27100,20727,20881,41608,19723
2564,63,ตาก,6399,ท้องถิ่นเทศบาลเมืองตาก,7322,8273,15595,7475,8402,15877,7482
2564,64,สุโขทัย,6401,อำเภอเมืองสุโขทัย,29172,31597,60769,29203,31614,60817,22988
2564,64,สุโขทัย,6402,อำเภอบ้านด่านลานหอย,22003,22091,44094,22111,22186,44297,14540
2564,64,สุโขทัย,6403,อำเภอคีรีมาศ,22767,23306,46073,22785,23321,46106,14443
2564,64,สุโขทัย,6404,อำเภอกงไกรลาศ,28858,30346,59204,28873,30358,59231,20626
2564,64,สุโขทัย,6405,อำเภอศรีสัชนาลัย,34210,35417,69627,34254,35462,69716,27009
2564,64,สุโขทัย,6406,อำเภอศรีสำโรง,29381,31895,61276,29412,31916,61328,22617
2564,64,สุโขทัย,6407,อำเภอสวรรคโลก,24008,26039,50047,24021,26049,50070,20207
2564,64,สุโขทัย,6408,อำเภอศรีนคร,10939,11538,22477,10953,11545,22498,8200
2564,64,สุโขทัย,6409,อำเภอทุ่งเสลี่ยม,20588,21126,41714,20620,21145,41765,14864
2564,64,สุโขทัย,6484,ท้องถิ่นเทศบาลตำบลในเมือง,3960,4178,8138,3964,4182,8146,3390
2564,64,สุโขทัย,6485,ท้องถิ่นเทศบาลตำบลป่ากุมเกาะ,3721,3983,7704,3722,3985,7707,2800
2564,64,สุโขทัย,6486,ท้องถิ่นเทศบาลตำบลบ้านกล้วย,7491,8516,16007,7504,8532,16036,7193
2564,64,สุโขทัย,6487,ท้องถิ่นเทศบาลตำบลทุ่งเสลี่ยม,3446,3851,7297,3450,3860,7310,3039
2564,64,สุโขทัย,6488,ท้องถิ่นเทศบาลตำบลศรีนคร,1415,1628,3043,1420,1632,3052,1692
2564,64,สุโขทัย,6489,ท้องถิ่นเทศบาลตำบลศรีสำโรง,3344,3889,7233,3351,3895,7246,3508
2564,64,สุโขทัย,6490,ท้องถิ่นเทศบาลตำบลหาดเสี้ยว,3080,3469,6549,3084,3474,6558,3637
2564,64,สุโขทัย,6491,ท้องถิ่นเทศบาลเมืองศรีสัชนาลัย,7159,7867,15026,7159,7868,15027,5837
2564,64,สุโขทัย,6492,ท้องถิ่นเทศบาลตำบลกงไกรลาศ,1921,2152,4073,1923,2153,4076,2053
2564,64,สุโขทัย,6493,ท้องถิ่นเทศบาลตำบลบ้านโตนด,1419,1598,3017,1421,1598,3019,1638
2564,64,สุโขทัย,6494,ท้องถิ่นเทศบาลตำบลทุ่งหลวง,3399,3703,7102,3400,3703,7103,2398
2564,64,สุโขทัย,6495,ท้องถิ่นเทศบาลตำบลลานหอย,1728,1847,3575,1732,1848,3580,1719
2564,64,สุโขทัย,6496,ท้องถิ่นเทศบาลตำบลเมืองเก่า,3318,3832,7150,3322,3832,7154,2645
2564,64,สุโขทัย,6497,ท้องถิ่นเทศบาลตำบลบ้านสวน,2057,2273,4330,2057,2274,4331,1717
2564,64,สุโขทัย,6498,ท้องถิ่นเทศบาลเมืองสวรรคโลก,7128,7994,15122,7150,8008,15158,6767
2564,64,สุโขทัย,6499,ท้องถิ่นเทศบาลเมืองสุโขทัยธานี,6515,7474,13989,6538,7483,14021,7103
2564,65,พิษณุโลก,6501,อำเภอเมืองพิษณุโลก,86249,92763,179012,86421,92836,179257,86797
2564,65,พิษณุโลก,6502,อำเภอนครไทย,33262,33679,66941,33324,33736,67060,23890
2564,65,พิษณุโลก,6503,อำเภอชาติตระการ,18161,17753,35914,18208,17788,35996,12390
2564,65,พิษณุโลก,6504,อำเภอบางระกำ,36578,37799,74377,36631,37858,74489,26305
2564,65,พิษณุโลก,6505,อำเภอบางกระทุ่ม,15840,16754,32594,15849,16771,32620,11878
2564,65,พิษณุโลก,6506,อำเภอพรหมพิราม,39464,41494,80958,39496,41513,81009,30884
2564,65,พิษณุโลก,6507,อำเภอวัดโบสถ์,14654,14909,29563,14662,14919,29581,11298
2564,65,พิษณุโลก,6508,อำเภอวังทอง,56158,57702,113860,56392,57835,114227,44017
2564,65,พิษณุโลก,6509,อำเภอเนินมะปราง,19086,19326,38412,19101,19336,38437,14864
2564,65,พิษณุโลก,6580,ท้องถิ่นเทศบาลเมืองอรัญญิก,16686,13505,30191,16726,13527,30253,14162
2564,65,พิษณุโลก,6581,ท้องถิ่นเทศบาลตำบลบ้านมุง,3440,3480,6920,3450,3485,6935,2614
2564,65,พิษณุโลก,6582,ท้องถิ่นเทศบาลตำบลบึงระมาณ,2121,2276,4397,2124,2279,4403,1688
2564,65,พิษณุโลก,6583,ท้องถิ่นเทศบาลตำบลพลายชุมพล,3580,4076,7656,3591,4079,7670,4304
2564,65,พิษณุโลก,6584,ท้องถิ่นเทศบาลตำบลพันเสา,2992,3071,6063,2996,3074,6070,2100
2564,65,พิษณุโลก,6585,ท้องถิ่นเทศบาลตำบลไทรย้อย,4195,4295,8490,4201,4296,8497,3173
2564,65,พิษณุโลก,6586,ท้องถิ่นเทศบาลตำบลบ้านแยง,5033,4896,9929,5056,4923,9979,5012
2564,65,พิษณุโลก,6587,ท้องถิ่นเทศบาลตำบลเนินมะปราง,1679,1794,3473,1687,1795,3482,1638
2564,65,พิษณุโลก,6588,ท้องถิ่นเทศบาลตำบลวังทอง,1991,2273,4264,1996,2278,4274,1718
2564,65,พิษณุโลก,6589,ท้องถิ่นเทศบาลตำบลวัดโบสถ์,3795,4210,8005,3802,4212,8014,4020
2564,65,พิษณุโลก,6590,ท้องถิ่นเทศบาลตำบลวงฆ้อง,1512,1576,3088,1516,1576,3092,1556
2564,65,พิษณุโลก,6591,ท้องถิ่นเทศบาลตำบลพรหมพิราม,512,597,1109,516,601,1117,547
2564,65,พิษณุโลก,6592,ท้องถิ่นเทศบาลตำบลบางกระทุ่ม,663,700,1363,664,701,1365,621
2564,65,พิษณุโลก,6593,ท้องถิ่นเทศบาลตำบลเนินกุ่ม,5800,6123,11923,5807,6126,11933,4572
2564,65,พิษณุโลก,6594,ท้องถิ่นเทศบาลตำบลปลักแรด,1692,1863,3555,1696,1865,3561,1312
2564,65,พิษณุโลก,6595,ท้องถิ่นเทศบาลตำบลบางระกำ,2011,2218,4229,2013,2222,4235,1989
2564,65,พิษณุโลก,6596,ท้องถิ่นเทศบาลตำบลป่าแดง,2616,2735,5351,2621,2740,5361,2599
2564,65,พิษณุโลก,6597,ท้องถิ่นเทศบาลตำบลนครไทย,4303,4618,8921,4317,4623,8940,4126
2564,65,พิษณุโลก,6598,ท้องถิ่นเทศบาลตำบลบ้านใหม่,920,1014,1934,923,1016,1939,798
2564,65,พิษณุโลก,6599,ท้องถิ่นเทศบาลนครพิษณุโลก,28598,34666,63264,28791,34797,63588,37164
2564,66,พิจิตร,6601,อำเภอเมืองพิจิตร,35203,37570,72773,35236,37588,72824,26567
2564,66,พิจิตร,6602,อำเภอวังทรายพูน,8623,8808,17431,8630,8815,17445,5929
2564,66,พิจิตร,6603,อำเภอโพธิ์ประทับช้าง,16666,17174,33840,16684,17196,33880,11647
2564,66,พิจิตร,6604,อำเภอตะพานหิน,21895,22996,44891,21916,23009,44925,16039
2564,66,พิจิตร,6605,อำเภอบางมูลนาก,9828,10510,20338,9838,10520,20358,7989
2564,66,พิจิตร,6606,อำเภอโพทะเล,26591,27802,54393,26620,27822,54442,18904
2564,66,พิจิตร,6607,อำเภอสามง่าม,12719,12960,25679,12722,12964,25686,8813
2564,66,พิจิตร,6608,อำเภอทับคล้อ,16488,17105,33593,16492,17113,33605,12735
2564,66,พิจิตร,6609,อำเภอสากเหล็ก,8934,9087,18021,8939,9092,18031,6158
2564,66,พิจิตร,6610,อำเภอบึงนาราง,14111,14685,28796,14126,14699,28825,10875
2564,66,พิจิตร,6611,อำเภอดงเจริญ,8472,8750,17222,8489,8757,17246,6350
2564,66,พิจิตร,6612,อำเภอวชิรบารมี,15280,15672,30952,15292,15683,30975,11047
2564,66,พิจิตร,6676,ท้องถิ่นเทศบาลตำบลหนองพยอม,3300,3434,6734,3302,3434,6736,2325
2564,66,พิจิตร,6677,ท้องถิ่นเทศบาลตำบลหนองปล้อง,1656,1728,3384,1657,1728,3385,1156
2564,66,พิจิตร,6678,ท้องถิ่นเทศบาลตำบลเนินมะกอก,3243,3510,6753,3252,3527,6779,3021
2564,66,พิจิตร,6679,ท้องถิ่นเทศบาลตำบลหอไกร,2859,3006,5865,2868,3018,5886,2706
2564,66,พิจิตร,6680,ท้องถิ่นเทศบาลตำบลดงป่าคำ,2333,2427,4760,2333,2427,4760,1620
2564,66,พิจิตร,6681,ท้องถิ่นเทศบาลตำบลเนินปอ,4512,4538,9050,4512,4540,9052,3121
2564,66,พิจิตร,6682,ท้องถิ่นเทศบาลตำบลสำนักขุนเณร,1093,1104,2197,1094,1108,2202,901
2564,66,พิจิตร,6683,ท้องถิ่นเทศบาลตำบลสากเหล็ก,2474,2733,5207,2478,2736,5214,2395
2564,66,พิจิตร,6684,ท้องถิ่นเทศบาลตำบลทับคล้อ,2071,2272,4343,2076,2275,4351,1766
2564,66,พิจิตร,6685,ท้องถิ่นเทศบาลตำบลเขาทราย,2125,2184,4309,2126,2184,4310,1910
2564,66,พิจิตร,6686,ท้องถิ่นเทศบาลตำบลสามง่าม,2218,2533,4751,2219,2534,4753,2265
2564,66,พิจิตร,6687,ท้องถิ่นเทศบาลตำบลกำแพงดิน,1036,1122,2158,1037,1124,2161,823
2564,66,พิจิตร,6688,ท้องถิ่นเทศบาลตำบลโพทะเล,1171,1269,2440,1173,1270,2443,1020
2564,66,พิจิตร,6689,ท้องถิ่นเทศบาลตำบลท่าเสา,741,724,1465,741,724,1465,525
2564,66,พิจิตร,6690,ท้องถิ่นเทศบาลตำบลวังตะกู,804,788,1592,810,790,1600,651
2564,66,พิจิตร,6691,ท้องถิ่นเทศบาลตำบลบางไผ่,723,774,1497,724,777,1501,630
2564,66,พิจิตร,6692,ท้องถิ่นเทศบาลตำบลโพธิ์ประทับช้าง,4548,4881,9429,4560,4889,9449,3530
2564,66,พิจิตร,6693,ท้องถิ่นเทศบาลตำบลวังทรายพูน,1624,1664,3288,1625,1665,3290,1247
2564,66,พิจิตร,6694,ท้องถิ่นเทศบาลตำบลหัวดง,1498,1607,3105,1507,1611,3118,1190
2564,66,พิจิตร,6695,ท้องถิ่นเทศบาลตำบลวังกรด,1475,1503,2978,1479,1506,2985,1051
2564,66,พิจิตร,6696,ท้องถิ่นเทศบาลตำบลท่าฬ่อ,1519,1669,3188,1521,1673,3194,1199
2564,66,พิจิตร,6697,ท้องถิ่นเทศบาลเมืองบางมูลนาก,3827,4217,8044,3842,4223,8065,3698
2564,66,พิจิตร,6698,ท้องถิ่นเทศบาลเมืองตะพานหิน,6240,7227,13467,6275,7251,13526,6277
2564,66,พิจิตร,6699,ท้องถิ่นเทศบาลเมืองพิจิตร,9766,11076,20842,9817,11111,20928,12520
2564,67,เพชรบูรณ์,6701,อำเภอเมืองเพชรบูรณ์,79994,79751,159745,80211,79812,160023,62884
2564,67,เพชรบูรณ์,6702,อำเภอชนแดน,33952,34068,68020,33976,34087,68063,28177
2564,67,เพชรบูรณ์,6703,อำเภอหล่มสัก,70091,73804,143895,70205,73840,144045,49318
2564,67,เพชรบูรณ์,6704,อำเภอหล่มเก่า,29113,30446,59559,29157,30493,59650,18966
2564,67,เพชรบูรณ์,6705,อำเภอวิเชียรบุรี,49335,50591,99926,49393,50612,100005,33788
2564,67,เพชรบูรณ์,6706,อำเภอศรีเทพ,28168,28566,56734,28206,28597,56803,19738
2564,67,เพชรบูรณ์,6707,อำเภอหนองไผ่,37757,38183,75940,37796,38215,76011,25261
2564,67,เพชรบูรณ์,6708,อำเภอบึงสามพัน,31017,31678,62695,31058,31702,62760,25826
2564,67,เพชรบูรณ์,6709,อำเภอน้ำหนาว,9544,9111,18655,9552,9115,18667,7165
2564,67,เพชรบูรณ์,6710,อำเภอวังโป่ง,14013,14309,28322,14023,14321,28344,9341
2564,67,เพชรบูรณ์,6711,อำเภอเขาค้อ,17480,17509,34989,17743,17820,35563,12257
2564,67,เพชรบูรณ์,6778,ท้องถิ่นเทศบาลตำบลแคมป์สน,2626,2792,5418,2639,2794,5433,3098
2564,67,เพชรบูรณ์,6779,ท้องถิ่นเทศบาลตำบลโคกสะอาด,3247,3282,6529,3249,3286,6535,2196
2564,67,เพชรบูรณ์,6780,ท้องถิ่นเทศบาลตำบลบัววัฒนา,2924,2925,5849,2926,2925,5851,1912
2564,67,เพชรบูรณ์,6781,ท้องถิ่นเทศบาลตำบลบ่อไทย,4689,4876,9565,4698,4886,9584,3013
2564,67,เพชรบูรณ์,6782,ท้องถิ่นเทศบาลตำบลนางั่ว,5954,6801,12755,6030,6804,12834,5719
2564,67,เพชรบูรณ์,6783,ท้องถิ่นเทศบาลตำบลเฉลียงทอง,3739,3753,7492,3744,3754,7498,2581
2564,67,เพชรบูรณ์,6784,ท้องถิ่นเทศบาลตำบลวังโป่ง,1808,2016,3824,1810,2021,3831,1521
2564,67,เพชรบูรณ์,6785,ท้องถิ่นเทศบาลตำบลท้ายดง,1640,1750,3390,1641,1753,3394,1069
2564,67,เพชรบูรณ์,6786,ท้องถิ่นเทศบาลตำบลซับสมอทอด,4164,4335,8499,4197,4370,8567,5123
2564,67,เพชรบูรณ์,6787,ท้องถิ่นเทศบาลตำบลหนองไผ่,3462,3805,7267,3470,3811,7281,3854
2564,67,เพชรบูรณ์,6788,ท้องถิ่นเทศบาลตำบลนาเฉลียง,2018,2230,4248,2023,2232,4255,1738
2564,67,เพชรบูรณ์,6789,ท้องถิ่นเทศบาลตำบลสว่างวัฒนา,3119,3389,6508,3126,3390,6516,2918
2564,67,เพชรบูรณ์,6790,ท้องถิ่นเทศบาลเมืองวิเชียรบุรี,10490,11679,22169,10577,11704,22281,8765
2564,67,เพชรบูรณ์,6791,ท้องถิ่นเทศบาลตำบลพุเตย,3571,3726,7297,3577,3727,7304,3028
2564,67,เพชรบูรณ์,6792,ท้องถิ่นเทศบาลตำบลหล่มเก่า,2748,3055,5803,2754,3055,5809,2644
2564,67,เพชรบูรณ์,6793,ท้องถิ่นเทศบาลตำบลท่าข้าม,1225,1214,2439,1227,1216,2443,976
2564,67,เพชรบูรณ์,6794,ท้องถิ่นเทศบาลตำบลดงขุย,1224,1351,2575,1225,1351,2576,1044
2564,67,เพชรบูรณ์,6795,ท้องถิ่นเทศบาลตำบลชนแดน,1742,1651,3393,1749,1653,3402,1831
2564,67,เพชรบูรณ์,6796,ท้องถิ่นเทศบาลตำบลวังชมภู,1627,1862,3489,1636,1866,3502,1327
2564,67,เพชรบูรณ์,6797,ท้องถิ่นเทศบาลตำบลท่าพล,3607,3962,7569,3621,3970,7591,2591
2564,67,เพชรบูรณ์,6798,ท้องถิ่นเทศบาลเมืองหล่มสัก,5367,5986,11353,5396,5996,11392,6607
2564,67,เพชรบูรณ์,6799,ท้องถิ่นเทศบาลเมืองเพชรบูรณ์,9562,10942,20504,9599,10960,20559,12722
2564,70,ราชบุรี,7001,อำเภอเมืองราชบุรี,59804,62898,122702,60426,63432,123858,48875
2564,70,ราชบุรี,7002,อำเภอจอมบึง,28194,29004,57198,28416,29220,57636,19537
2564,70,ราชบุรี,7003,อำเภอสวนผึ้ง,15176,14478,29654,24429,22479,46908,14759
2564,70,ราชบุรี,7004,อำเภอดำเนินสะดวก,35102,37642,72744,35358,37863,73221,23546
2564,70,ราชบุรี,7005,อำเภอบ้านโป่ง,46217,50430,96647,46425,50614,97039,37564
2564,70,ราชบุรี,7006,อำเภอบางแพ,8496,9279,17775,8531,9310,17841,6636
2564,70,ราชบุรี,7007,อำเภอโพธาราม,34611,36827,71438,34752,36979,71731,25691
2564,70,ราชบุรี,7008,อำเภอปากท่อ,24516,25668,50184,25052,26162,51214,18864
2564,70,ราชบุรี,7009,อำเภอวัดเพลง,5114,5627,10741,5119,5632,10751,3702
2564,70,ราชบุรี,7010,อำเภอบ้านคา,12237,11869,24106,12911,12389,25300,9724
2564,70,ราชบุรี,7070,ท้องถิ่นเทศบาลตำบลดอนทราย,3313,3676,6989,3362,3710,7072,3143
2564,70,ราชบุรี,7071,ท้องถิ่นเทศบาลตำบลหลุมดิน,2509,2611,5120,2524,2622,5146,1782
2564,70,ราชบุรี,7072,ท้องถิ่นเทศบาลตำบลเบิกไพร,7542,8519,16061,7560,8535,16095,6693
2564,70,ราชบุรี,7073,ท้องถิ่นเทศบาลตำบลทุ่งหลวง,6859,6916,13775,6896,6943,13839,4397
2564,70,ราชบุรี,7074,ท้องถิ่นเทศบาลตำบลบ้านฆ้อง,4048,4501,8549,4073,4529,8602,3545
2564,70,ราชบุรี,7075,ท้องถิ่นเทศบาลตำบลกรับใหญ่,6175,6709,12884,6195,6716,12911,3887
2564,70,ราชบุรี,7076,ท้องถิ่นเทศบาลตำบลบ้านสิงห์,5724,6308,12032,5756,6336,12092,4564
2564,70,ราชบุรี,7077,ท้องถิ่นเทศบาลตำบลวัดเพลง,650,700,1350,662,716,1378,561
2564,70,ราชบุรี,7078,ท้องถิ่นเทศบาลตำบลปากท่อ,1350,1426,2776,1359,1427,2786,1400
2564,70,ราชบุรี,7079,ท้องถิ่นเทศบาลตำบลหนองโพ,1784,2030,3814,1788,2039,3827,2179
2564,70,ราชบุรี,7080,ท้องถิ่นเทศบาลตำบลบ้านเลือก,5172,5703,10875,5191,5721,10912,5186
2564,70,ราชบุรี,7081,ท้องถิ่นเทศบาลตำบลเจ็ดเสมียน,2692,2970,5662,2730,3016,5746,2295
2564,70,ราชบุรี,7082,ท้องถิ่นเทศบาลตำบลเขาขวาง,3491,3774,7265,3496,3782,7278,2651
2564,70,ราชบุรี,7083,ท้องถิ่นเทศบาลตำบลโพหัก,5071,5403,10474,5080,5411,10491,3723
2564,70,ราชบุรี,7084,ท้องถิ่นเทศบาลตำบลบางแพ,7550,8344,15894,7629,8412,16041,6622
2564,70,ราชบุรี,7085,ท้องถิ่นเทศบาลตำบลห้วยกระบอก,800,847,1647,814,853,1667,735
2564,70,ราชบุรี,7086,ท้องถิ่นเทศบาลเมืองท่าผา,9695,10352,20047,9744,10388,20132,8281
2564,70,ราชบุรี,7087,ท้องถิ่นเทศบาลตำบลกระจับ,3625,4061,7686,3680,4095,7775,3781
2564,70,ราชบุรี,7088,ท้องถิ่นเทศบาลตำบลศรีดอนไผ่,5008,5560,10568,5032,5576,10608,3420
2564,70,ราชบุรี,7089,ท้องถิ่นเทศบาลตำบลดำเนินสะดวก,3310,3807,7117,3325,3814,7139,3282
2564,70,ราชบุรี,7090,ท้องถิ่นเทศบาลตำบลสวนผึ้ง,1673,1678,3351,1710,1709,3419,1857
2564,70,ราชบุรี,7091,ท้องถิ่นเทศบาลตำบลบ้านชัฏป่าหวาย,1843,1865,3708,1940,1933,3873,1913
2564,70,ราชบุรี,7092,ท้องถิ่นเทศบาลตำบลด่านทับตะโก,1239,1197,2436,1241,1200,2441,837
2564,70,ราชบุรี,7093,ท้องถิ่นเทศบาลตำบลจอมบึง,2266,2596,4862,2272,2599,4871,3658
2564,70,ราชบุรี,7094,ท้องถิ่นเทศบาลตำบลห้วยชินสีห์,5385,5833,11218,5413,5861,11274,4415
2564,70,ราชบุรี,7095,ท้องถิ่นเทศบาลตำบลหลักเมือง,9442,7974,17416,9489,8010,17499,7110
2564,70,ราชบุรี,7096,ท้องถิ่นเทศบาลตำบลเขางู,4342,4790,9132,4365,4816,9181,2937
2564,70,ราชบุรี,7097,ท้องถิ่นเทศบาลเมืองโพธาราม,3764,4184,7948,4039,4449,8488,3758
2564,70,ราชบุรี,7098,ท้องถิ่นเทศบาลเมืองบ้านโป่ง,7018,8140,15158,7396,8499,15895,8293
2564,70,ราชบุรี,7099,ท้องถิ่นเทศบาลเมืองราชบุรี,14951,17814,32765,15741,18563,34304,16411
2564,71,กาญจนบุรี,7101,อำเภอเมืองกาญจนบุรี,51382,41148,92530,54635,43547,98182,39445
2564,71,กาญจนบุรี,7102,อำเภอไทรโยค,22005,21355,43360,31049,29036,60085,21095
2564,71,กาญจนบุรี,7103,อำเภอบ่อพลอย,24020,24060,48080,24105,24145,48250,18764
2564,71,กาญจนบุรี,7104,อำเภอศรีสวัสดิ์,12256,11676,23932,13311,12531,25842,10200
2564,71,กาญจนบุรี,7105,อำเภอท่ามะกา,43476,46151,89627,43765,46433,90198,31243
2564,71,กาญจนบุรี,7106,อำเภอท่าม่วง,28039,29824,57863,28196,29950,58146,24148
2564,71,กาญจนบุรี,7107,อำเภอทองผาภูมิ,21803,20335,42138,34485,32005,66490,27861
2564,71,กาญจนบุรี,7108,อำเภอสังขละบุรี,10816,10180,20996,21928,20463,42391,12329
2564,71,กาญจนบุรี,7109,อำเภอพนมทวน,15855,16737,32592,15874,16757,32631,11322
2564,71,กาญจนบุรี,7110,อำเภอเลาขวัญ,26571,26808,53379,26640,26857,53497,18449
2564,71,กาญจนบุรี,7111,อำเภอด่านมะขามเตี้ย,15593,15644,31237,15670,15703,31373,11046
2564,71,กาญจนบุรี,7112,อำเภอหนองปรือ,13684,13290,26974,13782,13361,27143,9603
2564,71,กาญจนบุรี,7113,อำเภอห้วยกระเจา,16612,17161,33773,16664,17188,33852,11963
2564,71,กาญจนบุรี,7167,ท้องถิ่นเทศบาลตำบลรางหวาย,3624,3620,7244,3636,3627,7263,2590
2564,71,กาญจนบุรี,7168,ท้องถิ่นเทศบาลตำบลหนองสาหร่าย,1715,1938,3653,1730,1944,3674,1211
2564,71,กาญจนบุรี,7169,ท้องถิ่นเทศบาลเมืองปากแพรก,13042,14640,27682,13165,14734,27899,15817
2564,71,กาญจนบุรี,7170,ท้องถิ่นเทศบาลตำบลวังศาลา,5707,6066,11773,5727,6093,11820,5200
2564,71,กาญจนบุรี,7171,ท้องถิ่นเทศบาลตำบลท่าล้อ,4278,4788,9066,4312,4808,9120,3961
2564,71,กาญจนบุรี,7172,ท้องถิ่นเทศบาลตำบลวังขนาย,4396,4826,9222,4433,4846,9279,3918
2564,71,กาญจนบุรี,7173,ท้องถิ่นเทศบาลตำบลหนองปรือ,2132,2253,4385,2136,2256,4392,1802
2564,71,กาญจนบุรี,7174,ท้องถิ่นเทศบาลตำบลด่านมะขามเตี้ย,1189,1244,2433,1234,1263,2497,1283
2564,71,กาญจนบุรี,7175,ท้องถิ่นเทศบาลตำบลหนองฝ้าย,1022,1110,2132,1063,1148,2211,959
2564,71,กาญจนบุรี,7176,ท้องถิ่นเทศบาลตำบลเลาขวัญ,1316,1306,2622,1323,1307,2630,1337
2564,71,กาญจนบุรี,7177,ท้องถิ่นเทศบาลตำบลตลาดเขต,1901,2154,4055,1908,2162,4070,1816
2564,71,กาญจนบุรี,7178,ท้องถิ่นเทศบาลตำบลพนมทวน,2420,2719,5139,2464,2748,5212,2200
2564,71,กาญจนบุรี,7179,ท้องถิ่นเทศบาลตำบลวังกะ,3482,3309,6791,4700,4563,9263,2586
2564,71,กาญจนบุรี,7180,ท้องถิ่นเทศบาลตำบลทองผาภูมิ,1419,1363,2782,1595,1519,3114,1602
2564,71,กาญจนบุรี,7181,ท้องถิ่นเทศบาลตำบลหนองตากยา,1451,1537,2988,1456,1540,2996,966
2564,71,กาญจนบุรี,7182,ท้องถิ่นเทศบาลตำบลหนองขาว,2380,2659,5039,2393,2662,5055,1616
2564,71,กาญจนบุรี,7183,ท้องถิ่นเทศบาลตำบลสำรอง,882,935,1817,888,936,1824,637
2564,71,กาญจนบุรี,7184,ท้องถิ่นเทศบาลตำบลท่าม่วง,4429,5161,9590,4577,5311,9888,5513
2564,71,กาญจนบุรี,7185,ท้องถิ่นเทศบาลตำบลหวายเหนียว,2066,2229,4295,2081,2245,4326,1884
2564,71,กาญจนบุรี,7186,ท้องถิ่นเทศบาลตำบลพระแท่น,2949,3211,6160,2960,3219,6179,2162
2564,71,กาญจนบุรี,7187,ท้องถิ่นเทศบาลตำบลท่าไม้,4370,4714,9084,4394,4723,9117,3893
2564,71,กาญจนบุรี,7188,ท้องถิ่นเทศบาลตำบลท่ามะกา,3485,4077,7562,3971,4533,8504,4723
2564,71,กาญจนบุรี,7189,ท้องถิ่นเทศบาลตำบลลูกแก,1649,1885,3534,1653,1887,3540,1515
2564,71,กาญจนบุรี,7190,ท้องถิ่นเทศบาลตำบลเอราวัณ,458,482,940,458,482,940,726
2564,71,กาญจนบุรี,7191,ท้องถิ่นเทศบาลตำบลหนองรี,1028,1093,2121,1030,1093,2123,803
2564,71,กาญจนบุรี,7192,ท้องถิ่นเทศบาลตำบลบ่อพลอย,3370,3447,6817,3453,3508,6961,2726
2564,71,กาญจนบุรี,7193,ท้องถิ่นเทศบาลตำบลวังโพธิ์,945,927,1872,1053,1010,2063,890
2564,71,กาญจนบุรี,7194,ท้องถิ่นเทศบาลตำบลน้ำตกไทรโยคน้อย,1927,1995,3922,1944,2007,3951,1605
2564,71,กาญจนบุรี,7195,ท้องถิ่นเทศบาลตำบลหนองบัว,3165,3502,6667,3182,3516,6698,3046
2564,71,กาญจนบุรี,7196,ท้องถิ่นเทศบาลตำบลลาดหญ้า,2635,2868,5503,2649,2877,5526,2365
2564,71,กาญจนบุรี,7197,ท้องถิ่นเทศบาลตำบลแก่งเสี้ยน,2954,3405,6359,2966,3420,6386,3791
2564,71,กาญจนบุรี,7198,ท้องถิ่นเทศบาลเมืองท่าเรือพระแท่น,5176,5772,10948,5216,5812,11028,5083
2564,71,กาญจนบุรี,7199,ท้องถิ่นเทศบาลเมืองกาญจนบุรี,12135,13700,25835,12458,13967,26425,15985
2564,72,สุพรรณบุรี,7201,อำเภอเมืองสุพรรณบุรี,51009,56217,107226,51107,56297,107404,38697
2564,72,สุพรรณบุรี,7202,อำเภอเดิมบางนางบวช,20027,21484,41511,20061,21508,41569,15342
2564,72,สุพรรณบุรี,7203,อำเภอด่านช้าง,30260,31084,61344,30384,31157,61541,23813
2564,72,สุพรรณบุรี,7204,อำเภอบางปลาม้า,28489,30047,58536,28525,30099,58624,19833
2564,72,สุพรรณบุรี,7205,อำเภอศรีประจันต์,19164,20993,40157,19192,21024,40216,15170
2564,72,สุพรรณบุรี,7206,อำเภอดอนเจดีย์,19519,20805,40324,19536,20821,40357,14693
2564,72,สุพรรณบุรี,7207,อำเภอสองพี่น้อง,53909,56104,110013,54092,56265,110357,36313
2564,72,สุพรรณบุรี,7208,อำเภอสามชุก,19022,20617,39639,19057,20635,39692,14969
2564,72,สุพรรณบุรี,7209,อำเภออู่ทอง,31502,33343,64845,31610,33434,65044,21560
2564,72,สุพรรณบุรี,7210,อำเภอหนองหญ้าไซ,22574,23674,46248,22587,23691,46278,16597
2564,72,สุพรรณบุรี,7265,ท้องถิ่นเทศบาลตำบลปากน้ำ,2142,2358,4500,2143,2360,4503,1775
2564,72,สุพรรณบุรี,7266,ท้องถิ่นเทศบาลตำบลท้าวอู่ทอง,7618,8090,15708,7644,8106,15750,5911
2564,72,สุพรรณบุรี,7267,ท้องถิ่นเทศบาลตำบลกระจัน,3578,3757,7335,3583,3761,7344,1983
2564,72,สุพรรณบุรี,7268,ท้องถิ่นเทศบาลตำบลบ้านโข้ง,4455,4559,9014,4455,4561,9016,3112
2564,72,สุพรรณบุรี,7269,ท้องถิ่นเทศบาลตำบลเดิมบาง,3143,3598,6741,3145,3603,6748,2828
2564,72,สุพรรณบุรี,7270,ท้องถิ่นเทศบาลตำบลบางกุ้ง,912,981,1893,917,984,1901,588
2564,72,สุพรรณบุรี,7271,ท้องถิ่นเทศบาลตำบลท่าระหัด,4157,4911,9068,4174,4925,9099,5046
2564,72,สุพรรณบุรี,7272,ท้องถิ่นเทศบาลตำบลตะค่า,2630,2829,5459,2632,2832,5464,1928
2564,72,สุพรรณบุรี,7273,ท้องถิ่นเทศบาลตำบลบ้านดอน,3663,3910,7573,3665,3917,7582,2054
2564,72,สุพรรณบุรี,7274,ท้องถิ่นเทศบาลตำบลต้นคราม,2564,2847,5411,2586,2869,5455,2043
2564,72,สุพรรณบุรี,7275,ท้องถิ่นเทศบาลตำบลปลายนา,3964,4315,8279,3966,4318,8284,2904
2564,72,สุพรรณบุรี,7276,ท้องถิ่นเทศบาลตำบลขุนพัดเพ็ง,2684,2702,5386,2693,2706,5399,1859
2564,72,สุพรรณบุรี,7277,ท้องถิ่นเทศบาลตำบลวังยาง,3291,3610,6901,3297,3614,6911,2776
2564,72,สุพรรณบุรี,7278,ท้องถิ่นเทศบาลตำบลเขาดิน,2943,3100,6043,2944,3101,6045,2107
2564,72,สุพรรณบุรี,7279,ท้องถิ่นเทศบาลตำบลหนองหญ้าไซ,1198,1313,2511,1198,1313,2511,1101
2564,72,สุพรรณบุรี,7280,ท้องถิ่นเทศบาลตำบลอู่ทอง,3522,3935,7457,3536,3944,7480,3672
2564,72,สุพรรณบุรี,7281,ท้องถิ่นเทศบาลตำบลสระยายโสม,1328,1484,2812,1334,1487,2821,1059
2564,72,สุพรรณบุรี,7282,ท้องถิ่นเทศบาลตำบลสามชุก,5994,6748,12742,6012,6759,12771,6814
2564,72,สุพรรณบุรี,7283,ท้องถิ่นเทศบาลตำบลทุ่งคอก,1505,1767,3272,1521,1779,3300,1277
2564,72,สุพรรณบุรี,7284,ท้องถิ่นเทศบาลตำบลสระกระโจม,1212,1188,2400,1215,1190,2405,999
2564,72,สุพรรณบุรี,7285,ท้องถิ่นเทศบาลตำบลดอนเจดีย์,1373,1450,2823,1423,1491,2914,1370
2564,72,สุพรรณบุรี,7286,ท้องถิ่นเทศบาลตำบลศรีประจันต์,2628,3004,5632,2644,3013,5657,2625
2564,72,สุพรรณบุรี,7287,ท้องถิ่นเทศบาลตำบลไผ่กองดิน,822,870,1692,822,876,1698,619
2564,72,สุพรรณบุรี,7288,ท้องถิ่นเทศบาลตำบลบ้านแหลม,587,598,1185,588,600,1188,449
2564,72,สุพรรณบุรี,7289,ท้องถิ่นเทศบาลตำบลบางปลาม้า,910,959,1869,941,963,1904,671
2564,72,สุพรรณบุรี,7290,ท้องถิ่นเทศบาลตำบลโคกคราม,729,804,1533,734,806,1540,865
2564,72,สุพรรณบุรี,7291,ท้องถิ่นเทศบาลตำบลด่านช้าง,2892,3184,6076,2913,3205,6118,3362
2564,72,สุพรรณบุรี,7292,ท้องถิ่นเทศบาลตำบลบ่อกรุ,932,1039,1971,932,1039,1971,755
2564,72,สุพรรณบุรี,7293,ท้องถิ่นเทศบาลตำบลนางบวช,2100,2248,4348,2101,2250,4351,1648
2564,72,สุพรรณบุรี,7294,ท้องถิ่นเทศบาลตำบลเขาพระ,2559,2988,5547,2585,3009,5594,3271
2564,72,สุพรรณบุรี,7295,ท้องถิ่นเทศบาลตำบลสวนแตง,3172,3369,6541,3185,3376,6561,2308
2564,72,สุพรรณบุรี,7296,ท้องถิ่นเทศบาลตำบลโพธิ์พระยา,1495,1858,3353,1499,1860,3359,1707
2564,72,สุพรรณบุรี,7297,ท้องถิ่นเทศบาลตำบลท่าเสด็จ,6693,7137,13830,6714,7154,13868,4429
2564,72,สุพรรณบุรี,7298,ท้องถิ่นเทศบาลเมืองสองพี่น้อง,5644,6374,12018,5753,6496,12249,5199
2564,72,สุพรรณบุรี,7299,ท้องถิ่นเทศบาลเมืองสุพรรณบุรี,11002,13082,24084,11238,13279,24517,13035
2564,73,นครปฐม,7301,อำเภอเมืองนครปฐม,82972,90112,173084,83222,90322,173544,67628
2564,73,นครปฐม,7302,อำเภอกำแพงแสน,57755,61003,118758,58144,61354,119498,39713
2564,73,นครปฐม,7303,อำเภอนครชัยศรี,48023,53081,101104,48201,53249,101450,39698
2564,73,นครปฐม,7304,อำเภอดอนตูม,17273,17987,35260,17293,18003,35296,11143
2564,73,นครปฐม,7305,อำเภอบางเลน,39029,40079,79108,39556,40586,80142,29331
2564,73,นครปฐม,7306,อำเภอสามพราน,47070,52153,99223,47339,52399,99738,49870
2564,73,นครปฐม,7307,อำเภอพุทธมณฑล,9955,11698,21653,10053,11804,21857,11693
2564,73,นครปฐม,7380,ท้องถิ่นเทศบาลตำบลบ่อพลับ,4511,5012,9523,4546,5026,9572,4874
2564,73,นครปฐม,7381,ท้องถิ่นเทศบาลตำบลบางกระทึก,6479,7496,13975,6507,7518,14025,8898
2564,73,นครปฐม,7382,ท้องถิ่นเทศบาลเมืองกระทุ่มล้ม,13199,15255,28454,13261,15308,28569,18657
2564,73,นครปฐม,7383,ท้องถิ่นเทศบาลเมืองไร่ขิง,15220,17390,32610,15978,18142,34120,24922
2564,73,นครปฐม,7384,ท้องถิ่นเทศบาลเมืองคลองโยง,5052,5610,10662,5080,5636,10716,4468
2564,73,นครปฐม,7385,ท้องถิ่นเทศบาลตำบลศาลายา,6164,5248,11412,6181,5260,11441,7585
2564,73,นครปฐม,7386,ท้องถิ่นเทศบาลตำบลอ้อมใหญ่,11432,12561,23993,11528,12668,24196,21871
2564,73,นครปฐม,7387,ท้องถิ่นเทศบาลเมืองสามพราน,7890,7377,15267,8664,8103,16767,8820
2564,73,นครปฐม,7388,ท้องถิ่นเทศบาลตำบลลำพญา,905,977,1882,909,979,1888,626
2564,73,นครปฐม,7389,ท้องถิ่นเทศบาลตำบลรางกระทุ่ม,1013,1076,2089,1020,1080,2100,698
2564,73,นครปฐม,7390,ท้องถิ่นเทศบาลตำบลบางหลวง,1013,1085,2098,1017,1088,2105,779
2564,73,นครปฐม,7391,ท้องถิ่นเทศบาลตำบลบางเลน,3860,3947,7807,4173,4209,8382,4193
2564,73,นครปฐม,7392,ท้องถิ่นเทศบาลตำบลสามง่าม,6561,7157,13718,6619,7218,13837,4922
2564,73,นครปฐม,7393,ท้องถิ่นเทศบาลตำบลห้วยพลู,909,1021,1930,1033,1144,2177,895
2564,73,นครปฐม,7394,ท้องถิ่นเทศบาลตำบลนครชัยศรี,3678,4409,8087,3684,4412,8096,5088
2564,73,นครปฐม,7395,ท้องถิ่นเทศบาลตำบลกำแพงแสน,3188,3572,6760,3204,3579,6783,4261
2564,73,นครปฐม,7396,ท้องถิ่นเทศบาลตำบลโพรงมะเดื่อ,5145,5648,10793,5159,5660,10819,4247
2564,73,นครปฐม,7397,ท้องถิ่นเทศบาลตำบลธรรมศาลา,3290,3637,6927,3305,3641,6946,2990
2564,73,นครปฐม,7398,ท้องถิ่นเทศบาลตำบลดอนยายหอม,3115,3343,6458,3123,3349,6472,2231
2564,73,นครปฐม,7399,ท้องถิ่นเทศบาลนครนครปฐม,32324,36194,68518,34001,37634,71635,37814
2564,74,สมุทรสาคร,7401,อำเภอเมืองสมุทรสาคร,96330,105721,202051,98024,107139,205163,116242
2564,74,สมุทรสาคร,7402,อำเภอกระทุ่มแบน,31051,33630,64681,31558,34117,65675,38851
2564,74,สมุทรสาคร,7403,อำเภอบ้านแพ้ว,23927,26043,49970,24026,26136,50162,15917
2564,74,สมุทรสาคร,7491,ท้องถิ่นเทศบาลตำบลสวนหลวง,17675,17886,35561,17771,17979,35750,21954
2564,74,สมุทรสาคร,7492,ท้องถิ่นเทศบาลตำบลนาดี,13182,14663,27845,13271,14723,27994,16661
2564,74,สมุทรสาคร,7493,ท้องถิ่นเทศบาลตำบลหลักห้า,20330,21545,41875,20367,21583,41950,10713
2564,74,สมุทรสาคร,7494,ท้องถิ่นเทศบาลตำบลบ้านแพ้ว,1217,1337,2554,1529,1661,3190,1054
2564,74,สมุทรสาคร,7495,ท้องถิ่นเทศบาลตำบลเกษตรพัฒนา,2453,2633,5086,2470,2654,5124,1590
2564,74,สมุทรสาคร,7496,ท้องถิ่นเทศบาลตำบลบางปลา,3409,3678,7087,3416,3680,7096,4512
2564,74,สมุทรสาคร,7497,ท้องถิ่นเทศบาลนครอ้อมน้อย,25278,27975,53253,25426,28104,53530,49523
2564,74,สมุทรสาคร,7498,ท้องถิ่นเทศบาลเมืองกระทุ่มแบน,8596,9618,18214,13263,13894,27157,6653
2564,74,สมุทรสาคร,7499,ท้องถิ่นเทศบาลนครสมุทรสาคร,21292,23031,44323,31562,32436,63998,18948
2564,75,สมุทรสงคราม,7501,อำเภอเมืองสมุทรสงคราม,37518,40848,78366,37620,40950,78570,32614
2564,75,สมุทรสงคราม,7502,อำเภอบางคนที,12901,14225,27126,12922,14236,27158,9997
2564,75,สมุทรสงคราม,7503,อำเภออัมพวา,22907,24837,47744,22932,24866,47798,15811
2564,75,สมุทรสงคราม,7595,ท้องถิ่นเทศบาลตำบลเหมืองใหม่,934,997,1931,935,998,1933,778
2564,75,สมุทรสงคราม,7596,ท้องถิ่นเทศบาลตำบลบางนกแขวก,778,936,1714,782,940,1722,854
2564,75,สมุทรสงคราม,7597,ท้องถิ่นเทศบาลตำบลกระดังงา,1002,1149,2151,1009,1156,2165,862
2564,75,สมุทรสงคราม,7598,ท้องถิ่นเทศบาลตำบลอัมพวา,2200,2399,4599,2204,2409,4613,1989
2564,75,สมุทรสงคราม,7599,ท้องถิ่นเทศบาลเมืองสมุทรสงคราม,11963,13469,25432,12697,14186,26883,11035
2564,76,เพชรบุรี,7601,อำเภอเมืองเพชรบุรี,42344,48115,90459,42377,48147,90524,35630
2564,76,เพชรบุรี,7602,อำเภอเขาย้อย,11430,12070,23500,11460,12089,23549,10382
2564,76,เพชรบุรี,7603,อำเภอหนองหญ้าปล้อง,8178,8136,16314,8200,8170,16370,6907
2564,76,เพชรบุรี,7604,อำเภอชะอำ,10823,11034,21857,10883,11061,21944,8701
2564,76,เพชรบุรี,7605,อำเภอท่ายาง,23771,25121,48892,23800,25131,48931,20054
2564,76,เพชรบุรี,7606,อำเภอบ้านลาด,22998,25167,48165,23023,25188,48211,15936
2564,76,เพชรบุรี,7607,อำเภอบ้านแหลม,17699,18483,36182,17721,18491,36212,11719
2564,76,เพชรบุรี,7608,อำเภอแก่งกระจาน,16516,15551,32067,17393,16222,33615,15529
2564,76,เพชรบุรี,7688,ท้องถิ่นเทศบาลตำบลท่าแลง,2983,3236,6219,2984,3237,6221,2189
2564,76,เพชรบุรี,7689,ท้องถิ่นเทศบาลตำบลบ้านแหลม,5533,5972,11505,5572,6003,11575,4242
2564,76,เพชรบุรี,7690,ท้องถิ่นเทศบาลตำบลบางตะบูน,2464,2594,5058,2465,2595,5060,1877
2564,76,เพชรบุรี,7691,ท้องถิ่นเทศบาลตำบลบ้านลาด,1690,1979,3669,1693,1979,3672,1693
2564,76,เพชรบุรี,7692,ท้องถิ่นเทศบาลตำบลหนองจอก,1276,1435,2711,1279,1436,2715,1033
2564,76,เพชรบุรี,7693,ท้องถิ่นเทศบาลตำบลท่ายาง,13181,14667,27848,13256,14736,27992,11600
2564,76,เพชรบุรี,7694,ท้องถิ่นเทศบาลตำบลนายาง,9060,9769,18829,9135,9800,18935,7244
2564,76,เพชรบุรี,7695,ท้องถิ่นเทศบาลตำบลเขาย้อย,6956,7696,14652,7229,7984,15213,8201
2564,76,เพชรบุรี,7696,ท้องถิ่นเทศบาลตำบลหาดเจ้าสำราญ,2381,2573,4954,2389,2574,4963,2572
2564,76,เพชรบุรี,7697,ท้องถิ่นเทศบาลตำบลหัวสะพาน,2804,3113,5917,2807,3114,5921,2019
2564,76,เพชรบุรี,7698,ท้องถิ่นเทศบาลเมืองชะอำ,18869,21028,39897,19453,21209,40662,46704
2564,76,เพชรบุรี,7699,ท้องถิ่นเทศบาลเมืองเพชรบุรี,9538,10518,20056,9808,10782,20590,10338
2564,77,ประจวบคีรีขันธ์,7701,อำเภอเมืองประจวบคีรีขันธ์,32009,32094,64103,32461,32410,64871,26640
2564,77,ประจวบคีรีขันธ์,7702,อำเภอกุยบุรี,17020,17551,34571,17147,17678,34825,11337
2564,77,ประจวบคีรีขันธ์,7703,อำเภอทับสะแก,20409,21105,41514,21249,21770,43019,15089
2564,77,ประจวบคีรีขันธ์,7704,อำเภอบางสะพาน,29650,30313,59963,30506,31083,61589,26778
2564,77,ประจวบคีรีขันธ์,7705,อำเภอบางสะพานน้อย,17904,18086,35990,18337,18444,36781,16300
2564,77,ประจวบคีรีขันธ์,7706,อำเภอปราณบุรี,27879,24649,52528,28513,25020,53533,27593
2564,77,ประจวบคีรีขันธ์,7707,อำเภอหัวหิน,25000,27441,52441,26237,28102,54339,29376
2564,77,ประจวบคีรีขันธ์,7708,อำเภอสามร้อยยอด,15547,15916,31463,15668,15969,31637,12565
2564,77,ประจวบคีรีขันธ์,7785,ท้องถิ่นเทศบาลตำบลไร่เก่า,5194,5309,10503,5251,5361,10612,4211
2564,77,ประจวบคีรีขันธ์,7786,ท้องถิ่นเทศบาลตำบลหนองพลับ,2262,2469,4731,2274,2476,4750,2882
2564,77,ประจวบคีรีขันธ์,7787,ท้องถิ่นเทศบาลตำบลปากน้ำปราณ,3896,3884,7780,3917,3900,7817,3497
2564,77,ประจวบคีรีขันธ์,7788,ท้องถิ่นเทศบาลตำบลปราณบุรี,7867,8632,16499,7920,8664,16584,9446
2564,77,ประจวบคีรีขันธ์,7789,ท้องถิ่นเทศบาลตำบลบางสะพานน้อย,1448,1456,2904,1464,1467,2931,1531
2564,77,ประจวบคีรีขันธ์,7790,ท้องถิ่นเทศบาลตำบลร่อนทอง,3788,3930,7718,3844,3962,7806,3419
2564,77,ประจวบคีรีขันธ์,7791,ท้องถิ่นเทศบาลตำบลบ้านกรูด,1949,2163,4112,1970,2174,4144,2328
2564,77,ประจวบคีรีขันธ์,7792,ท้องถิ่นเทศบาลตำบลกำเนิดนพคุณ,1267,1308,2575,1284,1322,2606,1633
2564,77,ประจวบคีรีขันธ์,7793,ท้องถิ่นเทศบาลตำบลทับสะแก,3067,3430,6497,3084,3447,6531,3495
2564,77,ประจวบคีรีขันธ์,7794,ท้องถิ่นเทศบาลตำบลไร่ใหม่,3588,3904,7492,3734,4027,7761,2911
2564,77,ประจวบคีรีขันธ์,7795,ท้องถิ่นเทศบาลตำบลกุยบุรี,4164,4534,8698,4183,4549,8732,4250
2564,77,ประจวบคีรีขันธ์,7796,ท้องถิ่นเทศบาลตำบลคลองวาฬ,2117,2259,4376,2131,2267,4398,1857
2564,77,ประจวบคีรีขันธ์,7797,ท้องถิ่นเทศบาลตำบล กม.5,1708,1874,3582,1742,1885,3627,1407
2564,77,ประจวบคีรีขันธ์,7798,ท้องถิ่นเทศบาลนครหัวหิน,30699,32460,63159,32770,33418,66188,57375
2564,77,ประจวบคีรีขันธ์,7799,ท้องถิ่นเทศบาลเมืองประจวบคีรีขันธ์,8010,9437,17447,8363,9727,18090,11016
2564,80,นครศรีธรรมราช,8001,อำเภอเมืองนครศรีธรรมราช,78138,80561,158699,78202,80585,158787,63325
2564,80,นครศรีธรรมราช,8002,อำเภอพรหมคีรี,13491,13894,27385,13496,13896,27392,9141
2564,80,นครศรีธรรมราช,8003,อำเภอลานสกา,19160,20144,39304,19163,20149,39312,14708
2564,80,นครศรีธรรมราช,8004,อำเภอฉวาง,25857,27256,53113,25947,27345,53292,19303
2564,80,นครศรีธรรมราช,8005,อำเภอพิปูน,8883,9125,18008,8888,9132,18020,7335
2564,80,นครศรีธรรมราช,8006,อำเภอเชียรใหญ่,20206,20156,40362,20217,20164,40381,14599
2564,80,นครศรีธรรมราช,8007,อำเภอชะอวด,40861,41556,82417,40885,41579,82464,30094
2564,80,นครศรีธรรมราช,8008,อำเภอท่าศาลา,55844,59031,114875,55921,59074,114995,36584
2564,80,นครศรีธรรมราช,8009,อำเภอทุ่งสง,59416,57428,116844,59635,57641,117276,48188
2564,80,นครศรีธรรมราช,8010,อำเภอนาบอน,11904,12145,24049,11962,12216,24178,8605
2564,80,นครศรีธรรมราช,8011,อำเภอทุ่งใหญ่,34641,34935,69576,34654,34940,69594,24356
2564,80,นครศรีธรรมราช,8012,อำเภอปากพนัง,39198,38634,77832,39209,38649,77858,26242
2564,80,นครศรีธรรมราช,8013,อำเภอร่อนพิบูลย์,30670,30861,61531,30691,30883,61574,20405
2564,80,นครศรีธรรมราช,8014,อำเภอสิชล,40443,41020,81463,40556,41100,81656,29288
2564,80,นครศรีธรรมราช,8015,อำเภอขนอม,10046,10317,20363,10076,10341,20417,9721
2564,80,นครศรีธรรมราช,8016,อำเภอหัวไทร,21873,22148,44021,21888,22152,44040,17883
2564,80,นครศรีธรรมราช,8017,อำเภอบางขัน,23984,23485,47469,24007,23506,47513,16804
2564,80,นครศรีธรรมราช,8018,อำเภอถ้ำพรรณรา,9615,9629,19244,9634,9645,19279,7464
2564,80,นครศรีธรรมราช,8019,อำเภอจุฬาภรณ์,15533,15970,31503,15535,15972,31507,10844
2564,80,นครศรีธรรมราช,8020,อำเภอพระพรหม,21983,22660,44643,21988,22665,44653,16637
2564,80,นครศรีธรรมราช,8021,อำเภอนบพิตำ,16863,16797,33660,16864,16798,33662,12161
2564,80,นครศรีธรรมราช,8022,อำเภอช้างกลาง,13929,14443,28372,13932,14446,28378,11030
2564,80,นครศรีธรรมราช,8023,อำเภอเฉลิมพระเกียรติ,11094,11216,22310,11099,11217,22316,8017
2564,80,นครศรีธรรมราช,8070,ท้องถิ่นเทศบาลตำบลหน้าสตน,4102,4114,8216,4108,4120,8228,2930
2564,80,นครศรีธรรมราช,8071,ท้องถิ่นเทศบาลตำบลเขาพระ,4068,4086,8154,4069,4086,8155,3369
2564,80,นครศรีธรรมราช,8072,ท้องถิ่นเทศบาลตำบลเกาะเพชร,3473,3375,6848,3474,3378,6852,2162
2564,80,นครศรีธรรมราช,8073,ท้องถิ่นเทศบาลตำบลทางพูน,4533,4369,8902,4535,4370,8905,2888
2564,80,นครศรีธรรมราช,8074,ท้องถิ่นเทศบาลตำบลที่วัง,7171,7191,14362,7176,7193,14369,6481
2564,80,นครศรีธรรมราช,8075,ท้องถิ่นเทศบาลตำบลท้องเนียน,2796,2802,5598,2803,2803,5606,3297
2564,80,นครศรีธรรมราช,8076,ท้องถิ่นเทศบาลตำบลหัวไทร,1982,2147,4129,1986,2152,4138,1852
2564,80,นครศรีธรรมราช,8077,ท้องถิ่นเทศบาลตำบลขนอม,2016,2046,4062,2190,2224,4414,2466
2564,80,นครศรีธรรมราช,8078,ท้องถิ่นเทศบาลตำบลสิชล,3178,3457,6635,3345,3612,6957,4038
2564,80,นครศรีธรรมราช,8079,ท้องถิ่นเทศบาลตำบลหินตก,4178,4162,8340,4179,4164,8343,2810
2564,80,นครศรีธรรมราช,8080,ท้องถิ่นเทศบาลตำบลร่อนพิบูลย์,3626,3986,7612,3641,3991,7632,3337
2564,80,นครศรีธรรมราช,8081,ท้องถิ่นเทศบาลตำบลเขาชุมทอง,2101,2242,4343,2103,2243,4346,1384
2564,80,นครศรีธรรมราช,8082,ท้องถิ่นเทศบาลตำบลท่ายาง,2375,2593,4968,2457,2712,5169,3050
2564,80,นครศรีธรรมราช,8083,ท้องถิ่นเทศบาลตำบลนาบอน,1063,1130,2193,1075,1145,2220,1147
2564,80,นครศรีธรรมราช,8084,ท้องถิ่นเทศบาลตำบลท่าศาลา,1352,1501,2853,1354,1502,2856,1784
2564,80,นครศรีธรรมราช,8085,ท้องถิ่นเทศบาลตำบลชะอวด,1611,1875,3486,1613,1875,3488,1663
2564,80,นครศรีธรรมราช,8086,ท้องถิ่นเทศบาลตำบลเชียรใหญ่,795,818,1613,796,818,1614,760
2564,80,นครศรีธรรมราช,8087,ท้องถิ่นเทศบาลตำบลพิปูน,1314,1403,2717,1315,1403,2718,1132
2564,80,นครศรีธรรมราช,8088,ท้องถิ่นเทศบาลตำบลไม้เรียง,1138,1212,2350,1145,1220,2365,1249
2564,80,นครศรีธรรมราช,8089,ท้องถิ่นเทศบาลตำบลฉวาง,1201,1257,2458,1203,1258,2461,1288
2564,80,นครศรีธรรมราช,8090,ท้องถิ่นเทศบาลตำบลจันดี,3406,3811,7217,3451,3845,7296,3989
2564,80,นครศรีธรรมราช,8091,ท้องถิ่นเทศบาลตำบลลานสกา,871,911,1782,872,911,1783,1019
2564,80,นครศรีธรรมราช,8092,ท้องถิ่นเทศบาลตำบลพรหมโลก,3322,3454,6776,3329,3465,6794,2736
2564,80,นครศรีธรรมราช,8093,ท้องถิ่นเทศบาลตำบลทอนหงส์,1715,1725,3440,1718,1727,3445,1082
2564,80,นครศรีธรรมราช,8094,ท้องถิ่นเทศบาลตำบลปากนคร,3180,3120,6300,3180,3121,6301,2039
2564,80,นครศรีธรรมราช,8095,ท้องถิ่นเทศบาลตำบลบางจาก,873,948,1821,873,948,1821,669
2564,80,นครศรีธรรมราช,8096,ท้องถิ่นเทศบาลตำบลท่าแพ,1928,2020,3948,1931,2022,3953,1294
2564,80,นครศรีธรรมราช,8097,ท้องถิ่นเทศบาลเมืองทุ่งสง,13530,16073,29603,13544,16080,29624,11499
2564,80,นครศรีธรรมราช,8098,ท้องถิ่นเทศบาลเมืองปากพนัง,9481,9766,19247,9511,9784,19295,8015
2564,80,นครศรีธรรมราช,8099,ท้องถิ่นเทศบาลนครนครศรีธรรมราช,46871,52509,99380,47046,52606,99652,46813
2564,81,กระบี่,8101,อำเภอเมืองกระบี่,36536,37302,73838,36797,37434,74231,39148
2564,81,กระบี่,8102,อำเภอเขาพนม,25164,25012,50176,25217,25072,50289,18186
2564,81,กระบี่,8103,อำเภอเกาะลันตา,17592,17203,34795,17684,17257,34941,14812
2564,81,กระบี่,8104,อำเภอคลองท่อม,36289,35305,71594,36355,35386,71741,25162
2564,81,กระบี่,8105,อำเภออ่าวลึก,23246,23527,46773,23276,23556,46832,16649
2564,81,กระบี่,8106,อำเภอปลายพระยา,16257,16193,32450,16272,16213,32485,11125
2564,81,กระบี่,8107,อำเภอลำทับ,10277,10030,20307,10284,10032,20316,7383
2564,81,กระบี่,8108,อำเภอเหนือคลอง,29891,30421,60312,29939,30467,60406,20616
2564,81,กระบี่,8189,ท้องถิ่นเทศบาลตำบลกระบี่น้อย,9050,9316,18366,9061,9330,18391,8762
2564,81,กระบี่,8190,ท้องถิ่นเทศบาลตำบลเหนือคลอง,2034,2231,4265,2045,2235,4280,2434
2564,81,กระบี่,8191,ท้องถิ่นเทศบาลตำบลลำทับ,2067,2218,4285,2107,2254,4361,2395
2564,81,กระบี่,8192,ท้องถิ่นเทศบาลตำบลปลายพระยา,3040,3027,6067,3047,3043,6090,2531
2564,81,กระบี่,8193,ท้องถิ่นเทศบาลตำบลอ่าวลึกใต้,2662,2859,5521,2689,2879,5568,2974
2564,81,กระบี่,8194,ท้องถิ่นเทศบาลตำบลแหลมสัก,2079,2044,4123,2079,2045,4124,1254
2564,81,กระบี่,8195,ท้องถิ่นเทศบาลตำบลคลองพน,1395,1470,2865,1395,1472,2867,1313
2564,81,กระบี่,8196,ท้องถิ่นเทศบาลตำบลคลองท่อมใต้,1647,1804,3451,1648,1804,3452,1791
2564,81,กระบี่,8197,ท้องถิ่นเทศบาลตำบลเกาะลันตาใหญ่,565,586,1151,565,586,1151,500
2564,81,กระบี่,8198,ท้องถิ่นเทศบาลตำบลเขาพนม,2652,2879,5531,2714,2923,5637,2498
2564,81,กระบี่,8199,ท้องถิ่นเทศบาลเมืองกระบี่,14403,16848,31251,14918,17271,32189,17848
2564,82,พังงา,8201,อำเภอเมืองพังงา,15481,15932,31413,15501,15951,31452,12463
2564,82,พังงา,8202,อำเภอเกาะยาว,6859,6755,13614,6909,6798,13707,5409
2564,82,พังงา,8203,อำเภอกะปง,6662,6597,13259,6721,6640,13361,6027
2564,82,พังงา,8204,อำเภอตะกั่วทุ่ง,19687,19535,39222,19768,19625,39393,16132
2564,82,พังงา,8205,อำเภอตะกั่วป่า,19983,20407,40390,20838,21151,41989,24053
2564,82,พังงา,8206,อำเภอคุระบุรี,12196,11967,24163,12372,12159,24531,10359
2564,82,พังงา,8207,อำเภอทับปุด,12534,12458,24992,12554,12489,25043,8202
2564,82,พังงา,8208,อำเภอท้ายเหมือง,22945,22206,45151,23117,22326,45443,21029
2564,82,พังงา,8291,ท้องถิ่นเทศบาลตำบลท้ายเหมือง,1551,1681,3232,1558,1686,3244,1763
2564,82,พังงา,8292,ท้องถิ่นเทศบาลตำบลทับปุด,486,507,993,489,509,998,655
2564,82,พังงา,8293,ท้องถิ่นเทศบาลตำบลคุระบุรี,1662,1677,3339,1737,1739,3476,2145
2564,82,พังงา,8294,ท้องถิ่นเทศบาลเมืองโคกกลอย,1619,1790,3409,1712,1870,3582,1729
2564,82,พังงา,8295,ท้องถิ่นเทศบาลตำบลกระโสม,842,955,1797,843,959,1802,780
2564,82,พังงา,8296,ท้องถิ่นเทศบาลตำบลท่านา,498,534,1032,501,535,1036,595
2564,82,พังงา,8297,ท้องถิ่นเทศบาลตำบลเกาะยาว,411,419,830,412,419,831,499
2564,82,พังงา,8298,ท้องถิ่นเทศบาลเมืองตะกั่วป่า,3832,4192,8024,3846,4196,8042,2730
2564,82,พังงา,8299,ท้องถิ่นเทศบาลเมืองพังงา,4338,4681,9019,4907,5179,10086,5981
2564,83,ภูเก็ต,8301,อำเภอเมืองภูเก็ต,20742,23684,44426,20958,23776,44734,30801
2564,83,ภูเก็ต,8302,อำเภอกะทู้,3271,3635,6906,3345,3665,7010,6723
2564,83,ภูเก็ต,8303,อำเภอถลาง,45903,48648,94551,46430,48902,95332,71666
2564,83,ภูเก็ต,8391,ท้องถิ่นเทศบาลตำบลวิชิต,24380,27786,52166,24798,28156,52954,34915
2564,83,ภูเก็ต,8392,ท้องถิ่นเทศบาลตำบลราไวย์,8555,9916,18471,8785,9988,18773,19684
2564,83,ภูเก็ต,8393,ท้องถิ่นเทศบาลตำบลรัษฎา,23085,25814,48899,23389,26073,49462,30760
2564,83,ภูเก็ต,8394,ท้องถิ่นเทศบาลตำบลเทพกระษัตรี,4249,4558,8807,4655,4906,9561,5085
2564,83,ภูเก็ต,8395,ท้องถิ่นเทศบาลตำบลเชิงทะเล,3068,3787,6855,3131,3837,6968,3679
2564,83,ภูเก็ต,8396,ท้องถิ่นเทศบาลเมืองกะทู้,13808,16394,30202,14155,16467,30622,21671
2564,83,ภูเก็ต,8397,ท้องถิ่นเทศบาลตำบลกะรน,3534,3887,7421,3579,3915,7494,8835
2564,83,ภูเก็ต,8398,ท้องถิ่นเทศบาลเมืองป่าตอง,8592,9493,18085,9371,10134,19505,16523
2564,83,ภูเก็ต,8399,ท้องถิ่นเทศบาลนครภูเก็ต,32236,38339,70575,35278,41092,76370,26770
2564,84,สุราษฎร์ธานี,8401,อำเภอเมืองสุราษฎร์ธานี,8749,9247,17996,8756,9257,18013,7752
2564,84,สุราษฎร์ธานี,8402,อำเภอกาญจนดิษฐ์,39906,40628,80534,39998,40716,80714,33595
2564,84,สุราษฎร์ธานี,8403,อำเภอดอนสัก,12406,12473,24879,12420,12481,24901,10566
2564,84,สุราษฎร์ธานี,8405,อำเภอเกาะพะงัน,5042,5080,10122,5572,5382,10954,12409
2564,84,สุราษฎร์ธานี,8406,อำเภอไชยา,18878,19732,38610,18909,19753,38662,16904
2564,84,สุราษฎร์ธานี,8407,อำเภอท่าชนะ,25924,25712,51636,25956,25740,51696,22770
2564,84,สุราษฎร์ธานี,8408,อำเภอคีรีรัฐนิคม,21092,21183,42275,21143,21253,42396,17134
2564,84,สุราษฎร์ธานี,8409,อำเภอบ้านตาขุน,4559,4590,9149,4563,4592,9155,3960
2564,84,สุราษฎร์ธานี,8410,อำเภอพนม,12454,12014,24468,12466,12021,24487,9501
2564,84,สุราษฎร์ธานี,8411,อำเภอท่าฉาง,14793,14635,29428,14807,14644,29451,13124
2564,84,สุราษฎร์ธานี,8412,อำเภอบ้านนาสาร,25124,25753,50877,25133,25768,50901,18419
2564,84,สุราษฎร์ธานี,8413,อำเภอบ้านนาเดิม,10341,10541,20882,10345,10542,20887,7797
2564,84,สุราษฎร์ธานี,8414,อำเภอเคียนซา,13763,13736,27499,13877,13850,27727,11336
2564,84,สุราษฎร์ธานี,8415,อำเภอเวียงสระ,8496,8743,17239,8498,8744,17242,6944
2564,84,สุราษฎร์ธานี,8416,อำเภอพระแสง,31475,31266,62741,31484,31278,62762,24538
2564,84,สุราษฎร์ธานี,8417,อำเภอพุนพิน,37709,37232,74941,37823,37354,75177,35948
2564,84,สุราษฎร์ธานี,8418,อำเภอชัยบุรี,14176,13994,28170,14191,14011,28202,11467
2564,84,สุราษฎร์ธานี,8419,อำเภอวิภาวดี,8129,7543,15672,8194,7605,15799,7396
2564,84,สุราษฎร์ธานี,8471,ท้องถิ่นเทศบาลตำบลบ้านเสด็จ,9770,9509,19279,9773,9509,19282,7802
2564,84,สุราษฎร์ธานี,8472,ท้องถิ่นเทศบาลตำบลคลองชะอุ่น,4817,4748,9565,4817,4751,9568,3415
2564,84,สุราษฎร์ธานี,8473,ท้องถิ่นเทศบาลตำบลทุ่งหลวง,5462,5772,11234,5463,5772,11235,4214
2564,84,สุราษฎร์ธานี,8474,ท้องถิ่นเทศบาลตำบลขุนทะเล,7948,10949,18897,7966,11031,18997,11374
2564,84,สุราษฎร์ธานี,8475,ท้องถิ่นเทศบาลตำบลช้างซ้าย,5515,5584,11099,5525,5592,11117,3957
2564,84,สุราษฎร์ธานี,8476,ท้องถิ่นเทศบาลตำบลเขานิพันธ์,3317,3356,6673,3317,3356,6673,2915
2564,84,สุราษฎร์ธานี,8477,ท้องถิ่นเทศบาลตำบลวัดประดู่,9175,10162,19337,9190,10166,19356,11250
2564,84,สุราษฎร์ธานี,8478,ท้องถิ่นเทศบาลตำบลบ้านส้อง,8697,8867,17564,8698,8869,17567,6909
2564,84,สุราษฎร์ธานี,8479,ท้องถิ่นเทศบาลตำบลย่านดินแดง,1165,1209,2374,1188,1225,2413,1082
2564,84,สุราษฎร์ธานี,8480,ท้องถิ่นเทศบาลตำบลบางสวรรค์,2042,2044,4086,2042,2044,4086,1966
2564,84,สุราษฎร์ธานี,8481,ท้องถิ่นเทศบาลเมืองเวียงสระ,4368,4870,9238,4440,4944,9384,5822
2564,84,สุราษฎร์ธานี,8482,ท้องถิ่นเทศบาลตำบลเคียนซา,864,828,1692,864,828,1692,748
2564,84,สุราษฎร์ธานี,8483,ท้องถิ่นเทศบาลตำบลบ้านนา,1572,1673,3245,1584,1682,3266,1665
2564,84,สุราษฎร์ธานี,8484,ท้องถิ่นเทศบาลตำบลท่าฉาง,2233,2410,4643,2262,2438,4700,1938
2564,84,สุราษฎร์ธานี,8485,ท้องถิ่นเทศบาลตำบลพนม,2468,2421,4889,2486,2439,4925,2002
2564,84,สุราษฎร์ธานี,8486,ท้องถิ่นเทศบาลตำบลบ้านตาขุน,1148,1221,2369,1150,1222,2372,1833
2564,84,สุราษฎร์ธานี,8487,ท้องถิ่นเทศบาลตำบลบ้านเชี่ยวหลาน,2283,2250,4533,2285,2250,4535,1992
2564,84,สุราษฎร์ธานี,8488,ท้องถิ่นเทศบาลตำบลท่าขนอน,937,940,1877,944,942,1886,1105
2564,84,สุราษฎร์ธานี,8489,ท้องถิ่นเทศบาลตำบลท่าชนะ,1370,1532,2902,1371,1534,2905,1762
2564,84,สุราษฎร์ธานี,8490,ท้องถิ่นเทศบาลตำบลพุมเรียง,3830,4040,7870,3830,4041,7871,2804
2564,84,สุราษฎร์ธานี,8491,ท้องถิ่นเทศบาลตำบลตลาดไชยา,2285,2600,4885,2457,2770,5227,2919
2564,84,สุราษฎร์ธานี,8492,ท้องถิ่นเทศบาลตำบลเกาะพะงัน,3537,3707,7244,3752,3801,7553,5598
2564,84,สุราษฎร์ธานี,8493,ท้องถิ่นเทศบาลนครเกาะสมุย,30889,33946,64835,32701,35239,67940,57051
2564,84,สุราษฎร์ธานี,8494,ท้องถิ่นเทศบาลเมืองดอนสัก,5854,6196,12050,5881,6223,12104,5832
2564,84,สุราษฎร์ธานี,8495,ท้องถิ่นเทศบาลตำบลท่าทองใหม่,3525,3601,7126,3527,3604,7131,3186
2564,84,สุราษฎร์ธานี,8496,ท้องถิ่นเทศบาลตำบลกาญจนดิษฐ์,4536,4940,9476,4539,4942,9481,4770
2564,84,สุราษฎร์ธานี,8497,ท้องถิ่นเทศบาลเมืองท่าข้าม,8882,9430,18312,8998,9545,18543,9084
2564,84,สุราษฎร์ธานี,8498,ท้องถิ่นเทศบาลเมืองนาสาร,9349,9829,19178,9377,9847,19224,8197
2564,84,สุราษฎร์ธานี,8499,ท้องถิ่นเทศบาลนครสุราษฎร์ธานี,61961,68801,130762,62787,69518,132305,76513
2564,85,ระนอง,8501,อำเภอเมืองระนอง,32504,32121,64625,35747,34895,70642,38446
2564,85,ระนอง,8502,อำเภอละอุ่น,6291,6164,12455,6339,6215,12554,5603
2564,85,ระนอง,8503,อำเภอกะเปอร์,10158,9882,20040,10383,10084,20467,8074
2564,85,ระนอง,8504,อำเภอกระบุรี,22341,21601,43942,22733,21966,44699,22599
2564,85,ระนอง,8505,อำเภอสุขสำราญ,6906,6931,13837,7187,7191,14378,4625
2564,85,ระนอง,8594,ท้องถิ่นเทศบาลตำบลน้ำจืด,1622,1682,3304,1785,1818,3603,1944
2564,85,ระนอง,8595,ท้องถิ่นเทศบาลตำบลกะเปอร์,732,775,1507,736,778,1514,674
2564,85,ระนอง,8596,ท้องถิ่นเทศบาลตำบลละอุ่น,1272,1221,2493,1356,1296,2652,1211
2564,85,ระนอง,8597,ท้องถิ่นเทศบาลตำบลหงาว,1146,1229,2375,1191,1284,2475,1100
2564,85,ระนอง,8598,ท้องถิ่นเทศบาลตำบลปากน้ำ,1234,1113,2347,1271,1163,2434,1811
2564,85,ระนอง,8599,ท้องถิ่นเทศบาลเมืองระนอง,6037,6539,12576,9408,9747,19155,8208
2564,86,ชุมพร,8601,อำเภอเมืองชุมพร,45830,46537,92367,45889,46597,92486,44894
2564,86,ชุมพร,8602,อำเภอท่าแซะ,40871,41049,81920,41266,41428,82694,35852
2564,86,ชุมพร,8603,อำเภอปะทิว,19684,20168,39852,19780,20240,40020,18212
2564,86,ชุมพร,8604,อำเภอหลังสวน,27254,28467,55721,27460,28645,56105,24182
2564,86,ชุมพร,8605,อำเภอละแม,13049,13015,26064,13183,13123,26306,11958
2564,86,ชุมพร,8606,อำเภอพะโต๊ะ,11807,11342,23149,11812,11342,23154,10847
2564,86,ชุมพร,8607,อำเภอสวี,34742,35107,69849,34801,35166,69967,32624
2564,86,ชุมพร,8608,อำเภอทุ่งตะโก,10755,10677,21432,10780,10701,21481,9729
2564,86,ชุมพร,8685,ท้องถิ่นเทศบาลเมืองท่ายาง,5024,5211,10235,5036,5213,10249,4751
2564,86,ชุมพร,8686,ท้องถิ่นเทศบาลตำบลปากตะโก,2064,2009,4073,2066,2009,4075,1641
2564,86,ชุมพร,8687,ท้องถิ่นเทศบาลตำบลนาโพธิ์,1376,1568,2944,1380,1569,2949,1684
2564,86,ชุมพร,8688,ท้องถิ่นเทศบาลตำบลพะโต๊ะ,731,727,1458,739,732,1471,690
2564,86,ชุมพร,8689,ท้องถิ่นเทศบาลตำบลละแม,1476,1597,3073,1482,1606,3088,1899
2564,86,ชุมพร,8690,ท้องถิ่นเทศบาลตำบลปากน้ำหลังสวน,3156,3236,6392,3184,3262,6446,3073
2564,86,ชุมพร,8691,ท้องถิ่นเทศบาลตำบลสะพลี,1036,1141,2177,1039,1141,2180,1171
2564,86,ชุมพร,8692,ท้องถิ่นเทศบาลตำบลมาบอำมฤต,1697,1720,3417,1865,1910,3775,2224
2564,86,ชุมพร,8693,ท้องถิ่นเทศบาลตำบลปะทิว,555,637,1192,625,715,1340,878
2564,86,ชุมพร,8694,ท้องถิ่นเทศบาลตำบลเนินสันติ,919,958,1877,922,963,1885,1270
2564,86,ชุมพร,8695,ท้องถิ่นเทศบาลตำบลท่าแซะ,966,1074,2040,966,1077,2043,1376
2564,86,ชุมพร,8696,ท้องถิ่นเทศบาลตำบลวังไผ่,3219,3542,6761,3224,3545,6769,4707
2564,86,ชุมพร,8697,ท้องถิ่นเทศบาลตำบลปากน้ำชุมพร,2897,3078,5975,3106,3262,6368,3445
2564,86,ชุมพร,8698,ท้องถิ่นเทศบาลเมืองหลังสวน,5161,5787,10948,5175,5795,10970,6929
2564,86,ชุมพร,8699,ท้องถิ่นเทศบาลเมืองชุมพร,14972,17498,32470,15625,18033,33658,20140
2564,90,สงขลา,9001,อำเภอเมืองสงขลา,7340,7967,15307,7354,7970,15324,5589
2564,90,สงขลา,9002,อำเภอสทิงพระ,21964,23056,45020,21973,23060,45033,13893
2564,90,สงขลา,9003,อำเภอจะนะ,50256,51052,101308,50286,51077,101363,28112
2564,90,สงขลา,9004,อำเภอนาทวี,31927,31205,63132,31959,31233,63192,19744
2564,90,สงขลา,9005,อำเภอเทพา,31121,29367,60488,31166,29419,60585,16826
2564,90,สงขลา,9006,อำเภอสะบ้าย้อย,39915,39006,78921,40000,39069,79069,19490
2564,90,สงขลา,9007,อำเภอระโนด,23901,24535,48436,23921,24563,48484,19566
2564,90,สงขลา,9008,อำเภอกระแสสินธุ์,7343,7585,14928,7347,7587,14934,5261
2564,90,สงขลา,9009,อำเภอรัตภูมิ,33488,34132,67620,33733,34139,67872,22260
2564,90,สงขลา,9010,อำเภอสะเดา,29223,28906,58129,29444,29134,58578,21570
2564,90,สงขลา,9011,อำเภอหาดใหญ่,14921,16171,31092,14956,16199,31155,13212
2564,90,สงขลา,9012,อำเภอนาหม่อม,11057,11895,22952,11073,11900,22973,9215
2564,90,สงขลา,9013,อำเภอควนเนียง,14807,15458,30265,14826,15471,30297,9978
2564,90,สงขลา,9014,อำเภอบางกล่ำ,4923,5047,9970,5004,5100,10104,3564
2564,90,สงขลา,9015,อำเภอสิงหนคร,21586,22651,44237,21593,22652,44245,14937
2564,90,สงขลา,9016,อำเภอคลองหอยโข่ง,6050,5810,11860,6093,5861,11954,5140
2564,90,สงขลา,9066,ท้องถิ่นเทศบาลเมืองทุ่งตำเสา,8250,8721,16971,8260,8730,16990,6159
2564,90,สงขลา,9067,ท้องถิ่นเทศบาลตำบลโคกม่วง,4167,3525,7692,4169,3530,7699,2778
2564,90,สงขลา,9068,ท้องถิ่นเทศบาลตำบลทุ่งลาน,3583,3832,7415,3588,3832,7420,2569
2564,90,สงขลา,9069,ท้องถิ่นเทศบาลตำบลเกาะแต้ว,5703,5972,11675,5707,5974,11681,3842
2564,90,สงขลา,9070,ท้องถิ่นเทศบาลตำบลคูเต่า,5694,5804,11498,5700,5805,11505,3244
2564,90,สงขลา,9071,ท้องถิ่นเทศบาลตำบลท่าช้าง,11205,11318,22523,11219,11323,22542,9981
2564,90,สงขลา,9072,ท้องถิ่นเทศบาลตำบลน้ำน้อย,7043,7932,14975,7062,7933,14995,6232
2564,90,สงขลา,9073,ท้องถิ่นเทศบาลตำบลลำไพล,7827,8006,15833,7857,8022,15879,4636
2564,90,สงขลา,9074,ท้องถิ่นเทศบาลตำบลบ้านไร่,3940,4196,8136,3952,4200,8152,3459
2564,90,สงขลา,9075,ท้องถิ่นเทศบาลตำบลพะวง,16038,17564,33602,16490,18010,34500,15572
2564,90,สงขลา,9076,ท้องถิ่นเทศบาลเมืองเขารูปช้าง,20184,22758,42942,20227,22770,42997,20877
2564,90,สงขลา,9077,ท้องถิ่นเทศบาลตำบลสำนักขาม,6181,7305,13486,6244,7343,13587,9315
2564,90,สงขลา,9078,ท้องถิ่นเทศบาลเมืองคลองแห,19572,22089,41661,19601,22108,41709,21451
2564,90,สงขลา,9079,ท้องถิ่นเทศบาลเมืองควนลัง,23343,26583,49926,23419,26636,50055,26391
2564,90,สงขลา,9080,ท้องถิ่นเทศบาลเมืองคอหงส์,21831,24031,45862,21938,24091,46029,28591
2564,90,สงขลา,9081,ท้องถิ่นเทศบาลเมืองสิงหนคร,19696,20142,39838,19712,20147,39859,13337
2564,90,สงขลา,9082,ท้องถิ่นเทศบาลตำบลควนเนียง,1898,2206,4104,1913,2217,4130,1779
2564,90,สงขลา,9083,ท้องถิ่นเทศบาลตำบลพะตง,3578,4051,7629,3614,4077,7691,4773
2564,90,สงขลา,9084,ท้องถิ่นเทศบาลตำบลคลองแงะ,3949,4134,8083,4010,4188,8198,3450
2564,90,สงขลา,9085,ท้องถิ่นเทศบาลเมืองปาดังเบซาร์,7583,8040,15623,7608,8063,15671,6246
2564,90,สงขลา,9086,ท้องถิ่นเทศบาลตำบลปริก,3115,3280,6395,3123,3281,6404,2048
2564,90,สงขลา,9087,ท้องถิ่นเทศบาลตำบลนาสีทอง,1384,1541,2925,1385,1542,2927,1144
2564,90,สงขลา,9088,ท้องถิ่นเทศบาลตำบลกำแพงเพชร,2312,2487,4799,2364,2546,4910,2577
2564,90,สงขลา,9089,ท้องถิ่นเทศบาลตำบลระโนด,2130,2315,4445,2131,2316,4447,1971
2564,90,สงขลา,9090,ท้องถิ่นเทศบาลตำบลบ่อตรุ,5432,5597,11029,5433,5597,11030,3525
2564,90,สงขลา,9091,ท้องถิ่นเทศบาลตำบลสะบ้าย้อย,620,676,1296,620,676,1296,792
2564,90,สงขลา,9092,ท้องถิ่นเทศบาลตำบลเทพา,1130,1172,2302,1138,1180,2318,1077
2564,90,สงขลา,9093,ท้องถิ่นเทศบาลตำบลนาทวี,2957,2998,5955,3170,3184,6354,3718
2564,90,สงขลา,9094,ท้องถิ่นเทศบาลตำบลจะนะ,3321,3455,6776,3385,3497,6882,3335
2564,90,สงขลา,9095,ท้องถิ่นเทศบาลตำบลสทิงพระ,1287,1437,2724,1288,1437,2725,1299
2564,90,สงขลา,9096,ท้องถิ่นเทศบาลเมืองบ้านพรุ,12620,13898,26518,12659,13922,26581,12766
2564,90,สงขลา,9097,ท้องถิ่นเทศบาลเมืองสะเดา,10246,10898,21144,10518,11159,21677,8833
2564,90,สงขลา,9098,ท้องถิ่นเทศบาลนครหาดใหญ่,66018,77861,143879,68793,80349,149142,68701
2564,90,สงขลา,9099,ท้องถิ่นเทศบาลนครสงขลา,28164,30116,58280,28231,30161,58392,27597
2564,91,สตูล,9101,อำเภอเมืองสตูล,32550,33392,65942,32581,33422,66003,18707
2564,91,สตูล,9102,อำเภอควนโดน,10841,10935,21776,10850,10936,21786,6087
2564,91,สตูล,9103,อำเภอควนกาหลง,17873,17798,35671,17881,17807,35688,12037
2564,91,สตูล,9104,อำเภอท่าแพ,14735,14962,29697,14749,14965,29714,8859
2564,91,สตูล,9105,อำเภอละงู,34076,34486,68562,34193,34590,68783,21283
2564,91,สตูล,9106,อำเภอทุ่งหว้า,10651,10584,21235,10672,10598,21270,6784
2564,91,สตูล,9107,อำเภอมะนัง,9476,9074,18550,9479,9075,18554,6414
2564,91,สตูล,9193,ท้องถิ่นเทศบาลตำบลคลองขุด,10571,9864,20435,10582,9868,20450,9229
2564,91,สตูล,9194,ท้องถิ่นเทศบาลตำบลทุ่งหว้า,1582,1652,3234,1584,1652,3236,1239
2564,91,สตูล,9195,ท้องถิ่นเทศบาลตำบลกำแพง,2353,2622,4975,2356,2624,4980,2876
2564,91,สตูล,9196,ท้องถิ่นเทศบาลตำบลควนโดน,2712,2730,5442,2714,2733,5447,1953
2564,91,สตูล,9197,ท้องถิ่นเทศบาลตำบลฉลุง,1116,1223,2339,1116,1223,2339,1005
2564,91,สตูล,9198,ท้องถิ่นเทศบาลตำบลเจ๊ะบิลัง,1988,2014,4002,1997,2023,4020,1008
2564,91,สตูล,9199,ท้องถิ่นเทศบาลเมืองสตูล,10820,11626,22446,10886,11679,22565,10081
2564,92,ตรัง,9201,อำเภอเมืองตรัง,45770,49294,95064,45835,49331,95166,40715
2564,92,ตรัง,9202,อำเภอกันตัง,37386,37649,75035,37406,37673,75079,24330
2564,92,ตรัง,9203,อำเภอย่านตาขาว,27812,28897,56709,27854,28922,56776,18013
2564,92,ตรัง,9204,อำเภอปะเหลียน,31075,31824,62899,31128,31865,62993,21700
2564,92,ตรัง,9205,อำเภอสิเกา,17603,17243,34846,17629,17273,34902,12677
2564,92,ตรัง,9206,อำเภอห้วยยอด,38620,39734,78354,38714,39808,78522,26971
2564,92,ตรัง,9207,อำเภอวังวิเศษ,20053,20366,40419,20066,20380,40446,14028
2564,92,ตรัง,9208,อำเภอนาโยง,19940,21260,41200,19948,21262,41210,13627
2564,92,ตรัง,9209,อำเภอรัษฎา,13290,13615,26905,13313,13643,26956,9926
2564,92,ตรัง,9210,อำเภอหาดสำราญ,8479,8389,16868,8485,8396,16881,4938
2564,92,ตรัง,9286,ท้องถิ่นเทศบาลตำบลคลองปาง,1066,1159,2225,1067,1160,2227,1341
2564,92,ตรัง,9287,ท้องถิ่นเทศบาลตำบลนาโยงเหนือ,1678,1840,3518,1681,1843,3524,1571
2564,92,ตรัง,9288,ท้องถิ่นเทศบาลตำบลวังวิเศษ,1439,1494,2933,1460,1514,2974,1345
2564,92,ตรัง,9289,ท้องถิ่นเทศบาลตำบลลำภูรา,1827,1461,3288,1827,1461,3288,1500
2564,92,ตรัง,9290,ท้องถิ่นเทศบาลตำบลนาวง,1947,2095,4042,1955,2095,4050,1822
2564,92,ตรัง,9291,ท้องถิ่นเทศบาลตำบลสิเกา,637,703,1340,668,728,1396,664
2564,92,ตรัง,9292,ท้องถิ่นเทศบาลตำบลควนกุน,1048,1096,2144,1048,1096,2144,760
2564,92,ตรัง,9293,ท้องถิ่นเทศบาลตำบลทุ่งยาว,1142,1299,2441,1149,1304,2453,1096
2564,92,ตรัง,9294,ท้องถิ่นเทศบาลตำบลท่าข้าม,690,684,1374,692,686,1378,664
2564,92,ตรัง,9295,ท้องถิ่นเทศบาลตำบลย่านตาขาว,3481,4079,7560,3498,4099,7597,3811
2564,92,ตรัง,9296,ท้องถิ่นเทศบาลตำบลคลองเต็ง,1791,1953,3744,1798,1955,3753,1749
2564,92,ตรัง,9297,ท้องถิ่นเทศบาลตำบลห้วยยอด,3860,4262,8122,3869,4267,8136,4125
2564,92,ตรัง,9298,ท้องถิ่นเทศบาลเมืองกันตัง,5672,5903,11575,5723,5949,11672,5069
2564,92,ตรัง,9299,ท้องถิ่นเทศบาลนครตรัง,25625,30145,55770,25880,30385,56265,25493
2564,93,พัทลุง,9301,อำเภอเมืองพัทลุง,42482,46304,88786,42516,46319,88835,34261
2564,93,พัทลุง,9302,อำเภอกงหรา,14713,14687,29400,14714,14689,29403,9511
2564,93,พัทลุง,9303,อำเภอเขาชัยสน,15192,15835,31027,15200,15839,31039,11616
2564,93,พัทลุง,9304,อำเภอตะโหมด,7084,7218,14302,7088,7220,14308,4745
2564,93,พัทลุง,9305,อำเภอควนขนุน,37977,41194,79171,37987,41198,79185,30384
2564,93,พัทลุง,9306,อำเภอปากพะยูน,16150,16639,32789,16152,16643,32795,11129
2564,93,พัทลุง,9307,อำเภอศรีบรรพต,8994,8996,17990,8998,9005,18003,6942
2564,93,พัทลุง,9308,อำเภอป่าบอน,21721,22131,43852,21726,22133,43859,15923
2564,93,พัทลุง,9309,อำเภอบางแก้ว,8866,9047,17913,8872,9049,17921,6478
2564,93,พัทลุง,9310,อำเภอป่าพะยอม,13260,13819,27079,13265,13829,27094,10837
2564,93,พัทลุง,9311,อำเภอศรีนครินทร์,5131,5309,10440,5133,5312,10445,3663
2564,93,พัทลุง,9382,ท้องถิ่นเทศบาลตำบลเขาหัวช้าง,3608,3593,7201,3608,3594,7202,2172
2564,93,พัทลุง,9383,ท้องถิ่นเทศบาลตำบลชะรัด,3608,3679,7287,3610,3679,7289,2282
2564,93,พัทลุง,9384,ท้องถิ่นเทศบาลตำบลหารเทา,4940,5079,10019,4943,5079,10022,3510
2564,93,พัทลุง,9385,ท้องถิ่นเทศบาลตำบลบางแก้ว,1851,1929,3780,1854,1930,3784,1436
2564,93,พัทลุง,9386,ท้องถิ่นเทศบาลตำบลอ่าวพะยูน,2279,2373,4652,2284,2375,4659,1658
2564,93,พัทลุง,9387,ท้องถิ่นเทศบาลตำบลชุมพล,4647,4137,8784,4650,4137,8787,3576
2564,93,พัทลุง,9388,ท้องถิ่นเทศบาลตำบลโคกม่วง,5081,5288,10369,5081,5289,10370,3658
2564,93,พัทลุง,9389,ท้องถิ่นเทศบาลตำบลบ้านนา,3689,3762,7451,3691,3763,7454,3119
2564,93,พัทลุง,9390,ท้องถิ่นเทศบาลตำบลลานข่อย,4191,4463,8654,4196,4463,8659,2974
2564,93,พัทลุง,9391,ท้องถิ่นเทศบาลตำบลท่ามะเดื่อ,1974,2158,4132,1976,2161,4137,1794
2564,93,พัทลุง,9392,ท้องถิ่นเทศบาลตำบลป่าบอน,1911,2005,3916,1913,2005,3918,1736
2564,93,พัทลุง,9393,ท้องถิ่นเทศบาลตำบลปากพะยูน,1536,1642,3178,1540,1644,3184,1528
2564,93,พัทลุง,9394,ท้องถิ่นเทศบาลตำบลมะกอกเหนือ,1001,1164,2165,1003,1167,2170,797
2564,93,พัทลุง,9395,ท้องถิ่นเทศบาลตำบลควนขนุน,951,1114,2065,955,1117,2072,1181
2564,93,พัทลุง,9396,ท้องถิ่นเทศบาลตำบลแม่ขรี,3040,3230,6270,3047,3234,6281,3429
2564,93,พัทลุง,9397,ท้องถิ่นเทศบาลตำบลตะโหมด,2121,2231,4352,2121,2231,4352,1564
2564,93,พัทลุง,9398,ท้องถิ่นเทศบาลตำบลเขาชัยสน,1667,1825,3492,1671,1830,3501,1626
2564,93,พัทลุง,9399,ท้องถิ่นเทศบาลเมืองพัทลุง,14559,17124,31683,14631,17182,31813,16158
2564,94,ปัตตานี,9401,อำเภอเมืองปัตตานี,43550,47748,91298,43606,47795,91401,31646
2564,94,ปัตตานี,9402,อำเภอโคกโพธิ์,30451,31880,62331,30466,31887,62353,17994
2564,94,ปัตตานี,9403,อำเภอหนองจิก,29683,29923,59606,29692,29927,59619,13667
2564,94,ปัตตานี,9404,อำเภอปะนาเระ,18060,18777,36837,18069,18783,36852,9680
2564,94,ปัตตานี,9405,อำเภอมายอ,27861,28585,56446,27878,28610,56488,12939
2564,94,ปัตตานี,9406,อำเภอทุ่งยางแดง,12444,12846,25290,12446,12851,25297,5936
2564,94,ปัตตานี,9407,อำเภอสายบุรี,27857,29131,56988,27869,29139,57008,13731
2564,94,ปัตตานี,9408,อำเภอไม้แก่น,6411,6602,13013,6411,6603,13014,3434
2564,94,ปัตตานี,9409,อำเภอยะหริ่ง,35182,35574,70756,35219,35606,70825,16296
2564,94,ปัตตานี,9410,อำเภอยะรัง,45253,45333,90586,45272,45345,90617,22359
2564,94,ปัตตานี,9411,อำเภอกะพ้อ,9405,9689,19094,9407,9692,19099,4477
2564,94,ปัตตานี,9412,อำเภอแม่ลาน,8634,8956,17590,8640,8964,17604,4569
2564,94,ปัตตานี,9488,ท้องถิ่นเทศบาลตำบลยะรัง,2480,2608,5088,2480,2609,5089,1373
2564,94,ปัตตานี,9489,ท้องถิ่นเทศบาลตำบลยะหริ่ง,3178,3079,6257,3179,3081,6260,1944
2564,94,ปัตตานี,9490,ท้องถิ่นเทศบาลตำบลบางปู,5200,5239,10439,5202,5240,10442,2314
2564,94,ปัตตานี,9491,ท้องถิ่นเทศบาลตำบลตันหยง,1323,1493,2816,1326,1494,2820,736
2564,94,ปัตตานี,9492,ท้องถิ่นเทศบาลตำบลมายอ,2447,2456,4903,2450,2457,4907,1220
2564,94,ปัตตานี,9493,ท้องถิ่นเทศบาลตำบลปะนาเระ,5360,5319,10679,5361,5320,10681,2714
2564,94,ปัตตานี,9494,ท้องถิ่นเทศบาลตำบลหนองจิก,3102,3132,6234,3107,3138,6245,2022
2564,94,ปัตตานี,9495,ท้องถิ่นเทศบาลตำบลบ่อทอง,9852,6382,16234,9857,6384,16241,5948
2564,94,ปัตตานี,9496,ท้องถิ่นเทศบาลตำบลนาประดู่,1491,1606,3097,1494,1608,3102,1429
2564,94,ปัตตานี,9497,ท้องถิ่นเทศบาลตำบลโคกโพธิ์,1587,1770,3357,1588,1771,3359,1843
2564,94,ปัตตานี,9498,ท้องถิ่นเทศบาลเมืองตะลุบัน,7129,7398,14527,7152,7418,14570,4523
2564,94,ปัตตานี,9499,ท้องถิ่นเทศบาลเมืองปัตตานี,21585,22942,44527,22177,23511,45688,16309
2564,95,ยะลา,9501,อำเภอเมืองยะลา,37809,38853,76662,37816,38858,76674,19051
2564,95,ยะลา,9502,อำเภอเบตง,18373,17250,35623,18588,17498,36086,15843
2564,95,ยะลา,9503,อำเภอบันนังสตา,28663,27653,56316,28716,27705,56421,15968
2564,95,ยะลา,9504,อำเภอธารโต,12629,11565,24194,12691,11606,24297,9150
2564,95,ยะลา,9505,อำเภอยะหา,31075,30915,61990,31083,30918,62001,14643
2564,95,ยะลา,9506,อำเภอรามัน,42854,43740,86594,42868,43750,86618,20912
2564,95,ยะลา,9507,อำเภอกาบัง,13084,12522,25606,13097,12530,25627,7202
2564,95,ยะลา,9508,อำเภอกรงปินัง,15212,14978,30190,15213,14978,30191,6648
2564,95,ยะลา,9590,ท้องถิ่นเทศบาลเมืองสะเตงนอก,16810,17964,34774,16817,17968,34785,15472
2564,95,ยะลา,9591,ท้องถิ่นเทศบาลตำบลเขื่อนบางลาง,2372,2175,4547,2372,2175,4547,2031
2564,95,ยะลา,9592,ท้องถิ่นเทศบาลตำบลโกตาบารู,2907,2999,5906,2909,3000,5909,1605
2564,95,ยะลา,9593,ท้องถิ่นเทศบาลตำบลเมืองรามันห์,2518,2599,5117,2523,2600,5123,1888
2564,95,ยะลา,9594,ท้องถิ่นเทศบาลตำบลยะหา,1258,1217,2475,1258,1217,2475,767
2564,95,ยะลา,9595,ท้องถิ่นเทศบาลตำบลคอกช้าง,755,736,1491,755,736,1491,589
2564,95,ยะลา,9596,ท้องถิ่นเทศบาลตำบลบันนังสตา,1292,1254,2546,1292,1254,2546,1011
2564,95,ยะลา,9597,ท้องถิ่นเทศบาลตำบลลำใหม่,497,491,988,497,491,988,379
2564,95,ยะลา,9598,ท้องถิ่นเทศบาลเมืองเบตง,12618,13588,26206,12712,13686,26398,11394
2564,95,ยะลา,9599,ท้องถิ่นเทศบาลนครยะลา,28432,31154,59586,28700,31437,60137,28673
2564,96,นราธิวาส,9601,อำเภอเมืองนราธิวาส,43191,42800,85991,43227,42828,86055,26506
2564,96,นราธิวาส,9602,อำเภอตากใบ,26856,27513,54369,26879,27527,54406,12122
2564,96,นราธิวาส,9603,อำเภอบาเจาะ,20390,21074,41464,20402,21080,41482,9545
2564,96,นราธิวาส,9604,อำเภอยี่งอ,21826,22469,44295,21835,22482,44317,10622
2564,96,นราธิวาส,9605,อำเภอระแงะ,38585,39981,78566,38597,39992,78589,17721
2564,96,นราธิวาส,9606,อำเภอรือเสาะ,33332,33583,66915,33336,33588,66924,15961
2564,96,นราธิวาส,9607,อำเภอศรีสาคร,18663,18103,36766,18672,18113,36785,9618
2564,96,นราธิวาส,9608,อำเภอแว้ง,21669,22182,43851,21695,22214,43909,10487
2564,96,นราธิวาส,9609,อำเภอสุคิริน,11763,11331,23094,11768,11345,23113,7476
2564,96,นราธิวาส,9610,อำเภอสุไหงโกลก,18303,19589,37892,18320,19608,37928,11249
2564,96,นราธิวาส,9611,อำเภอสุไหงปาดี,23838,24460,48298,23867,24484,48351,12305
2564,96,นราธิวาส,9612,อำเภอจะแนะ,20054,19432,39486,20073,19444,39517,9797
2564,96,นราธิวาส,9613,อำเภอเจาะไอร้อง,20458,20609,41067,20467,20615,41082,9843
2564,96,นราธิวาส,9686,ท้องถิ่นเทศบาลตำบลปะลุรู,3430,3538,6968,3449,3553,7002,2114
2564,96,นราธิวาส,9687,ท้องถิ่นเทศบาลตำบลสุคิริน,1734,1663,3397,1742,1675,3417,1585
2564,96,นราธิวาส,9688,ท้องถิ่นเทศบาลตำบลแว้ง,2592,2740,5332,2593,2742,5335,1687
2564,96,นราธิวาส,9689,ท้องถิ่นเทศบาลตำบลบูเก๊ะตา,2480,2599,5079,2482,2601,5083,1399
2564,96,นราธิวาส,9690,ท้องถิ่นเทศบาลตำบลศรีสาคร,2577,2518,5095,2590,2527,5117,1806
2564,96,นราธิวาส,9691,ท้องถิ่นเทศบาลตำบลรือเสาะ,3704,3849,7553,3723,3853,7576,3584
2564,96,นราธิวาส,9692,ท้องถิ่นเทศบาลตำบลมะรือโบตก,4273,4173,8446,4277,4174,8451,1781
2564,96,นราธิวาส,9693,ท้องถิ่นเทศบาลตำบลตันหยงมัส,3356,3605,6961,3388,3622,7010,3839
2564,96,นราธิวาส,9694,ท้องถิ่นเทศบาลตำบลยี่งอ,1538,1538,3076,1543,1539,3082,1106
2564,96,นราธิวาส,9695,ท้องถิ่นเทศบาลตำบลบาเจาะ,4777,4751,9528,4783,4757,9540,2305
2564,96,นราธิวาส,9696,ท้องถิ่นเทศบาลตำบลต้นไทร,2350,2588,4938,2351,2588,4939,1392
2564,96,นราธิวาส,9697,ท้องถิ่นเทศบาลเมืองตากใบ,9568,10189,19757,9577,10203,19780,5749
2564,96,นราธิวาส,9698,ท้องถิ่นเทศบาลเมืองสุไหงโกลก,19031,21256,40287,19182,21401,40583,15532
2564,96,นราธิวาส,9699,ท้องถิ่นเทศบาลเมืองนราธิวาส,19507,20467,39974,19683,20604,40287,16010
2565,10,กรุงเทพมหานคร,1001,เขตพระนคร,19628,21300,40928,20076,21570,41646,19100
2565,10,กรุงเทพมหานคร,1002,เขตดุสิต,41234,35814,77048,42104,36498,78602,32404
2565,10,กรุงเทพมหานคร,1003,เขตหนองจอก,87837,93058,180895,88111,93256,181367,71054
2565,10,กรุงเทพมหานคร,1004,เขตบางรัก,15913,19331,35244,20616,23298,43914,35399
2565,10,กรุงเทพมหานคร,1005,เขตบางเขน,86161,98329,184490,86668,98701,185369,116209
2565,10,กรุงเทพมหานคร,1006,เขตบางกะปิ,63092,76581,139673,64164,77325,141489,112795
2565,10,กรุงเทพมหานคร,1007,เขตปทุมวัน,17584,20349,37933,19195,21649,40844,32169
2565,10,กรุงเทพมหานคร,1008,เขตป้อมปราบศัตรูพ่าย,17931,19036,36967,19194,20116,39310,19608
2565,10,กรุงเทพมหานคร,1009,เขตพระโขนง,38302,47271,85573,38717,47573,86290,62527
2565,10,กรุงเทพมหานคร,1010,เขตมีนบุรี,65900,74306,140206,66401,74629,141030,63794
2565,10,กรุงเทพมหานคร,1011,เขตลาดกระบัง,83862,93664,177526,84335,94015,178350,102711
2565,10,กรุงเทพมหานคร,1012,เขตยานนาวา,33174,39102,72276,34283,39831,74114,53724
2565,10,กรุงเทพมหานคร,1013,เขตสัมพันธวงศ์,9387,10131,19518,9784,10384,20168,13179
2565,10,กรุงเทพมหานคร,1014,เขตพญาไท,31329,32885,64214,31964,33311,65275,45733
2565,10,กรุงเทพมหานคร,1015,เขตธนบุรี,45733,52483,98216,46455,53136,99591,61415
2565,10,กรุงเทพมหานคร,1016,เขตบางกอกใหญ่,28457,32580,61037,28734,32845,61579,32974
2565,10,กรุงเทพมหานคร,1017,เขตห้วยขวาง,35953,45193,81146,37269,46224,83493,89332
2565,10,กรุงเทพมหานคร,1018,เขตคลองสาน,28256,33725,61981,30579,35768,66347,42118
2565,10,กรุงเทพมหานคร,1019,เขตตลิ่งชัน,47138,54107,101245,47445,54357,101802,43891
2565,10,กรุงเทพมหานคร,1020,เขตบางกอกน้อย,45448,51820,97268,46725,53004,99729,52288
2565,10,กรุงเทพมหานคร,1021,เขตบางขุนเทียน,86235,97414,183649,86851,97954,184805,93312
2565,10,กรุงเทพมหานคร,1022,เขตภาษีเจริญ,56070,65090,121160,56557,65513,122070,66651
2565,10,กรุงเทพมหานคร,1023,เขตหนองแขม,71594,82603,154197,72154,83089,155243,64392
2565,10,กรุงเทพมหานคร,1024,เขตราษฎร์บูรณะ,36021,39863,75884,36403,40187,76590,38263
2565,10,กรุงเทพมหานคร,1025,เขตบางพลัด,39352,47523,86875,39666,47809,87475,59492
2565,10,กรุงเทพมหานคร,1026,เขตดินแดง,50412,59822,110234,50866,60186,111052,64140
2565,10,กรุงเทพมหานคร,1027,เขตบึงกุ่ม,62354,74934,137288,62753,75297,138050,76666
2565,10,กรุงเทพมหานคร,1028,เขตสาทร,32725,37198,69923,34337,38311,72648,43854
2565,10,กรุงเทพมหานคร,1029,เขตบางซื่อ,54661,63863,118524,55183,64248,119431,77645
2565,10,กรุงเทพมหานคร,1030,เขตจตุจักร,69983,82637,152620,70682,83110,153792,133963
2565,10,กรุงเทพมหานคร,1031,เขตบางคอแหลม,36210,41059,77269,37207,41888,79095,40806
2565,10,กรุงเทพมหานคร,1032,เขตประเวศ,84098,96100,180198,85675,97309,182984,95188
2565,10,กรุงเทพมหานคร,1033,เขตคลองเตย,41437,46922,88359,42733,47713,90446,79410
2565,10,กรุงเทพมหานคร,1034,เขตสวนหลวง,54731,65954,120685,55897,66779,122676,82934
2565,10,กรุงเทพมหานคร,1035,เขตจอมทอง,66059,74348,140407,67651,75679,143330,74375
2565,10,กรุงเทพมหานคร,1036,เขตดอนเมือง,82005,83663,165668,82397,83892,166289,79816
2565,10,กรุงเทพมหานคร,1037,เขตราชเทวี,27736,31548,59284,31461,34818,66279,57243
2565,10,กรุงเทพมหานคร,1038,เขตลาดพร้าว,51453,62157,113610,51811,62464,114275,58302
2565,10,กรุงเทพมหานคร,1039,เขตวัฒนา,30394,37291,67685,37429,43401,80830,84722
2565,10,กรุงเทพมหานคร,1040,เขตบางแค,88211,102479,190690,89032,103221,192253,96515
2565,10,กรุงเทพมหานคร,1041,เขตหลักสี่,47504,52413,99917,47741,52619,100360,59484
2565,10,กรุงเทพมหานคร,1042,เขตสายไหม,96642,110405,207047,97699,111229,208928,109011
2565,10,กรุงเทพมหานคร,1043,เขตคันนายาว,40159,47128,87287,44461,51062,95523,46722
2565,10,กรุงเทพมหานคร,1044,เขตสะพานสูง,43741,51868,95609,44095,52116,96211,42485
2565,10,กรุงเทพมหานคร,1045,เขตวังทองหลาง,47108,56532,103640,47583,56895,104478,64109
2565,10,กรุงเทพมหานคร,1046,เขตคลองสามวา,97904,110504,208408,98320,110800,209120,90104
2565,10,กรุงเทพมหานคร,1047,เขตบางนา,39032,45773,84805,39835,46320,86155,73052
2565,10,กรุงเทพมหานคร,1048,เขตทวีวัฒนา,36337,42274,78611,36653,42575,79228,35482
2565,10,กรุงเทพมหานคร,1049,เขตทุ่งครุ,57410,65591,123001,57842,65919,123761,55959
2565,10,กรุงเทพมหานคร,1050,เขตบางบอน,47003,51989,98992,48181,53065,101246,51344
2565,11,สมุทรปราการ,1101,อำเภอเมืองสมุทรปราการ,60182,67179,127361,60322,67289,127611,60152
2565,11,สมุทรปราการ,1102,อำเภอบางบ่อ,46233,49191,95424,46789,49680,96469,48561
2565,11,สมุทรปราการ,1103,อำเภอบางพลี,126689,143791,270480,127573,144389,271962,180795
2565,11,สมุทรปราการ,1104,อำเภอพระประแดง,18130,19772,37902,18161,19803,37964,13556
2565,11,สมุทรปราการ,1105,อำเภอพระสมุทรเจดีย์,57521,62323,119844,57652,62428,120080,57990
2565,11,สมุทรปราการ,1106,อำเภอบางเสาธง,29384,31664,61048,29495,31729,61224,46289
2565,11,สมุทรปราการ,1183,ท้องถิ่นเทศบาลเมืองปากน้ำสมุทรปราการ,17995,20559,38554,18064,20606,38670,17097
2565,11,สมุทรปราการ,1184,ท้องถิ่นเทศบาลตำบลบางเสาธง,9916,10894,20810,9944,10915,20859,17456
2565,11,สมุทรปราการ,1185,ท้องถิ่นเทศบาลตำบลแหลมฟ้าผ่า,10410,11001,21411,10436,11038,21474,9568
2565,11,สมุทรปราการ,1186,ท้องถิ่นเทศบาลตำบลพระสมุทรเจดีย์,5396,5616,11012,5652,5869,11521,5724
2565,11,สมุทรปราการ,1187,ท้องถิ่นเทศบาลตำบลบางพลี,3299,3470,6769,5772,5772,11544,2236
2565,11,สมุทรปราการ,1188,ท้องถิ่นเทศบาลตำบลบางบ่อ,3033,3290,6323,3051,3299,6350,2439
2565,11,สมุทรปราการ,1189,ท้องถิ่นเทศบาลตำบลคลองสวน,1402,1484,2886,1404,1484,2888,890
2565,11,สมุทรปราการ,1190,ท้องถิ่นเทศบาลตำบลคลองด่าน,5465,5690,11155,5479,5706,11185,3245
2565,11,สมุทรปราการ,1191,ท้องถิ่นเทศบาลตำบลบางปู,56894,61706,118600,57064,61851,118915,61080
2565,11,สมุทรปราการ,1192,ท้องถิ่นเทศบาลตำบลแพรกษา,12166,13796,25962,12209,13838,26047,15733
2565,11,สมุทรปราการ,1193,ท้องถิ่นเทศบาลตำบลบางเมือง,45195,51913,97108,45372,52077,97449,50499
2565,11,สมุทรปราการ,1194,ท้องถิ่นเทศบาลตำบลด่านสำโรง,24945,28640,53585,25070,28729,53799,27999
2565,11,สมุทรปราการ,1195,ท้องถิ่นเทศบาลเมืองปู่เจ้าสมิงพราย,33469,35673,69142,33597,35781,69378,35839
2565,11,สมุทรปราการ,1196,ท้องถิ่นเทศบาลตำบลสำโรงเหนือ,13651,16489,30140,13808,16582,30390,31384
2565,11,สมุทรปราการ,1197,ท้องถิ่นเทศบาลเมืองลัดหลวง,31751,34832,66583,32479,35549,68028,37685
2565,11,สมุทรปราการ,1198,ท้องถิ่นเทศบาลเมืองพระประแดง,4021,4310,8331,4081,4373,8454,2187
2565,11,สมุทรปราการ,1199,ท้องถิ่นเทศบาลนครสมุทรปราการ,19938,21486,41424,23324,24642,47966,22018
2565,12,นนทบุรี,1201,อำเภอเมืองนนทบุรี,27052,31279,58331,27133,31355,58488,31316
2565,12,นนทบุรี,1202,อำเภอบางกรวย,16150,18954,35104,16211,19020,35231,20493
2565,12,นนทบุรี,1203,อำเภอบางใหญ่,49350,57299,106649,49657,57541,107198,53855
2565,12,นนทบุรี,1204,อำเภอบางบัวทอง,87768,100588,188356,88053,100854,188907,100481
2565,12,นนทบุรี,1205,อำเภอไทรน้อย,34044,37649,71693,34268,37862,72130,35526
2565,12,นนทบุรี,1206,อำเภอปากเกร็ด,24115,26888,51003,24378,27302,51680,25476
2565,12,นนทบุรี,1286,ท้องถิ่นเทศบาลเมืองเสาธงหิน,17996,21754,39750,18096,21833,39929,26883
2565,12,นนทบุรี,1287,ท้องถิ่นเทศบาลเมืองบางพลับ,5338,6218,11556,5366,6231,11597,6333
2565,12,นนทบุรี,1288,ท้องถิ่นเทศบาลเมืองพิมลราช,23076,26950,50026,23121,27003,50124,24489
2565,12,นนทบุรี,1289,ท้องถิ่นเทศบาลเมืองศาลากลาง,10366,12171,22537,10393,12183,22576,12213
2565,12,นนทบุรี,1290,ท้องถิ่นเทศบาลเมืองไทรม้า,11019,13064,24083,11081,13100,24181,15983
2565,12,นนทบุรี,1291,ท้องถิ่นเทศบาลตำบลไทรน้อย,1229,1235,2464,1242,1239,2481,1148
2565,12,นนทบุรี,1292,ท้องถิ่นเทศบาลเมืองบางใหญ่,6250,6856,13106,6280,6876,13156,6407
2565,12,นนทบุรี,1293,ท้องถิ่นเทศบาลตำบลบางม่วง,3066,3230,6296,3084,3239,6323,3003
2565,12,นนทบุรี,1294,ท้องถิ่นเทศบาลเมืองปลายบาง,21662,25525,47187,21748,25587,47335,24081
2565,12,นนทบุรี,1295,ท้องถิ่นเทศบาลเมืองบางศรีเมือง,15271,17888,33159,15305,17915,33220,13635
2565,12,นนทบุรี,1296,ท้องถิ่นเทศบาลเมืองบางกรวย,20163,23964,44127,20358,24152,44510,22455
2565,12,นนทบุรี,1297,ท้องถิ่นเทศบาลนครปากเกร็ด,86459,101231,187690,87622,102067,189689,136768
2565,12,นนทบุรี,1298,ท้องถิ่นเทศบาลนครบางบัวทอง,23450,27906,51356,23761,28162,51923,26286
2565,12,นนทบุรี,1299,ท้องถิ่นเทศบาลนครนนทบุรี,112268,128896,241164,114525,130713,245238,153018
2565,13,ปทุมธานี,1301,อำเภอเมืองปทุมธานี,62221,69191,131412,62409,69315,131724,70682
2565,13,ปทุมธานี,1302,อำเภอคลองหลวง,71683,79373,151056,71939,79550,151489,73775
2565,13,ปทุมธานี,1303,อำเภอธัญบุรี,0,0,0,0,0,0,0
2565,13,ปทุมธานี,1304,อำเภอหนองเสือ,25844,26413,52257,25924,26482,52406,17352
2565,13,ปทุมธานี,1305,อำเภอลาดหลุมแก้ว,29498,31046,60544,29536,31081,60617,30820
2565,13,ปทุมธานี,1306,อำเภอลำลูกกา,42717,45633,88350,42873,45776,88649,44852
2565,13,ปทุมธานี,1307,อำเภอสามโคก,21788,23380,45168,21852,23423,45275,20899
2565,13,ปทุมธานี,1379,ท้องถิ่นเทศบาลเมืองลาดสวาย,32579,37416,69995,32719,37505,70224,41452
2565,13,ปทุมธานี,1380,ท้องถิ่นเทศบาลตำบลบางพูน,12260,13817,26077,12294,13838,26132,20500
2565,13,ปทุมธานี,1381,ท้องถิ่นเทศบาลตำบลบ้านกลาง,6094,6842,12936,6131,6864,12995,7205
2565,13,ปทุมธานี,1382,ท้องถิ่นเทศบาลเมืองลำสามแก้ว,30313,35292,65605,30399,35349,65748,33889
2565,13,ปทุมธานี,1384,ท้องถิ่นเทศบาลเมืองบึงยี่โถ,15313,18297,33610,15385,18329,33714,16224
2565,13,ปทุมธานี,1386,ท้องถิ่นเทศบาลเมืองบางกะดี,7169,8158,15327,7209,8176,15385,7829
2565,13,ปทุมธานี,1387,ท้องถิ่นเทศบาลตำบลบางเตย,5367,5691,11058,5384,5701,11085,4938
2565,13,ปทุมธานี,1388,ท้องถิ่นเทศบาลตำบลลำลูกกา,9490,10624,20114,9517,10646,20163,10749
2565,13,ปทุมธานี,1389,ท้องถิ่นเทศบาลตำบลลำไทร,1209,1254,2463,1258,1306,2564,1064
2565,13,ปทุมธานี,1390,ท้องถิ่นเทศบาลตำบลระแหง,5017,5457,10474,5042,5484,10526,5743
2565,13,ปทุมธานี,1391,ท้องถิ่นเทศบาลตำบลหนองเสือ,1771,1856,3627,1777,1873,3650,1921
2565,13,ปทุมธานี,1392,ท้องถิ่นเทศบาลเมืองสนั่นรักษ์,15387,17284,32671,15444,17334,32778,17903
2565,13,ปทุมธานี,1393,ท้องถิ่นเทศบาลตำบลธัญบุรี,29684,33368,63052,30546,33879,64425,34458
2565,13,ปทุมธานี,1394,ท้องถิ่นเทศบาลเมืองคลองหลวง,32333,36674,69007,32507,36799,69306,59009
2565,13,ปทุมธานี,1395,ท้องถิ่นเทศบาลตำบลบางหลวง,3651,4047,7698,3658,4058,7716,4452
2565,13,ปทุมธานี,1396,ท้องถิ่นเทศบาลเมืองท่าโขลง,33156,38734,71890,34498,39990,74488,57842
2565,13,ปทุมธานี,1397,ท้องถิ่นเทศบาลเมืองคูคต,20286,22116,42402,20445,22255,42700,26551
2565,13,ปทุมธานี,1398,ท้องถิ่นเทศบาลนครรังสิต,38914,45177,84091,39158,45386,84544,57307
2565,13,ปทุมธานี,1399,ท้องถิ่นเทศบาลเมืองปทุมธานี,9604,10898,20502,10973,12256,23229,9630
2565,14,พระนครศรีอยุธยา,1401,อำเภอพระนครศรีอยุธยา,34078,37339,71417,34124,37370,71494,26268
2565,14,พระนครศรีอยุธยา,1402,อำเภอท่าเรือ,14717,16250,30967,14734,16263,30997,11665
2565,14,พระนครศรีอยุธยา,1403,อำเภอนครหลวง,10506,11439,21945,10537,11465,22002,11733
2565,14,พระนครศรีอยุธยา,1404,อำเภอบางไทร,15427,16222,31649,15454,16235,31689,10888
2565,14,พระนครศรีอยุธยา,1405,อำเภอบางบาล,6877,7410,14287,6879,7413,14292,5532
2565,14,พระนครศรีอยุธยา,1406,อำเภอบางปะอิน,18774,20410,39184,18812,20438,39250,18696
2565,14,พระนครศรีอยุธยา,1407,อำเภอบางปะหัน,17355,18578,35933,17447,18659,36106,12805
2565,14,พระนครศรีอยุธยา,1408,อำเภอผักไห่,10610,11430,22040,10618,11439,22057,7418
2565,14,พระนครศรีอยุธยา,1409,อำเภอภาชี,12482,13279,25761,12491,13287,25778,8509
2565,14,พระนครศรีอยุธยา,1410,อำเภอลาดบัวหลวง,14705,15052,29757,14733,15076,29809,9915
2565,14,พระนครศรีอยุธยา,1411,อำเภอวังน้อย,27377,28924,56301,27457,28998,56455,27211
2565,14,พระนครศรีอยุธยา,1412,อำเภอเสนา,15027,15831,30858,15040,15842,30882,10060
2565,14,พระนครศรีอยุธยา,1413,อำเภอบางซ้าย,6856,6985,13841,6878,6999,13877,4527
2565,14,พระนครศรีอยุธยา,1414,อำเภออุทัย,22348,24214,46562,22380,24249,46629,22362
2565,14,พระนครศรีอยุธยา,1415,อำเภอมหาราช,6392,7042,13434,6394,7044,13438,5193
2565,14,พระนครศรีอยุธยา,1416,อำเภอบ้านแพรก,3141,3645,6786,3147,3648,6795,2715
2565,14,พระนครศรีอยุธยา,1465,ท้องถิ่นเทศบาลเมืองบ้านกรด,6316,7356,13672,6325,7364,13689,9828
2565,14,พระนครศรีอยุธยา,1466,ท้องถิ่นเทศบาลตำบลสามเมือง,3605,3741,7346,3634,3775,7409,2945
2565,14,พระนครศรีอยุธยา,1467,ท้องถิ่นเทศบาลตำบลสามกอ,3247,3562,6809,3281,3593,6874,2950
2565,14,พระนครศรีอยุธยา,1468,ท้องถิ่นเทศบาลตำบลบางนมโค,3616,4078,7694,3621,4091,7712,4203
2565,14,พระนครศรีอยุธยา,1469,ท้องถิ่นเทศบาลตำบลบางกระสั้น,6236,7129,13365,6244,7136,13380,5880
2565,14,พระนครศรีอยุธยา,1470,ท้องถิ่นเทศบาลตำบลเชียงรากน้อย,4915,5239,10154,4957,5263,10220,4537
2565,14,พระนครศรีอยุธยา,1471,ท้องถิ่นเทศบาลตำบลคลองจิก,4510,5037,9547,4519,5041,9560,5614
2565,14,พระนครศรีอยุธยา,1472,ท้องถิ่นเทศบาลตำบลปราสาททอง,2386,2688,5074,2417,2705,5122,3479
2565,14,พระนครศรีอยุธยา,1473,ท้องถิ่นเทศบาลตำบลบ้านแพรก,933,1008,1941,934,1011,1945,882
2565,14,พระนครศรีอยุธยา,1474,ท้องถิ่นเทศบาลตำบลโรงช้าง,2956,3238,6194,2961,3241,6202,2523
2565,14,พระนครศรีอยุธยา,1475,ท้องถิ่นเทศบาลตำบลมหาราช,1556,1639,3195,1557,1640,3197,1466
2565,14,พระนครศรีอยุธยา,1476,ท้องถิ่นเทศบาลตำบลอุทัย,3280,3760,7040,3282,3764,7046,4442
2565,14,พระนครศรีอยุธยา,1477,ท้องถิ่นเทศบาลตำบลบางซ้าย,2513,2665,5178,2514,2667,5181,1895
2565,14,พระนครศรีอยุธยา,1478,ท้องถิ่นเทศบาลตำบลหัวเวียง,2791,2989,5780,2791,2989,5780,1830
2565,14,พระนครศรีอยุธยา,1479,ท้องถิ่นเทศบาลเมืองลำตาเสา,10597,11238,21835,10617,11255,21872,10058
2565,14,พระนครศรีอยุธยา,1480,ท้องถิ่นเทศบาลตำบลลาดบัวหลวง,1279,1332,2611,1281,1338,2619,1434
2565,14,พระนครศรีอยุธยา,1481,ท้องถิ่นเทศบาลตำบลภาชี,2457,2779,5236,2476,2801,5277,2591
2565,14,พระนครศรีอยุธยา,1482,ท้องถิ่นเทศบาลตำบลลาดชะโด,3607,3817,7424,3615,3817,7432,2805
2565,14,พระนครศรีอยุธยา,1483,ท้องถิ่นเทศบาลเมืองผักไห่,4512,4803,9315,4518,4814,9332,4407
2565,14,พระนครศรีอยุธยา,1484,ท้องถิ่นเทศบาลตำบลพระอินทราชา,4429,5007,9436,4445,5024,9469,6697
2565,14,พระนครศรีอยุธยา,1485,ท้องถิ่นเทศบาลเมืองบ้านสร้าง,5100,5931,11031,5108,5944,11052,7116
2565,14,พระนครศรีอยุธยา,1486,ท้องถิ่นเทศบาลตำบลบางปะอิน,3230,3317,6547,3240,3321,6561,2200
2565,14,พระนครศรีอยุธยา,1487,ท้องถิ่นเทศบาลตำบลบางปะหัน,2444,2755,5199,2447,2757,5204,2255
2565,14,พระนครศรีอยุธยา,1488,ท้องถิ่นเทศบาลตำบลมหาพราหมณ์,4041,4338,8379,4044,4341,8385,3348
2565,14,พระนครศรีอยุธยา,1489,ท้องถิ่นเทศบาลตำบลบางบาล,5128,5681,10809,5130,5685,10815,3773
2565,14,พระนครศรีอยุธยา,1490,ท้องถิ่นเทศบาลตำบลราชคราม,3013,3044,6057,3026,3056,6082,1847
2565,14,พระนครศรีอยุธยา,1491,ท้องถิ่นเทศบาลเมืองบางไทร,4935,5168,10103,4946,5177,10123,3927
2565,14,พระนครศรีอยุธยา,1492,ท้องถิ่นเทศบาลตำบลอรัญญิก,3708,3984,7692,3710,3986,7696,2843
2565,14,พระนครศรีอยุธยา,1493,ท้องถิ่นเทศบาลตำบลนครหลวง,3239,3583,6822,3242,3585,6827,3038
2565,14,พระนครศรีอยุธยา,1494,ท้องถิ่นเทศบาลตำบลท่าหลวง,3911,4331,8242,3918,4335,8253,4153
2565,14,พระนครศรีอยุธยา,1495,ท้องถิ่นเทศบาลเมืองอโยธยา,9121,10694,19815,9148,10720,19868,10389
2565,14,พระนครศรีอยุธยา,1496,ท้องถิ่นเทศบาลเมืองเจ้าเจ็ด,5053,5464,10517,5118,5526,10644,3263
2565,14,พระนครศรีอยุธยา,1497,ท้องถิ่นเทศบาลตำบลท่าเรือ,2954,3383,6337,2969,3399,6368,3229
2565,14,พระนครศรีอยุธยา,1498,ท้องถิ่นเทศบาลเมืองเสนา,1672,1892,3564,1692,1900,3592,1483
2565,14,พระนครศรีอยุธยา,1499,ท้องถิ่นเทศบาลนครพระนครศรีอยุธยา,22572,25001,47573,22833,25246,48079,20486
2565,15,อ่างทอง,1501,อำเภอเมืองอ่างทอง,20542,22859,43401,20564,22889,43453,17316
2565,15,อ่างทอง,1502,อำเภอไชโย,3363,3651,7014,3365,3654,7019,2448
2565,15,อ่างทอง,1503,อำเภอป่าโมก,8834,9751,18585,8845,9770,18615,6831
2565,15,อ่างทอง,1504,อำเภอโพธิ์ทอง,20629,22634,43263,20649,22655,43304,15030
2565,15,อ่างทอง,1505,อำเภอแสวงหา,14909,15605,30514,14919,15611,30530,10249
2565,15,อ่างทอง,1506,อำเภอวิเศษชัยชาญ,24133,26152,50285,24164,26179,50343,18554
2565,15,อ่างทอง,1507,อำเภอสามโก้,4041,4315,8356,4043,4320,8363,2899
2565,15,อ่างทอง,1590,ท้องถิ่นเทศบาลตำบลสามโก้,4996,5539,10535,4999,5542,10541,3627
2565,15,อ่างทอง,1591,ท้องถิ่นเทศบาลตำบลวิเศษไชยชาญ,2661,3135,5796,2678,3144,5822,3029
2565,15,อ่างทอง,1592,ท้องถิ่นเทศบาลตำบลบางจัก,3578,3925,7503,3580,3927,7507,2842
2565,15,อ่างทอง,1593,ท้องถิ่นเทศบาลตำบลแสวงหา,1538,1631,3169,1542,1635,3177,1283
2565,15,อ่างทอง,1594,ท้องถิ่นเทศบาลตำบลรำมะสัก,1984,2156,4140,1985,2158,4143,1501
2565,15,อ่างทอง,1595,ท้องถิ่นเทศบาลตำบลโพธิ์ทอง,1958,2221,4179,1960,2223,4183,1739
2565,15,อ่างทอง,1596,ท้องถิ่นเทศบาลตำบลไชโย,6008,6424,12432,6016,6429,12445,4245
2565,15,อ่างทอง,1597,ท้องถิ่นเทศบาลตำบลเกษไชโย,1368,1388,2756,1371,1390,2761,997
2565,15,อ่างทอง,1598,ท้องถิ่นเทศบาลตำบลป่าโมก,4093,4497,8590,4117,4517,8634,3671
2565,15,อ่างทอง,1599,ท้องถิ่นเทศบาลเมืองอ่างทอง,5496,6152,11648,5540,6207,11747,6671
2565,16,ลพบุรี,1601,อำเภอเมืองลพบุรี,50987,50712,101699,51034,50737,101771,42125
2565,16,ลพบุรี,1602,อำเภอพัฒนานิคม,26784,27749,54533,26816,27774,54590,23968
2565,16,ลพบุรี,1603,อำเภอโคกสำโรง,37468,38302,75770,37500,38328,75828,29200
2565,16,ลพบุรี,1604,อำเภอชัยบาดาล,36166,37059,73225,36198,37074,73272,28541
2565,16,ลพบุรี,1605,อำเภอท่าวุ้ง,20915,22634,43549,20928,22655,43583,14326
2565,16,ลพบุรี,1606,อำเภอบ้านหมี่,32785,35476,68261,32805,35496,68301,23678
2565,16,ลพบุรี,1607,อำเภอท่าหลวง,12722,13070,25792,12740,13081,25821,8607
2565,16,ลพบุรี,1608,อำเภอสระโบสถ์,7084,6905,13989,7088,6911,13999,5366
2565,16,ลพบุรี,1609,อำเภอโคกเจริญ,12148,12192,24340,12152,12200,24352,7914
2565,16,ลพบุรี,1610,อำเภอลำสนธิ,13492,13728,27220,13506,13729,27235,9617
2565,16,ลพบุรี,1611,อำเภอหนองม่วง,13581,14121,27702,13611,14159,27770,10313
2565,16,ลพบุรี,1681,ท้องถิ่นเทศบาลตำบลกกโก,4948,5843,10791,4957,5844,10801,5824
2565,16,ลพบุรี,1682,ท้องถิ่นเทศบาลตำบลถนนใหญ่,6275,5066,11341,6284,5071,11355,4885
2565,16,ลพบุรี,1683,ท้องถิ่นเทศบาลเมืองเขาสามยอด,15470,13006,28476,15666,13144,28810,12762
2565,16,ลพบุรี,1684,ท้องถิ่นเทศบาลตำบลท่าศาลา,6769,7668,14437,6785,7690,14475,7179
2565,16,ลพบุรี,1685,ท้องถิ่นเทศบาลตำบลดีลัง,3886,4129,8015,3892,4132,8024,3881
2565,16,ลพบุรี,1686,ท้องถิ่นเทศบาลตำบลเขาพระงาม,15344,8976,24320,15350,8981,24331,11943
2565,16,ลพบุรี,1688,ท้องถิ่นเทศบาลตำบลสระโบสถ์,3418,3720,7138,3420,3721,7141,3180
2565,16,ลพบุรี,1689,ท้องถิ่นเทศบาลตำบลบ้านท่าหลวง,1884,1907,3791,1890,1910,3800,2137
2565,16,ลพบุรี,1690,ท้องถิ่นเทศบาลตำบลท่าวุ้ง,995,1086,2081,996,1086,2082,888
2565,16,ลพบุรี,1691,ท้องถิ่นเทศบาลตำบลท่าโขลง,1031,1170,2201,1039,1183,2222,1008
2565,16,ลพบุรี,1692,ท้องถิ่นเทศบาลตำบลลำนารายณ์,7351,7987,15338,7471,8068,15539,8659
2565,16,ลพบุรี,1693,ท้องถิ่นเทศบาลตำบลหนองม่วง,2373,2534,4907,2379,2536,4915,2129
2565,16,ลพบุรี,1694,ท้องถิ่นเทศบาลตำบลพัฒนานิคม,1448,1586,3034,1538,1690,3228,1475
2565,16,ลพบุรี,1695,ท้องถิ่นเทศบาลตำบลแก่งเสือเต้น,1310,1377,2687,1311,1378,2689,1103
2565,16,ลพบุรี,1696,ท้องถิ่นเทศบาลตำบลโคกตูม,14815,15215,30030,14829,15222,30051,12032
2565,16,ลพบุรี,1697,ท้องถิ่นเทศบาลตำบลโคกสำโรง,2633,2886,5519,2641,2891,5532,2424
2565,16,ลพบุรี,1698,ท้องถิ่นเทศบาลเมืองบ้านหมี่,1440,1615,3055,1472,1635,3107,1343
2565,16,ลพบุรี,1699,ท้องถิ่นเทศบาลเมืองลพบุรี,9964,10652,20616,9996,10673,20669,12763
2565,17,สิงห์บุรี,1701,อำเภอเมืองสิงห์บุรี,16880,19296,36176,16912,19320,36232,13811
2565,17,สิงห์บุรี,1702,อำเภอบางระจัน,9258,9916,19174,9267,9923,19190,7243
2565,17,สิงห์บุรี,1703,อำเภอค่ายบางระจัน,12362,13250,25612,12375,13265,25640,9063
2565,17,สิงห์บุรี,1704,อำเภอพรหมบุรี,7778,8568,16346,7788,8585,16373,6027
2565,17,สิงห์บุรี,1705,อำเภอท่าช้าง,2507,2863,5370,2512,2865,5377,1885
2565,17,สิงห์บุรี,1706,อำเภออินทร์บุรี,23058,25095,48153,23077,25117,48194,17921
2565,17,สิงห์บุรี,1793,ท้องถิ่นเทศบาลตำบลอินทร์บุรี,2069,2281,4350,2073,2284,4357,2286
2565,17,สิงห์บุรี,1794,ท้องถิ่นเทศบาลตำบลถอนสมอ,4114,4510,8624,4117,4514,8631,3472
2565,17,สิงห์บุรี,1795,ท้องถิ่นเทศบาลตำบลพรหมบุรี,1511,1604,3115,1515,1606,3121,1322
2565,17,สิงห์บุรี,1796,ท้องถิ่นเทศบาลตำบลบางน้ำเชี่ยว,1594,1737,3331,1605,1745,3350,1405
2565,17,สิงห์บุรี,1797,ท้องถิ่นเทศบาลตำบลโพสังโฆ,936,1048,1984,937,1049,1986,861
2565,17,สิงห์บุรี,1798,ท้องถิ่นเทศบาลเมืองบางระจัน,6392,7228,13620,6405,7235,13640,5737
2565,17,สิงห์บุรี,1799,ท้องถิ่นเทศบาลเมืองสิงห์บุรี,7729,8917,16646,7762,8944,16706,9308
2565,18,ชัยนาท,1801,อำเภอเมืองชัยนาท,10986,11751,22737,11000,11759,22759,8849
2565,18,ชัยนาท,1802,อำเภอมโนรมย์,11265,12286,23551,11280,12303,23583,9098
2565,18,ชัยนาท,1803,อำเภอวัดสิงห์,10578,11346,21924,10580,11350,21930,9376
2565,18,ชัยนาท,1804,อำเภอสรรพยา,14678,15714,30392,14680,15719,30399,11885
2565,18,ชัยนาท,1805,อำเภอสรรคบุรี,28912,31429,60341,28939,31451,60390,22515
2565,18,ชัยนาท,1806,อำเภอหันคา,19667,20991,40658,19687,21010,40697,14883
2565,18,ชัยนาท,1807,อำเภอหนองมะโมง,6238,6456,12694,6242,6460,12702,5212
2565,18,ชัยนาท,1808,อำเภอเนินขาม,5283,5492,10775,5284,5492,10776,4057
2565,18,ชัยนาท,1880,ท้องถิ่นเทศบาลตำบลบางหลวง,2474,2760,5234,2474,2762,5236,2637
2565,18,ชัยนาท,1881,ท้องถิ่นเทศบาลตำบลนางลือ,3525,3904,7429,3528,3911,7439,2603
2565,18,ชัยนาท,1882,ท้องถิ่นเทศบาลตำบลเสือโฮก,3618,3821,7439,3622,3821,7443,2482
2565,18,ชัยนาท,1883,ท้องถิ่นเทศบาลตำบลหาดท่าเสา,2420,2575,4995,2421,2576,4997,1844
2565,18,ชัยนาท,1884,ท้องถิ่นเทศบาลตำบลชัยนาท,3563,4360,7923,3564,4361,7925,2733
2565,18,ชัยนาท,1885,ท้องถิ่นเทศบาลตำบลบ้านกล้วย,3305,3670,6975,3315,3673,6988,3637
2565,18,ชัยนาท,1887,ท้องถิ่นเทศบาลตำบลหนองแซง,3764,3932,7696,3767,3936,7703,2810
2565,18,ชัยนาท,1889,ท้องถิ่นเทศบาลตำบลวังตะเคียน,3251,3397,6648,3252,3398,6650,2504
2565,18,ชัยนาท,1890,ท้องถิ่นเทศบาลตำบลเนินขาม,2846,3108,5954,2846,3109,5955,2731
2565,18,ชัยนาท,1891,ท้องถิ่นเทศบาลตำบลหันคา,1911,2122,4033,1916,2125,4041,2449
2565,18,ชัยนาท,1892,ท้องถิ่นเทศบาลตำบลสามง่ามท่าโบสถ์,631,675,1306,632,675,1307,483
2565,18,ชัยนาท,1893,ท้องถิ่นเทศบาลตำบลแพรกศรีราชา,1123,1310,2433,1128,1320,2448,1382
2565,18,ชัยนาท,1894,ท้องถิ่นเทศบาลตำบลสรรพยา,1453,1555,3008,1453,1555,3008,1370
2565,18,ชัยนาท,1895,ท้องถิ่นเทศบาลตำบลโพธิ์พิทักษ์,720,808,1528,720,809,1529,578
2565,18,ชัยนาท,1896,ท้องถิ่นเทศบาลตำบลหางน้ำสาคร,2891,3130,6021,2904,3136,6040,3182
2565,18,ชัยนาท,1897,ท้องถิ่นเทศบาลตำบลคุ้งสำเภา,873,943,1816,879,946,1825,997
2565,18,ชัยนาท,1898,ท้องถิ่นเทศบาลตำบลวัดสิงห์,1466,1646,3112,1469,1648,3117,1974
2565,18,ชัยนาท,1899,ท้องถิ่นเทศบาลเมืองชัยนาท,5174,6152,11326,5218,6203,11421,7554
2565,19,สระบุรี,1901,อำเภอเมืองสระบุรี,25417,22271,47688,25462,22324,47786,20686
2565,19,สระบุรี,1902,อำเภอแก่งคอย,34510,35615,70125,34625,35686,70311,32113
2565,19,สระบุรี,1903,อำเภอหนองแค,32980,34994,67974,33039,35072,68111,35010
2565,19,สระบุรี,1904,อำเภอวิหารแดง,16203,16872,33075,16232,16908,33140,12467
2565,19,สระบุรี,1905,อำเภอหนองแซง,6187,6848,13035,6194,6855,13049,4598
2565,19,สระบุรี,1906,อำเภอบ้านหมอ,15209,16154,31363,15228,16169,31397,12733
2565,19,สระบุรี,1907,อำเภอดอนพุด,943,1009,1952,943,1009,1952,673
2565,19,สระบุรี,1908,อำเภอหนองโดน,5565,5894,11459,5571,5898,11469,4622
2565,19,สระบุรี,1909,อำเภอพระพุทธบาท,12006,12762,24768,12018,12773,24791,10302
2565,19,สระบุรี,1910,อำเภอเสาไห้,10621,11598,22219,10649,11625,22274,8648
2565,19,สระบุรี,1911,อำเภอมวกเหล็ก,24725,24979,49704,24803,25022,49825,22617
2565,19,สระบุรี,1912,อำเภอวังม่วง,5660,5929,11589,5665,5934,11599,4707
2565,19,สระบุรี,1913,อำเภอเฉลิมพระเกียรติ,14625,15438,30063,14648,15467,30115,13126
2565,19,สระบุรี,1974,ท้องถิ่นเทศบาลตำบลพุกร่าง,3298,3488,6786,3298,3492,6790,2505
2565,19,สระบุรี,1975,ท้องถิ่นเทศบาลตำบลคำพราน,2054,2111,4165,2058,2112,4170,2168
2565,19,สระบุรี,1976,ท้องถิ่นเทศบาลตำบลไผ่ต่ำ,2004,2051,4055,2010,2062,4072,2148
2565,19,สระบุรี,1977,ท้องถิ่นเทศบาลตำบลตะกุด,2325,2460,4785,2331,2465,4796,2338
2565,19,สระบุรี,1978,ท้องถิ่นเทศบาลตำบลกุดนกเปล้า,2985,3141,6126,2986,3143,6129,2678
2565,19,สระบุรี,1979,ท้องถิ่นเทศบาลตำบลหน้าพระลาน,3819,3801,7620,3839,3826,7665,3354
2565,19,สระบุรี,1980,ท้องถิ่นเทศบาลตำบลวังม่วง,2068,2199,4267,2081,2208,4289,2616
2565,19,สระบุรี,1981,ท้องถิ่นเทศบาลตำบลมวกเหล็ก,3171,3382,6553,3199,3412,6611,4404
2565,19,สระบุรี,1982,ท้องถิ่นเทศบาลตำบลเสาไห้,1467,1591,3058,1474,1597,3071,1507
2565,19,สระบุรี,1983,ท้องถิ่นเทศบาลตำบลสวนดอกไม้,3679,4118,7797,3681,4119,7800,4143
2565,19,สระบุรี,1984,ท้องถิ่นเทศบาลตำบลบ้านยาง,495,571,1066,497,572,1069,404
2565,19,สระบุรี,1985,ท้องถิ่นเทศบาลตำบลหนองโดน,1135,1249,2384,1136,1249,2385,1046
2565,19,สระบุรี,1986,ท้องถิ่นเทศบาลตำบลดอนพุด,2276,2333,4609,2277,2334,4611,1876
2565,19,สระบุรี,1987,ท้องถิ่นเทศบาลตำบลบ้านหมอ,1232,1332,2564,1235,1338,2573,1345
2565,19,สระบุรี,1988,ท้องถิ่นเทศบาลตำบลท่าลาน,3694,3955,7649,3701,3960,7661,4036
2565,19,สระบุรี,1989,ท้องถิ่นเทศบาลตำบลหนองแซง,1352,1501,2853,1357,1502,2859,1040
2565,19,สระบุรี,1990,ท้องถิ่นเทศบาลตำบลหนองหมู,814,860,1674,815,860,1675,505
2565,19,สระบุรี,1991,ท้องถิ่นเทศบาลตำบลวิหารแดง,1869,2067,3936,1880,2076,3956,1930
2565,19,สระบุรี,1992,ท้องถิ่นเทศบาลตำบลหินกอง,4438,4960,9398,4455,4978,9433,5695
2565,19,สระบุรี,1993,ท้องถิ่นเทศบาลตำบลคชสิทธิ์,622,667,1289,626,672,1298,676
2565,19,สระบุรี,1994,ท้องถิ่นเทศบาลเมืองทับกวาง,9926,10014,19940,10019,10072,20091,10075
2565,19,สระบุรี,1995,ท้องถิ่นเทศบาลตำบลป๊อกแป๊ก,317,388,705,319,389,708,434
2565,19,สระบุรี,1996,ท้องถิ่นเทศบาลเมืองพระพุทธบาท,12900,14974,27874,13092,15175,28267,13503
2565,19,สระบุรี,1997,ท้องถิ่นเทศบาลตำบลหนองแค,5841,6250,12091,5914,6323,12237,6496
2565,19,สระบุรี,1998,ท้องถิ่นเทศบาลเมืองแก่งคอย,5139,5561,10700,5159,5571,10730,6229
2565,19,สระบุรี,1999,ท้องถิ่นเทศบาลเมืองสระบุรี,28507,28980,57487,28697,29120,57817,28976
2565,20,ชลบุรี,2001,อำเภอเมืองชลบุรี,21056,22410,43466,21091,22439,43530,27913
2565,20,ชลบุรี,2002,อำเภอบ้านบึง,41181,42632,83813,41541,42913,84454,47385
2565,20,ชลบุรี,2003,อำเภอหนองใหญ่,7397,7479,14876,7604,7639,15243,6854
2565,20,ชลบุรี,2004,อำเภอบางละมุง,13934,15899,29833,14177,16066,30243,19611
2565,20,ชลบุรี,2005,อำเภอพานทอง,24010,24899,48909,24035,24924,48959,40501
2565,20,ชลบุรี,2006,อำเภอพนัสนิคม,49223,52135,101358,49533,52432,101965,38548
2565,20,ชลบุรี,2007,อำเภอศรีราชา,28329,28592,56921,28469,28680,57149,49187
2565,20,ชลบุรี,2008,อำเภอเกาะสีชัง,0,0,0,0,0,0,0
2565,20,ชลบุรี,2009,อำเภอสัตหีบ,26746,26172,52918,27144,26512,53656,30111
2565,20,ชลบุรี,2010,อำเภอบ่อทอง,18825,18625,37450,18954,18715,37669,13853
2565,20,ชลบุรี,2011,อำเภอเกาะจันทร์,13404,12689,26093,13839,13031,26870,8943
2565,20,ชลบุรี,2060,ท้องถิ่นเทศบาลตำบลเกล็ดแก้ว,7144,5594,12738,7309,5610,12919,6682
2565,20,ชลบุรี,2061,ท้องถิ่นเทศบาลตำบลเขตรอุดมศักดิ์,34193,21956,56149,34292,21997,56289,27452
2565,20,ชลบุรี,2063,ท้องถิ่นเทศบาลตำบลหมอนนาง,6535,6948,13483,6574,6966,13540,4673
2565,20,ชลบุรี,2064,ท้องถิ่นเทศบาลตำบลตะเคียนเตี้ย,12366,13391,25757,12424,13420,25844,13471
2565,20,ชลบุรี,2065,ท้องถิ่นเทศบาลตำบลเสม็ด,10309,12476,22785,10351,12493,22844,17619
2565,20,ชลบุรี,2066,ท้องถิ่นเทศบาลเมืองดอนหัวฬ่อ,6726,6847,13573,6737,6851,13588,15886
2565,20,ชลบุรี,2067,ท้องถิ่นเทศบาลตำบลห้วยกะปิ,7931,9060,16991,7951,9067,17018,10761
2565,20,ชลบุรี,2068,ท้องถิ่นเทศบาลตำบลนาป่า,20390,21514,41904,20416,21533,41949,26643
2565,20,ชลบุรี,2069,ท้องถิ่นเทศบาลตำบลหนองไม้แดง,6618,6424,13042,6628,6428,13056,11361
2565,20,ชลบุรี,2070,ท้องถิ่นเทศบาลตำบลธาตุทอง,3798,3951,7749,3846,3994,7840,2818
2565,20,ชลบุรี,2071,ท้องถิ่นเทศบาลตำบลโป่ง,5319,5949,11268,5442,5966,11408,6854
2565,20,ชลบุรี,2072,ท้องถิ่นเทศบาลเมืองหนองปรือ,38418,48812,87230,39836,49055,88891,52280
2565,20,ชลบุรี,2073,ท้องถิ่นเทศบาลตำบลท่าบุญมี,3252,3433,6685,3267,3447,6714,4219
2565,20,ชลบุรี,2074,ท้องถิ่นเทศบาลตำบลเกาะจันทร์,4060,1838,5898,4066,1841,5907,1996
2565,20,ชลบุรี,2075,ท้องถิ่นเทศบาลตำบลบ่อทอง,1769,1893,3662,2062,2152,4214,2133
2565,20,ชลบุรี,2076,ท้องถิ่นเทศบาลเมืองสัตหีบ,10154,11371,21525,10207,11409,21616,12181
2565,20,ชลบุรี,2077,ท้องถิ่นเทศบาลตำบลบางเสร่,5152,6324,11476,5318,6353,11671,9518
2565,20,ชลบุรี,2078,ท้องถิ่นเทศบาลตำบลนาจอมเทียน,3531,4068,7599,3709,4123,7832,16127
2565,20,ชลบุรี,2079,ท้องถิ่นเทศบาลตำบลเกาะสีชัง,2232,2278,4510,2238,2282,4520,2261
2565,20,ชลบุรี,2080,ท้องถิ่นเทศบาลนครเจ้าพระยาสุรศักดิ์,74336,78871,153207,74649,79038,153687,107539
2565,20,ชลบุรี,2081,ท้องถิ่นเทศบาลตำบลบางพระ,6387,7000,13387,6422,7013,13435,8138
2565,20,ชลบุรี,2082,ท้องถิ่นเทศบาลตำบลหนองตำลึง,10952,11273,22225,10963,11285,22248,17609
2565,20,ชลบุรี,2083,ท้องถิ่นเทศบาลตำบลพานทอง,2912,3136,6048,3085,3301,6386,3815
2565,20,ชลบุรี,2084,ท้องถิ่นเทศบาลตำบลห้วยใหญ่,14404,16432,30836,14633,16491,31124,18961
2565,20,ชลบุรี,2085,ท้องถิ่นเทศบาลตำบลบางละมุง,6086,6669,12755,6150,6757,12907,9207
2565,20,ชลบุรี,2086,ท้องถิ่นเทศบาลตำบลหนองใหญ่,4137,4001,8138,4395,4213,8608,3510
2565,20,ชลบุรี,2087,ท้องถิ่นเทศบาลตำบลหัวกุญแจ,1661,1884,3545,1687,1906,3593,2133
2565,20,ชลบุรี,2088,ท้องถิ่นเทศบาลตำบลหนองไผ่แก้ว,1096,1190,2286,1097,1194,2291,1599
2565,20,ชลบุรี,2089,ท้องถิ่นเทศบาลเมืองอ่างศิลา,17000,19742,36742,17037,19769,36806,22433
2565,20,ชลบุรี,2090,ท้องถิ่นเทศบาลนครบ้านสวน,33261,33919,67180,34382,34874,69256,46259
2565,20,ชลบุรี,2091,ท้องถิ่นเทศบาลตำบลบางทราย,6375,5035,11410,6401,5047,11448,7476
2565,20,ชลบุรี,2092,ท้องถิ่นเทศบาลตำบลคลองตำหรุ,2194,2471,4665,2208,2480,4688,6888
2565,20,ชลบุรี,2093,ท้องถิ่นเทศบาลนครแหลมฉบัง,44345,45901,90246,44875,46344,91219,82805
2565,20,ชลบุรี,2094,ท้องถิ่นเทศบาลเมืองแสนสุข,21112,24313,45425,21433,24541,45974,39327
2565,20,ชลบุรี,2095,ท้องถิ่นเทศบาลเมืองบ้านบึง,8694,10039,18733,9497,10763,20260,10632
2565,20,ชลบุรี,2096,ท้องถิ่นเมืองพัทยา,49402,60809,110211,53046,63332,116378,176104
2565,20,ชลบุรี,2097,ท้องถิ่นเทศบาลเมืองศรีราชา,9676,12259,21935,10456,12952,23408,8991
2565,20,ชลบุรี,2098,ท้องถิ่นเทศบาลเมืองพนัสนิคม,4479,5330,9809,4496,5333,9829,5038
2565,20,ชลบุรี,2099,ท้องถิ่นเทศบาลเมืองชลบุรี,11183,12530,23713,11248,12567,23815,12502
2565,21,ระยอง,2101,อำเภอเมืองระยอง,50419,51993,102412,50770,52130,102900,67335
2565,21,ระยอง,2102,อำเภอบ้านฉาง,5657,5120,10777,5680,5134,10814,5002
2565,21,ระยอง,2103,อำเภอแกลง,32446,34950,67396,32535,35014,67549,32211
2565,21,ระยอง,2104,อำเภอวังจันทร์,11079,11134,22213,11127,11172,22299,11422
2565,21,ระยอง,2105,อำเภอบ้านค่าย,33108,34887,67995,33209,34951,68160,36800
2565,21,ระยอง,2106,อำเภอปลวกแดง,38177,37022,75199,38254,37103,75357,104779
2565,21,ระยอง,2107,อำเภอเขาชะเมา,11718,11882,23600,11751,11915,23666,11301
2565,21,ระยอง,2108,อำเภอนิคมพัฒนา,11318,11430,22748,11352,11469,22821,19164
2565,21,ระยอง,2177,ท้องถิ่นเทศบาลตำบลพลา,4111,4211,8322,4266,4251,8517,5630
2565,21,ระยอง,2178,ท้องถิ่นเทศบาลตำบลเนินฆ้อ,2179,2341,4520,2190,2348,4538,2013
2565,21,ระยอง,2179,ท้องถิ่นเทศบาลตำบลทับมา,12654,12868,25522,12697,12893,25590,17568
2565,21,ระยอง,2180,ท้องถิ่นเทศบาลตำบลบ้านนา,4163,4339,8502,4172,4356,8528,3506
2565,21,ระยอง,2181,ท้องถิ่นเทศบาลตำบลมาบข่าพัฒนา,5331,5361,10692,5338,5372,10710,7978
2565,21,ระยอง,2182,ท้องถิ่นเทศบาลตำบลบ้านฉาง,7812,8178,15990,7927,8211,16138,9621
2565,21,ระยอง,2183,ท้องถิ่นเทศบาลเมืองมะขามคู่,7130,7199,14329,7138,7207,14345,12962
2565,21,ระยอง,2184,ท้องถิ่นเทศบาลเมืองนิคมพัฒนา,5584,5488,11072,5587,5495,11082,8708
2565,21,ระยอง,2185,ท้องถิ่นเทศบาลตำบลบ้านปลวกแดง,2384,2729,5113,2611,2922,5533,4553
2565,21,ระยอง,2186,ท้องถิ่นเทศบาลตำบลจอมพลเจ้าพระยา,196,192,388,196,192,388,614
2565,21,ระยอง,2187,ท้องถิ่นเทศบาลตำบลบ้านค่าย,1531,1708,3239,1613,1786,3399,2117
2565,21,ระยอง,2188,ท้องถิ่นเทศบาลตำบลชุมแสง,1767,1815,3582,1819,1863,3682,2358
2565,21,ระยอง,2189,ท้องถิ่นเทศบาลตำบลสุนทรภู่,6923,7797,14720,7147,7855,15002,10266
2565,21,ระยอง,2190,ท้องถิ่นเทศบาลตำบลปากน้ำประแส,2255,2410,4665,2274,2429,4703,2069
2565,21,ระยอง,2191,ท้องถิ่นเทศบาลตำบลทุ่งควายกิน,3114,3433,6547,3136,3446,6582,4119
2565,21,ระยอง,2192,ท้องถิ่นเทศบาลตำบลกองดิน,2370,2382,4752,2375,2392,4767,1874
2565,21,ระยอง,2193,ท้องถิ่นเทศบาลตำบลสำนักท้อน,5469,5665,11134,5497,5683,11180,6164
2565,21,ระยอง,2194,ท้องถิ่นเทศบาลเมืองบ้านฉาง,15081,16065,31146,15336,16181,31517,21316
2565,21,ระยอง,2195,ท้องถิ่นเทศบาลตำบลบ้านเพ,8359,9374,17733,8526,9411,17937,12278
2565,21,ระยอง,2196,ท้องถิ่นเทศบาลตำบลแกลงกะเฉด,3377,3663,7040,3408,3675,7083,3407
2565,21,ระยอง,2197,ท้องถิ่นเทศบาลนครมาบตาพุด,37660,37536,75196,37880,37751,75631,63937
2565,21,ระยอง,2198,ท้องถิ่นเทศบาลตำบลเมืองแกลง,8099,9228,17327,8721,9762,18483,11829
2565,21,ระยอง,2199,ท้องถิ่นเทศบาลนครระยอง,26935,30878,57813,28331,32154,60485,38162
2565,22,จันทบุรี,2201,อำเภอเมืองจันทบุรี,22323,24853,47176,22394,24905,47299,23019
2565,22,จันทบุรี,2202,อำเภอขลุง,12420,12901,25321,12442,12918,25360,10426
2565,22,จันทบุรี,2203,อำเภอท่าใหม่,23184,24193,47377,23259,24247,47506,18477
2565,22,จันทบุรี,2204,อำเภอโป่งน้ำร้อน,10905,10367,21272,10983,10490,21473,8884
2565,22,จันทบุรี,2205,อำเภอมะขาม,15118,15587,30705,15212,15696,30908,13849
2565,22,จันทบุรี,2206,อำเภอแหลมสิงห์,6797,7147,13944,6846,7199,14045,5418
2565,22,จันทบุรี,2207,อำเภอสอยดาว,18784,18482,37266,18874,18547,37421,15324
2565,22,จันทบุรี,2208,อำเภอแก่งหางแมว,21304,21166,42470,21412,21289,42701,21763
2565,22,จันทบุรี,2209,อำเภอนายายอาม,14726,15819,30545,14881,15974,30855,12323
2565,22,จันทบุรี,2210,อำเภอเขาคิชฌกูฏ,6265,6498,12763,6284,6517,12801,5666
2565,22,จันทบุรี,2272,ท้องถิ่นเทศบาลตำบลเขาบายศรี,3083,3218,6301,3109,3233,6342,2587
2565,22,จันทบุรี,2273,ท้องถิ่นเทศบาลตำบลคลองใหญ่,2608,2634,5242,2640,2668,5308,2131
2565,22,จันทบุรี,2274,ท้องถิ่นเทศบาลตำบลหนองตาคง,5127,4866,9993,5162,4912,10074,4093
2565,22,จันทบุรี,2275,ท้องถิ่นเทศบาลตำบลตกพรม,1961,2122,4083,1995,2140,4135,1659
2565,22,จันทบุรี,2276,ท้องถิ่นเทศบาลตำบลเกวียนหัก,2114,2460,4574,2116,2462,4578,2260
2565,22,จันทบุรี,2277,ท้องถิ่นเทศบาลตำบลบ่อ,3483,3629,7112,3485,3636,7121,2746
2565,22,จันทบุรี,2278,ท้องถิ่นเทศบาลตำบลชากไทย,2101,2213,4314,2120,2233,4353,1922
2565,22,จันทบุรี,2279,ท้องถิ่นเทศบาลตำบลตะเคียนทอง,2345,2294,4639,2350,2297,4647,1865
2565,22,จันทบุรี,2280,ท้องถิ่นเทศบาลเมืองเกาะขวาง,8140,9012,17152,8199,9046,17245,8463
2565,22,จันทบุรี,2281,ท้องถิ่นเทศบาลตำบลบ่อเวฬุ,2253,2064,4317,2273,2083,4356,2607
2565,22,จันทบุรี,2282,ท้องถิ่นเทศบาลตำบลพลวง,3474,3700,7174,3581,3803,7384,4266
2565,22,จันทบุรี,2283,ท้องถิ่นเทศบาลตำบลทับช้าง,8195,8086,16281,8216,8093,16309,6199
2565,22,จันทบุรี,2284,ท้องถิ่นเทศบาลตำบลนายายอาม,1625,1822,3447,1629,1831,3460,1999
2565,22,จันทบุรี,2285,ท้องถิ่นเทศบาลตำบลสอยดาว,5462,5633,11095,5538,5713,11251,6458
2565,22,จันทบุรี,2286,ท้องถิ่นเทศบาลตำบลพลิ้ว,3262,3721,6983,3270,3725,6995,3162
2565,22,จันทบุรี,2287,ท้องถิ่นเทศบาลตำบลปากน้ำแหลมสิงห์,4173,4446,8619,4183,4457,8640,3471
2565,22,จันทบุรี,2288,ท้องถิ่นเทศบาลตำบลมะขาม,793,902,1695,797,906,1703,1037
2565,22,จันทบุรี,2289,ท้องถิ่นเทศบาลตำบลโป่งน้ำร้อน,4920,4108,9028,5077,4258,9335,4357
2565,22,จันทบุรี,2290,ท้องถิ่นเทศบาลตำบลหนองคล้า,1764,1964,3728,1775,1981,3756,2203
2565,22,จันทบุรี,2291,ท้องถิ่นเทศบาลตำบลเนินสูง,1475,1570,3045,1480,1575,3055,1701
2565,22,จันทบุรี,2292,ท้องถิ่นเทศบาลตำบลหนองบัว,1028,1183,2211,1029,1183,2212,982
2565,22,จันทบุรี,2293,ท้องถิ่นเทศบาลตำบลพลับพลานารายณ์,4862,5408,10270,4870,5426,10296,6448
2565,22,จันทบุรี,2294,ท้องถิ่นเทศบาลตำบลบางกะจะ,2452,2648,5100,2460,2650,5110,2252
2565,22,จันทบุรี,2295,ท้องถิ่นเทศบาลเมืองท่าช้าง,6415,7686,14101,6447,7702,14149,11006
2565,22,จันทบุรี,2296,ท้องถิ่นเทศบาลเมืองจันทนิมิต,5459,6192,11651,5562,6300,11862,7923
2565,22,จันทบุรี,2297,ท้องถิ่นเทศบาลเมืองขลุง,4836,5528,10364,4857,5551,10408,4306
2565,22,จันทบุรี,2298,ท้องถิ่นเทศบาลเมืองท่าใหม่,4656,5333,9989,4686,5364,10050,4675
2565,22,จันทบุรี,2299,ท้องถิ่นเทศบาลเมืองจันทบุรี,9856,10821,20677,10381,11260,21641,14798
2565,23,ตราด,2301,อำเภอเมืองตราด,34802,37236,72038,36093,38461,74554,36463
2565,23,ตราด,2302,อำเภอคลองใหญ่,5938,5738,11676,7380,7261,14641,5526
2565,23,ตราด,2303,อำเภอเขาสมิง,19698,19980,39678,19842,20097,39939,18251
2565,23,ตราด,2304,อำเภอบ่อไร่,9441,8855,18296,9563,8991,18554,7748
2565,23,ตราด,2305,อำเภอแหลมงอบ,7069,6979,14048,7160,7078,14238,5927
2565,23,ตราด,2306,อำเภอเกาะกูด,1377,1263,2640,1419,1297,2716,2106
2565,23,ตราด,2307,อำเภอเกาะช้าง,4003,4053,8056,4253,4268,8521,6193
2565,23,ตราด,2389,ท้องถิ่นเทศบาลตำบลตะกาง,1258,1324,2582,1281,1348,2629,1385
2565,23,ตราด,2390,ท้องถิ่นเทศบาลตำบลหนองบอน,3728,3648,7376,3749,3682,7431,3972
2565,23,ตราด,2391,ท้องถิ่นเทศบาลตำบลแหลมงอบ,853,865,1718,864,875,1739,748
2565,23,ตราด,2392,ท้องถิ่นเทศบาลตำบลน้ำเชี่ยว,1544,1652,3196,1551,1661,3212,1331
2565,23,ตราด,2393,ท้องถิ่นเทศบาลตำบลบ่อพลอย,4215,4244,8459,4368,4409,8777,5723
2565,23,ตราด,2394,ท้องถิ่นเทศบาลตำบลแสนตุ้ง,1525,1598,3123,1564,1631,3195,2404
2565,23,ตราด,2395,ท้องถิ่นเทศบาลตำบลเขาสมิง,697,674,1371,699,677,1376,617
2565,23,ตราด,2396,ท้องถิ่นเทศบาลตำบลหาดเล็ก,2529,2396,4925,2737,2594,5331,2000
2565,23,ตราด,2397,ท้องถิ่นเทศบาลตำบลคลองใหญ่,2381,2384,4765,2598,2643,5241,2444
2565,23,ตราด,2398,ท้องถิ่นเทศบาลตำบลท่าพริกเนินทราย,3027,3331,6358,3109,3422,6531,3112
2565,23,ตราด,2399,ท้องถิ่นเทศบาลเมืองตราด,3675,4089,7764,4438,4745,9183,5530
2565,24,ฉะเชิงเทรา,2401,อำเภอเมืองฉะเชิงเทรา,60502,63684,124186,60705,63870,124575,53772
2565,24,ฉะเชิงเทรา,2402,อำเภอบางคล้า,14663,15732,30395,14700,15772,30472,12964
2565,24,ฉะเชิงเทรา,2403,อำเภอบางน้ำเปรี้ยว,36253,36890,73143,36381,36994,73375,22992
2565,24,ฉะเชิงเทรา,2404,อำเภอบางปะกง,27958,29204,57162,28361,29531,57892,28357
2565,24,ฉะเชิงเทรา,2405,อำเภอบ้านโพธิ์,22311,24036,46347,22350,24073,46423,21613
2565,24,ฉะเชิงเทรา,2406,อำเภอพนมสารคาม,34592,36520,71112,34723,36649,71372,31414
2565,24,ฉะเชิงเทรา,2407,อำเภอราชสาส์น,6183,6429,12612,6188,6441,12629,4926
2565,24,ฉะเชิงเทรา,2408,อำเภอสนามชัยเขต,35372,35328,70700,35453,35405,70858,23525
2565,24,ฉะเชิงเทรา,2409,อำเภอแปลงยาว,11343,11082,22425,11382,11125,22507,12167
2565,24,ฉะเชิงเทรา,2410,อำเภอท่าตะเกียบ,23557,23336,46893,23597,23371,46968,17657
2565,24,ฉะเชิงเทรา,2411,อำเภอคลองเขื่อน,6136,6427,12563,6143,6438,12581,4581
2565,24,ฉะเชิงเทรา,2474,ท้องถิ่นเทศบาลตำบลบางวัวคณารักษ์,5378,5868,11246,5392,5881,11273,8800
2565,24,ฉะเชิงเทรา,2475,ท้องถิ่นเทศบาลตำบลพิมพา,1659,1794,3453,1664,1796,3460,3820
2565,24,ฉะเชิงเทรา,2476,ท้องถิ่นเทศบาลตำบลวังเย็น,4714,4820,9534,4721,4830,9551,3626
2565,24,ฉะเชิงเทรา,2477,ท้องถิ่นเทศบาลตำบลดอนเกาะกา,4381,4266,8647,4400,4280,8680,2436
2565,24,ฉะเชิงเทรา,2478,ท้องถิ่นเทศบาลตำบลหัวสำโรง,3314,3480,6794,3319,3492,6811,4077
2565,24,ฉะเชิงเทรา,2479,ท้องถิ่นเทศบาลตำบลแปลงยาว,3022,3158,6180,3027,3161,6188,3612
2565,24,ฉะเชิงเทรา,2480,ท้องถิ่นเทศบาลตำบลทุ่งสะเดา,2973,2454,5427,3081,2562,5643,4637
2565,24,ฉะเชิงเทรา,2481,ท้องถิ่นเทศบาลตำบลสนามชัยเขต,1980,2204,4184,2025,2259,4284,2999
2565,24,ฉะเชิงเทรา,2482,ท้องถิ่นเทศบาลตำบลพนมสารคาม,2893,3348,6241,2903,3358,6261,4265
2565,24,ฉะเชิงเทรา,2483,ท้องถิ่นเทศบาลตำบลเขาหินซ้อน,1688,1775,3463,1690,1777,3467,2666
2565,24,ฉะเชิงเทรา,2484,ท้องถิ่นเทศบาลตำบลเกาะขนุน,1016,1099,2115,1020,1103,2123,1105
2565,24,ฉะเชิงเทรา,2485,ท้องถิ่นเทศบาลตำบลบ้านโพธิ์,1320,1370,2690,1380,1420,2800,1427
2565,24,ฉะเชิงเทรา,2486,ท้องถิ่นเทศบาลตำบลเทพราช,2035,2139,4174,2037,2143,4180,1292
2565,24,ฉะเชิงเทรา,2487,ท้องถิ่นเทศบาลตำบลบางวัว,1253,1379,2632,1259,1384,2643,2019
2565,24,ฉะเชิงเทรา,2488,ท้องถิ่นเทศบาลตำบลบางปะกง,2826,3133,5959,2837,3151,5988,2933
2565,24,ฉะเชิงเทรา,2489,ท้องถิ่นเทศบาลตำบลหอมศีล,628,623,1251,628,624,1252,321
2565,24,ฉะเชิงเทรา,2490,ท้องถิ่นเทศบาลตำบลท่าสะอ้าน,1675,1794,3469,1680,1794,3474,2691
2565,24,ฉะเชิงเทรา,2491,ท้องถิ่นเทศบาลตำบลท่าข้าม,3581,3839,7420,3590,3852,7442,9100
2565,24,ฉะเชิงเทรา,2492,ท้องถิ่นเทศบาลตำบลศาลาแดง,710,753,1463,712,756,1468,550
2565,24,ฉะเชิงเทรา,2493,ท้องถิ่นเทศบาลตำบลบางน้ำเปรี้ยว,1101,1183,2284,1111,1194,2305,1229
2565,24,ฉะเชิงเทรา,2494,ท้องถิ่นเทศบาลตำบลบางขนาก,1048,1019,2067,1058,1029,2087,798
2565,24,ฉะเชิงเทรา,2495,ท้องถิ่นเทศบาลตำบลดอนฉิมพลี,768,779,1547,779,783,1562,736
2565,24,ฉะเชิงเทรา,2496,ท้องถิ่นเทศบาลตำบลปากน้ำ,2530,2748,5278,2596,2825,5421,2692
2565,24,ฉะเชิงเทรา,2497,ท้องถิ่นเทศบาลตำบลนครเนื่องเขต,650,760,1410,654,764,1418,498
2565,24,ฉะเชิงเทรา,2498,ท้องถิ่นเทศบาลตำบลบางคล้า,4452,5239,9691,4487,5278,9765,4993
2565,24,ฉะเชิงเทรา,2499,ท้องถิ่นเทศบาลเมืองฉะเชิงเทรา,17194,19269,36463,17726,19763,37489,22316
2565,25,ปราจีนบุรี,2501,อำเภอเมืองปราจีนบุรี,45520,42760,88280,45652,42846,88498,36687
2565,25,ปราจีนบุรี,2502,อำเภอกบินทร์บุรี,66970,69241,136211,67075,69313,136388,54536
2565,25,ปราจีนบุรี,2503,อำเภอนาดี,22009,22232,44241,22036,22252,44288,18463
2565,25,ปราจีนบุรี,2506,อำเภอบ้านสร้าง,13457,13985,27442,13476,14012,27488,9597
2565,25,ปราจีนบุรี,2507,อำเภอประจันตคาม,24300,25564,49864,24318,25587,49905,17772
2565,25,ปราจีนบุรี,2508,อำเภอศรีมหาโพธิ,37474,39361,76835,37536,39404,76940,56636
2565,25,ปราจีนบุรี,2509,อำเภอศรีมโหสถ,6592,6796,13388,6599,6804,13403,6733
2565,25,ปราจีนบุรี,2587,ท้องถิ่นเทศบาลตำบลโคกมะกอก,1046,1161,2207,1049,1163,2212,852
2565,25,ปราจีนบุรี,2588,ท้องถิ่นเทศบาลตำบลโคกปีบ,2739,3022,5761,2755,3032,5787,2359
2565,25,ปราจีนบุรี,2589,ท้องถิ่นเทศบาลตำบลศรีมหาโพธิ,1734,1836,3570,1736,1838,3574,2472
2565,25,ปราจีนบุรี,2590,ท้องถิ่นเทศบาลตำบลกรอกสมบูรณ์,1741,1763,3504,1741,1763,3504,1313
2565,25,ปราจีนบุรี,2591,ท้องถิ่นเทศบาลตำบลประจันตคาม,2084,2311,4395,2086,2312,4398,2407
2565,25,ปราจีนบุรี,2592,ท้องถิ่นเทศบาลตำบลบ้านสร้าง,1555,1613,3168,1563,1622,3185,1660
2565,25,ปราจีนบุรี,2593,ท้องถิ่นเทศบาลตำบลนาดี,3873,4006,7879,3882,4023,7905,3391
2565,25,ปราจีนบุรี,2594,ท้องถิ่นเทศบาลตำบลสระบัว,878,911,1789,881,916,1797,650
2565,25,ปราจีนบุรี,2595,ท้องถิ่นเทศบาลตำบลเมืองเก่า,3031,3190,6221,3222,3326,6548,4562
2565,25,ปราจีนบุรี,2596,ท้องถิ่นเทศบาลตำบลบ้านนาปรือ,1107,1109,2216,1109,1110,2219,806
2565,25,ปราจีนบุรี,2598,ท้องถิ่นเทศบาลตำบลกบินทร์,1670,1949,3619,1673,1952,3625,2207
2565,25,ปราจีนบุรี,2599,ท้องถิ่นเทศบาลเมืองปราจีนบุรี,7456,8599,16055,7495,8619,16114,9036
2565,26,นครนายก,2601,อำเภอเมืองนครนายก,42646,42487,85133,42683,42509,85192,36199
2565,26,นครนายก,2602,อำเภอปากพลี,10838,11538,22376,10842,11545,22387,8883
2565,26,นครนายก,2603,อำเภอบ้านนา,31988,32178,64166,32073,32249,64322,24810
2565,26,นครนายก,2604,อำเภอองครักษ์,30579,31546,62125,30901,31834,62735,23011
2565,26,นครนายก,2695,ท้องถิ่นเทศบาลตำบลองครักษ์,1188,1277,2465,1244,1342,2586,1373
2565,26,นครนายก,2696,ท้องถิ่นเทศบาลตำบลบ้านนา,2176,2484,4660,2196,2493,4689,2539
2565,26,นครนายก,2697,ท้องถิ่นเทศบาลตำบลเกาะหวาย,821,918,1739,826,919,1745,761
2565,26,นครนายก,2698,ท้องถิ่นเทศบาลตำบลท่าช้าง,496,518,1014,496,518,1014,331
2565,26,นครนายก,2699,ท้องถิ่นเทศบาลเมืองนครนายก,7282,8020,15302,7529,8207,15736,8732
2565,27,สระแก้ว,2701,อำเภอเมืองสระแก้ว,43759,43045,86804,43865,43148,87013,30501
2565,27,สระแก้ว,2702,อำเภอคลองหาด,19547,19446,38993,19580,19493,39073,13997
2565,27,สระแก้ว,2703,อำเภอตาพระยา,27408,27044,54452,27569,27311,54880,16834
2565,27,สระแก้ว,2704,อำเภอวังน้ำเย็น,20277,20222,40499,20355,20280,40635,15363
2565,27,สระแก้ว,2705,อำเภอวัฒนานคร,38315,37897,76212,38450,38033,76483,27557
2565,27,สระแก้ว,2706,อำเภออรัญประเทศ,36720,37484,74204,37105,38222,75327,37787
2565,27,สระแก้ว,2707,อำเภอเขาฉกรรจ์,25552,25456,51008,25618,25500,51118,16749
2565,27,สระแก้ว,2708,อำเภอโคกสูง,13474,13616,27090,13568,13779,27347,8641
2565,27,สระแก้ว,2709,อำเภอวังสมบูรณ์,12736,12511,25247,12756,12557,25313,10654
2565,27,สระแก้ว,2791,ท้องถิ่นเทศบาลตำบลวังสมบูรณ์,5277,5350,10627,5288,5366,10654,5183
2565,27,สระแก้ว,2792,ท้องถิ่นเทศบาลตำบลเขาฉกรรจ์,2351,2393,4744,2398,2435,4833,2402
2565,27,สระแก้ว,2793,ท้องถิ่นเทศบาลตำบลวัฒนานคร,2586,3034,5620,2590,3042,5632,3090
2565,27,สระแก้ว,2794,ท้องถิ่นเทศบาลเมืองวังน้ำเย็น,9912,10469,20381,9980,10518,20498,10064
2565,27,สระแก้ว,2795,ท้องถิ่นเทศบาลตำบลตาพระยา,1221,1266,2487,1239,1277,2516,1178
2565,27,สระแก้ว,2796,ท้องถิ่นเทศบาลตำบลศาลาลำดวน,1270,1325,2595,1275,1331,2606,1222
2565,27,สระแก้ว,2797,ท้องถิ่นเทศบาลตำบลท่าเกษม,1694,1886,3580,1699,1890,3589,1679
2565,27,สระแก้ว,2798,ท้องถิ่นเทศบาลเมืองอรัญญประเทศ,8432,7100,15532,9118,7822,16940,11522
2565,27,สระแก้ว,2799,ท้องถิ่นเทศบาลเมืองสระแก้ว,8660,9439,18099,8799,9560,18359,11889
2565,30,นครราชสีมา,3001,อำเภอเมืองนครราชสีมา,113059,125172,238231,113423,125292,238715,117784
2565,30,นครราชสีมา,3002,อำเภอครบุรี,39632,40742,80374,39689,40757,80446,31194
2565,30,นครราชสีมา,3003,อำเภอเสิงสาง,28152,28604,56756,28237,28658,56895,17687
2565,30,นครราชสีมา,3004,อำเภอคง,36467,37574,74041,36511,37597,74108,21976
2565,30,นครราชสีมา,3005,อำเภอบ้านเหลื่อม,8512,8631,17143,8521,8635,17156,5254
2565,30,นครราชสีมา,3006,อำเภอจักราช,33532,33907,67439,33560,33920,67480,19683
2565,30,นครราชสีมา,3007,อำเภอโชคชัย,24285,25825,50110,24319,25834,50153,19801
2565,30,นครราชสีมา,3008,อำเภอด่านขุนทด,53989,55553,109542,54018,55571,109589,35596
2565,30,นครราชสีมา,3009,อำเภอโนนไทย,26599,27863,54462,26619,27872,54491,17262
2565,30,นครราชสีมา,3010,อำเภอโนนสูง,41411,43174,84585,41452,43186,84638,25848
2565,30,นครราชสีมา,3011,อำเภอขามสะแกแสง,16561,16707,33268,16589,16710,33299,10146
2565,30,นครราชสีมา,3012,อำเภอบัวใหญ่,33593,33668,67261,33621,33690,67311,19650
2565,30,นครราชสีมา,3013,อำเภอประทาย,35097,35740,70837,35122,35756,70878,20041
2565,30,นครราชสีมา,3014,อำเภอปักธงชัย,44970,47331,92301,45006,47344,92350,33192
2565,30,นครราชสีมา,3015,อำเภอพิมาย,58650,60826,119476,58744,60862,119606,40170
2565,30,นครราชสีมา,3016,อำเภอห้วยแถลง,35165,35010,70175,35179,35024,70203,20093
2565,30,นครราชสีมา,3017,อำเภอชุมพวง,36601,37012,73613,36631,37029,73660,20706
2565,30,นครราชสีมา,3018,อำเภอสูงเนิน,35509,37242,72751,35542,37260,72802,30534
2565,30,นครราชสีมา,3019,อำเภอขามทะเลสอ,12693,13270,25963,12705,13274,25979,8806
2565,30,นครราชสีมา,3020,อำเภอสีคิ้ว,42943,43722,86665,42979,43754,86733,33134
2565,30,นครราชสีมา,3021,อำเภอปากช่อง,61920,63310,125230,62205,63530,125735,70617
2565,30,นครราชสีมา,3022,อำเภอหนองบุญมาก,29932,30618,60550,29979,30632,60611,19031
2565,30,นครราชสีมา,3023,อำเภอแก้งสนามนาง,18042,18432,36474,18049,18438,36487,10959
2565,30,นครราชสีมา,3024,อำเภอโนนแดง,10188,10557,20745,10193,10564,20757,5814
2565,30,นครราชสีมา,3025,อำเภอวังน้ำเขียว,21687,21993,43680,21737,22030,43767,20043
2565,30,นครราชสีมา,3026,อำเภอเทพารักษ์,12734,12602,25336,12743,12608,25351,8786
2565,30,นครราชสีมา,3027,อำเภอเมืองยาง,9853,9721,19574,9858,9728,19586,5645
2565,30,นครราชสีมา,3028,อำเภอพระทองคำ,18155,18406,36561,18176,18414,36590,12445
2565,30,นครราชสีมา,3029,อำเภอลำทะเมนชัย,13862,14035,27897,13873,14041,27914,7728
2565,30,นครราชสีมา,3030,อำเภอบัวลาย,10632,10780,21412,10645,10787,21432,6562
2565,30,นครราชสีมา,3031,อำเภอสีดา,9942,10049,19991,9951,10053,20004,6149
2565,30,นครราชสีมา,3032,อำเภอเฉลิมพระเกียรติ,15136,15864,31000,15148,15870,31018,9655
2565,30,นครราชสีมา,3037,ท้องถิ่นเทศบาลตำบลเมืองยาง,4011,4075,8086,4013,4078,8091,2383
2565,30,นครราชสีมา,3038,ท้องถิ่นเทศบาลตำบลหนองน้ำใส,6642,6624,13266,6648,6628,13276,5193
2565,30,นครราชสีมา,3039,ท้องถิ่นเทศบาลตำบลด่านคล้า,4172,4366,8538,4177,4366,8543,2655
2565,30,นครราชสีมา,3040,ท้องถิ่นเทศบาลตำบลใหม่,6347,6460,12807,6360,6466,12826,3616
2565,30,นครราชสีมา,3041,ท้องถิ่นเทศบาลตำบลหนองบัวตะเกียด,4281,4511,8792,4282,4513,8795,2756
2565,30,นครราชสีมา,3042,ท้องถิ่นเทศบาลตำบลบัลลังก์,3867,3898,7765,3872,3900,7772,2509
2565,30,นครราชสีมา,3043,ท้องถิ่นเทศบาลตำบลหนองไข่น้ำ,3092,3066,6158,3096,3066,6162,1899
2565,30,นครราชสีมา,3044,ท้องถิ่นเทศบาลตำบลท่าเยี่ยม,5601,5752,11353,5606,5752,11358,5619
2565,30,นครราชสีมา,3045,ท้องถิ่นเทศบาลตำบลสีมามงคล,4505,4553,9058,4517,4557,9074,4430
2565,30,นครราชสีมา,3046,ท้องถิ่นเทศบาลตำบลลำนางแก้ว,2341,2384,4725,2342,2386,4728,1426
2565,30,นครราชสีมา,3047,ท้องถิ่นเทศบาลตำบลดอนหวาย,1743,1906,3649,1744,1907,3651,1332
2565,30,นครราชสีมา,3048,ท้องถิ่นเทศบาลตำบลหมูสี,6553,6713,13266,6598,6739,13337,11710
2565,30,นครราชสีมา,3049,ท้องถิ่นเทศบาลตำบลโพธิ์กลาง,15486,14159,29645,15507,14170,29677,13740
2565,30,นครราชสีมา,3050,ท้องถิ่นเทศบาลตำบลหัวทะเล,13144,14484,27628,13178,14507,27685,14141
2565,30,นครราชสีมา,3051,ท้องถิ่นเทศบาลตำบลวังไทร,5608,5831,11439,5623,5836,11459,5637
2565,30,นครราชสีมา,3052,ท้องถิ่นเทศบาลตำบลปรุใหญ่,4685,5140,9825,4696,5141,9837,5243
2565,30,นครราชสีมา,3053,ท้องถิ่นเทศบาลตำบลหนองไผ่ล้อม,10520,4293,14813,10523,4298,14821,11300
2565,30,นครราชสีมา,3054,ท้องถิ่นเทศบาลตำบลท่าช้าง,2430,2581,5011,2433,2581,5014,2147
2565,30,นครราชสีมา,3055,ท้องถิ่นเทศบาลตำบลสีดา,1769,1835,3604,1771,1842,3613,1493
2565,30,นครราชสีมา,3056,ท้องถิ่นเทศบาลตำบลหนองบัวลาย,1183,1220,2403,1186,1222,2408,880
2565,30,นครราชสีมา,3057,ท้องถิ่นเทศบาลตำบลหนองบัววง,2266,2341,4607,2268,2342,4610,1872
2565,30,นครราชสีมา,3058,ท้องถิ่นเทศบาลตำบลพระทองคำ,1947,2070,4017,1952,2072,4024,1672
2565,30,นครราชสีมา,3059,ท้องถิ่นเทศบาลตำบลศาลเจ้าพ่อ,886,1012,1898,888,1014,1902,966
2565,30,นครราชสีมา,3060,ท้องถิ่นเทศบาลตำบลโนนแดง,2074,2181,4255,2077,2185,4262,1613
2565,30,นครราชสีมา,3061,ท้องถิ่นเทศบาลตำบลกลางดง,2468,2538,5006,2474,2544,5018,2753
2565,30,นครราชสีมา,3062,ท้องถิ่นเทศบาลเมืองสีคิ้ว,7690,8601,16291,7710,8627,16337,9607
2565,30,นครราชสีมา,3063,ท้องถิ่นเทศบาลตำบลลาดบัวขาว,1949,2136,4085,1950,2137,4087,2257
2565,30,นครราชสีมา,3064,ท้องถิ่นเทศบาลตำบลคลองไผ่,1945,1650,3595,1956,1660,3616,1762
2565,30,นครราชสีมา,3065,ท้องถิ่นเทศบาลตำบลขามทะเลสอ,2095,2211,4306,2102,2217,4319,2287
2565,30,นครราชสีมา,3066,ท้องถิ่นเทศบาลตำบลสูงเนิน,4498,5096,9594,4574,5170,9744,6365
2565,30,นครราชสีมา,3067,ท้องถิ่นเทศบาลตำบลกุดจิก,1252,1435,2687,1253,1435,2688,1435
2565,30,นครราชสีมา,3068,ท้องถิ่นเทศบาลตำบลชุมพวง,4246,4497,8743,4249,4499,8748,3870
2565,30,นครราชสีมา,3069,ท้องถิ่นเทศบาลตำบลหินดาด,1368,1376,2744,1371,1377,2748,799
2565,30,นครราชสีมา,3070,ท้องถิ่นเทศบาลตำบลห้วยแถลง,1470,1642,3112,1472,1645,3117,1671
2565,30,นครราชสีมา,3071,ท้องถิ่นเทศบาลตำบลพิมาย,3524,4120,7644,3531,4121,7652,2911
2565,30,นครราชสีมา,3072,ท้องถิ่นเทศบาลเมืองเมืองปัก,6280,7136,13416,6297,7158,13455,7102
2565,30,นครราชสีมา,3073,ท้องถิ่นเทศบาลตำบลตะขบ,2554,2671,5225,2554,2673,5227,1943
2565,30,นครราชสีมา,3074,ท้องถิ่นเทศบาลตำบลประทาย,2908,3098,6006,2912,3099,6011,3138
2565,30,นครราชสีมา,3075,ท้องถิ่นเทศบาลตำบลหนองหัวฟาน,2248,2252,4500,2252,2255,4507,1447
2565,30,นครราชสีมา,3076,ท้องถิ่นเทศบาลตำบลขามสะแกแสง,2406,2650,5056,2410,2650,5060,1956
2565,30,นครราชสีมา,3077,ท้องถิ่นเทศบาลตำบลมะค่า,942,962,1904,942,962,1904,603
2565,30,นครราชสีมา,3078,ท้องถิ่นเทศบาลตำบลตลาดแค,1552,1713,3265,1555,1716,3271,1345
2565,30,นครราชสีมา,3079,ท้องถิ่นเทศบาลตำบลโนนไทย,1409,1623,3032,1416,1626,3042,1397
2565,30,นครราชสีมา,3080,ท้องถิ่นเทศบาลตำบลโคกสวาย,2526,2658,5184,2527,2658,5185,1816
2565,30,นครราชสีมา,3081,ท้องถิ่นเทศบาลตำบลหนองกราด,1949,2111,4060,1954,2112,4066,1371
2565,30,นครราชสีมา,3082,ท้องถิ่นเทศบาลตำบลด่านขุนทด,2825,3221,6046,2833,3227,6060,4017
2565,30,นครราชสีมา,3083,ท้องถิ่นเทศบาลตำบลด่านเกวียน,4783,5050,9833,4784,5051,9835,4494
2565,30,นครราชสีมา,3084,ท้องถิ่นเทศบาลตำบลโชคชัย,5778,6442,12220,5950,6623,12573,5610
2565,30,นครราชสีมา,3085,ท้องถิ่นเทศบาลตำบลจักราช,1896,2117,4013,1901,2120,4021,1653
2565,30,นครราชสีมา,3086,ท้องถิ่นเทศบาลตำบลบ้านเหลื่อม,1583,1808,3391,1584,1808,3392,1238
2565,30,นครราชสีมา,3087,ท้องถิ่นเทศบาลตำบลเมืองคง,1020,1132,2152,1027,1133,2160,995
2565,30,นครราชสีมา,3088,ท้องถิ่นเทศบาลตำบลเทพาลัย,1317,1406,2723,1320,1408,2728,875
2565,30,นครราชสีมา,3089,ท้องถิ่นเทศบาลตำบลเสิงสาง,3633,3890,7523,3644,3900,7544,3250
2565,30,นครราชสีมา,3090,ท้องถิ่นเทศบาลตำบลโนนสมบูรณ์,2845,2909,5754,2855,2912,5767,1850
2565,30,นครราชสีมา,3091,ท้องถิ่นเทศบาลตำบลไทรโยง-ไชยวาล,1794,1855,3649,1800,1856,3656,1175
2565,30,นครราชสีมา,3092,ท้องถิ่นเทศบาลตำบลแชะ,2716,3104,5820,2727,3106,5833,3052
2565,30,นครราชสีมา,3093,ท้องถิ่นเทศบาลตำบลจระเข้หิน,2879,3202,6081,2882,3203,6085,2456
2565,30,นครราชสีมา,3094,ท้องถิ่นเทศบาลตำบลจอหอ,8521,8587,17108,8545,8601,17146,10047
2565,30,นครราชสีมา,3095,ท้องถิ่นเทศบาลตำบลโคกกรวด,3241,3745,6986,3275,3771,7046,4735
2565,30,นครราชสีมา,3096,ท้องถิ่นเทศบาลตำบลโนนสูง,4560,4923,9483,4569,4926,9495,4052
2565,30,นครราชสีมา,3097,ท้องถิ่นเทศบาลเมืองบัวใหญ่,6367,6979,13346,6391,6987,13378,7226
2565,30,นครราชสีมา,3098,ท้องถิ่นเทศบาลเมืองปากช่อง,15151,17119,32270,15429,17378,32807,19001
2565,30,นครราชสีมา,3099,ท้องถิ่นเทศบาลนครนครราชสีมา,54437,62798,117235,54895,63166,118061,72740
2565,31,บุรีรัมย์,3101,อำเภอเมืองบุรีรัมย์,86735,87715,174450,86947,87790,174737,54466
2565,31,บุรีรัมย์,3102,อำเภอคูเมือง,29537,29550,59087,29596,29577,59173,16599
2565,31,บุรีรัมย์,3103,อำเภอกระสัง,49963,51251,101214,50065,51294,101359,26905
2565,31,บุรีรัมย์,3104,อำเภอนางรอง,45757,47286,93043,45801,47313,93114,27045
2565,31,บุรีรัมย์,3105,อำเภอหนองกี่,28821,28497,57318,28853,28508,57361,15771
2565,31,บุรีรัมย์,3106,อำเภอละหานทราย,9704,9744,19448,9734,9752,19486,5924
2565,31,บุรีรัมย์,3107,อำเภอประโคนชัย,62158,62892,125050,62281,62955,125236,37410
2565,31,บุรีรัมย์,3108,อำเภอบ้านกรวด,20266,20558,40824,20365,20586,40951,11611
2565,31,บุรีรัมย์,3109,อำเภอพุทไธสง,20225,21248,41473,20239,21256,41495,12509
2565,31,บุรีรัมย์,3110,อำเภอลำปลายมาศ,56926,57234,114160,56995,57258,114253,31746
2565,31,บุรีรัมย์,3111,อำเภอสตึก,49158,49423,98581,49208,49437,98645,27762
2565,31,บุรีรัมย์,3112,อำเภอปะคำ,19174,19141,38315,19199,19149,38348,12012
2565,31,บุรีรัมย์,3113,อำเภอนาโพธิ์,13990,14367,28357,14005,14377,28382,8122
2565,31,บุรีรัมย์,3114,อำเภอหนองหงส์,17824,17607,35431,17832,17612,35444,9550
2565,31,บุรีรัมย์,3115,อำเภอพลับพลาชัย,14061,13682,27743,14106,13688,27794,7324
2565,31,บุรีรัมย์,3116,อำเภอห้วยราช,16101,16347,32448,16130,16351,32481,8466
2565,31,บุรีรัมย์,3117,อำเภอโนนสุวรรณ,10867,10949,21816,10874,10951,21825,6521
2565,31,บุรีรัมย์,3118,อำเภอชำนิ,17580,17700,35280,17609,17710,35319,9344
2565,31,บุรีรัมย์,3119,อำเภอบ้านใหม่ไชยพจน์,10801,11130,21931,10813,11138,21951,6197
2565,31,บุรีรัมย์,3120,อำเภอโนนดินแดง,9364,9299,18663,9394,9315,18709,5850
2565,31,บุรีรัมย์,3121,อำเภอบ้านด่าน,9228,9533,18761,9244,9537,18781,4699
2565,31,บุรีรัมย์,3122,อำเภอแคนดง,13307,13494,26801,13330,13502,26832,7488
2565,31,บุรีรัมย์,3123,อำเภอเฉลิมพระเกียรติ,5997,6086,12083,6006,6094,12100,3610
2565,31,บุรีรัมย์,3162,ท้องถิ่นเทศบาลตำบลจันดุม,5196,5306,10502,5208,5312,10520,3004
2565,31,บุรีรัมย์,3163,ท้องถิ่นเทศบาลตำบลห้วยหิน,4825,4877,9702,4827,4877,9704,2697
2565,31,บุรีรัมย์,3164,ท้องถิ่นเทศบาลตำบลสำโรงใหม่,6350,6290,12640,6363,6295,12658,3823
2565,31,บุรีรัมย์,3165,ท้องถิ่นเทศบาลตำบลจันทบเพชร,3873,3929,7802,3898,3935,7833,2442
2565,31,บุรีรัมย์,3166,ท้องถิ่นเทศบาลตำบลหนองแวง,8459,8342,16801,8467,8347,16814,4299
2565,31,บุรีรัมย์,3167,ท้องถิ่นเทศบาลตำบลหนองไม้งาม,5062,5028,10090,5080,5028,10108,2948
2565,31,บุรีรัมย์,3168,ท้องถิ่นเทศบาลตำบลบ้านกรวดปัญญาวัฒน์,4654,4661,9315,4682,4663,9345,2761
2565,31,บุรีรัมย์,3169,ท้องถิ่นเทศบาลตำบลบ้านด่าน,5855,6092,11947,5878,6092,11970,3379
2565,31,บุรีรัมย์,3170,ท้องถิ่นเทศบาลตำบลถาวร,3757,3861,7618,3765,3863,7628,2241
2565,31,บุรีรัมย์,3171,ท้องถิ่นเทศบาลตำบลยายแย้มวัฒนา,4338,4279,8617,4347,4283,8630,2384
2565,31,บุรีรัมย์,3172,ท้องถิ่นเทศบาลตำบลอิสาณ,10297,11451,21748,10358,11461,21819,13165
2565,31,บุรีรัมย์,3174,ท้องถิ่นเทศบาลตำบลศาลเจ้าพ่อขุนศรี,1671,1716,3387,1672,1717,3389,1332
2565,31,บุรีรัมย์,3175,ท้องถิ่นเทศบาลตำบลตาจง,8389,8252,16641,8406,8263,16669,4413
2565,31,บุรีรัมย์,3176,ท้องถิ่นเทศบาลตำบลพนมรุ้ง,5675,6079,11754,5684,6081,11765,3964
2565,31,บุรีรัมย์,3177,ท้องถิ่นเทศบาลตำบลแคนดง,2699,2762,5461,2705,2763,5468,1950
2565,31,บุรีรัมย์,3178,ท้องถิ่นเทศบาลตำบลโนนดินแดง,4593,4756,9349,4624,4764,9388,3660
2565,31,บุรีรัมย์,3179,ท้องถิ่นเทศบาลตำบลบ้านใหม่ไชยพจน์,2074,2193,4267,2086,2195,4281,1431
2565,31,บุรีรัมย์,3180,ท้องถิ่นเทศบาลตำบลโนนสุวรรณ,1592,1681,3273,1595,1682,3277,1077
2565,31,บุรีรัมย์,3181,ท้องถิ่นเทศบาลตำบลห้วยราช,2496,2557,5053,2502,2560,5062,1456
2565,31,บุรีรัมย์,3182,ท้องถิ่นเทศบาลตำบลพลับพลาชัย,3343,3287,6630,3351,3288,6639,1992
2565,31,บุรีรัมย์,3183,ท้องถิ่นเทศบาลตำบลหนองหงส์,2350,2374,4724,2353,2375,4728,1789
2565,31,บุรีรัมย์,3184,ท้องถิ่นเทศบาลตำบลนาโพธิ์,1729,1899,3628,1732,1900,3632,1682
2565,31,บุรีรัมย์,3185,ท้องถิ่นเทศบาลตำบลปะคำ,3498,3604,7102,3503,3606,7109,2855
2565,31,บุรีรัมย์,3186,ท้องถิ่นเทศบาลตำบลสตึก,5215,5648,10863,5242,5662,10904,5701
2565,31,บุรีรัมย์,3187,ท้องถิ่นเทศบาลเมืองลำปลายมาศ,6299,6900,13199,6310,6910,13220,6288
2565,31,บุรีรัมย์,3188,ท้องถิ่นเทศบาลตำบลทะเมนชัย,2128,2163,4291,2131,2164,4295,1269
2565,31,บุรีรัมย์,3189,ท้องถิ่นเทศบาลตำบลพุทไธสง,1972,2182,4154,1974,2184,4158,2280
2565,31,บุรีรัมย์,3190,ท้องถิ่นเทศบาลตำบลบ้านกรวด,1875,1972,3847,1895,1973,3868,2001
2565,31,บุรีรัมย์,3191,ท้องถิ่นเทศบาลตำบลตลาดนิคมปราสาท,2345,2467,4812,2363,2468,4831,1800
2565,31,บุรีรัมย์,3192,ท้องถิ่นเทศบาลเมืองประโคนชัย,4365,4911,9276,4374,4914,9288,4118
2565,31,บุรีรัมย์,3193,ท้องถิ่นเทศบาลตำบลละหานทราย,4133,4129,8262,4151,4135,8286,3523
2565,31,บุรีรัมย์,3194,ท้องถิ่นเทศบาลตำบลหนองกี่,4659,5016,9675,4665,5024,9689,4207
2565,31,บุรีรัมย์,3195,ท้องถิ่นเทศบาลตำบลกระสัง,1556,1754,3310,1571,1764,3335,1833
2565,31,บุรีรัมย์,3196,ท้องถิ่นเทศบาลตำบลหินเหล็กไฟ,2425,2533,4958,2429,2534,4963,1860
2565,31,บุรีรัมย์,3197,ท้องถิ่นเทศบาลตำบลคูเมือง,1794,1793,3587,1799,1797,3596,2036
2565,31,บุรีรัมย์,3198,ท้องถิ่นเทศบาลเมืองนางรอง,9540,10819,20359,9564,10836,20400,11523
2565,31,บุรีรัมย์,3199,ท้องถิ่นเทศบาลนครบุรีรัมย์,11299,12484,23783,11350,12520,23870,14530
2565,32,สุรินทร์,3201,อำเภอเมืองสุรินทร์,107077,109909,216986,107369,109984,217353,78271
2565,32,สุรินทร์,3202,อำเภอชุมพลบุรี,34269,34125,68394,34287,34140,68427,19183
2565,32,สุรินทร์,3203,อำเภอท่าตูม,45660,45496,91156,45692,45537,91229,24015
2565,32,สุรินทร์,3204,อำเภอจอมพระ,27219,27145,54364,27228,27156,54384,14202
2565,32,สุรินทร์,3205,อำเภอปราสาท,71102,72856,143958,71259,72900,144159,43086
2565,32,สุรินทร์,3206,อำเภอกาบเชิง,30075,29893,59968,30115,29912,60027,18986
2565,32,สุรินทร์,3207,อำเภอรัตนบุรี,43232,43484,86716,43262,43505,86767,23455
2565,32,สุรินทร์,3208,อำเภอสนม,19265,19085,38350,19279,19091,38370,10969
2565,32,สุรินทร์,3209,อำเภอศีขรภูมิ,64385,65345,129730,64422,65371,129793,33169
2565,32,สุรินทร์,3210,อำเภอสังขะ,63734,63311,127045,63806,63325,127131,35456
2565,32,สุรินทร์,3211,อำเภอลำดวน,13372,13349,26721,13384,13355,26739,7218
2565,32,สุรินทร์,3212,อำเภอสำโรงทาบ,25209,25032,50241,25215,25036,50251,12052
2565,32,สุรินทร์,3213,อำเภอบัวเชด,17813,17173,34986,17839,17181,35020,10034
2565,32,สุรินทร์,3214,อำเภอพนมดงรัก,19038,18709,37747,19097,18731,37828,12552
2565,32,สุรินทร์,3215,อำเภอศรีณรงค์,23533,23170,46703,23545,23175,46720,11847
2565,32,สุรินทร์,3216,อำเภอเขวาสินรินทร์,16848,17258,34106,16874,17271,34145,10254
2565,32,สุรินทร์,3217,อำเภอโนนนารายณ์,17329,17487,34816,17332,17489,34821,8844
2565,32,สุรินทร์,3286,ท้องถิ่นเทศบาลตำบลบัวเชด,3170,3295,6465,3172,3296,6468,2455
2565,32,สุรินทร์,3287,ท้องถิ่นเทศบาลตำบลสำโรงทาบ,1121,1147,2268,1125,1148,2273,1277
2565,32,สุรินทร์,3288,ท้องถิ่นเทศบาลตำบลลำดวนสุรพินท์,2051,2253,4304,2057,2256,4313,1893
2565,32,สุรินทร์,3289,ท้องถิ่นเทศบาลตำบลสังขะ,1651,1930,3581,1653,1934,3587,2377
2565,32,สุรินทร์,3290,ท้องถิ่นเทศบาลตำบลศีขรภูมิ,2230,2407,4637,2234,2412,4646,2859
2565,32,สุรินทร์,3291,ท้องถิ่นเทศบาลตำบลสนม,2408,2545,4953,2414,2547,4961,1637
2565,32,สุรินทร์,3292,ท้องถิ่นเทศบาลตำบลรัตนบุรี,2519,2734,5253,2522,2737,5259,2734
2565,32,สุรินทร์,3293,ท้องถิ่นเทศบาลตำบลนิคมปราสาท,1309,1327,2636,1311,1328,2639,872
2565,32,สุรินทร์,3294,ท้องถิ่นเทศบาลตำบลกังแอน,2587,2981,5568,2610,2990,5600,3447
2565,32,สุรินทร์,3295,ท้องถิ่นเทศบาลตำบลจอมพระ,1935,2144,4079,1941,2145,4086,1968
2565,32,สุรินทร์,3296,ท้องถิ่นเทศบาลตำบลท่าตูม,1913,2049,3962,1917,2052,3969,1828
2565,32,สุรินทร์,3297,ท้องถิ่นเทศบาลตำบลชุมพลบุรี,1083,1197,2280,1085,1200,2285,1114
2565,32,สุรินทร์,3298,ท้องถิ่นเทศบาลตำบลเมืองที,954,931,1885,955,932,1887,574
2565,32,สุรินทร์,3299,ท้องถิ่นเทศบาลเมืองสุรินทร์,17201,20272,37473,17370,20403,37773,17359
2565,33,ศรีสะเกษ,3301,อำเภอเมืองศรีสะเกษ,42877,44445,87322,42900,44471,87371,27732
2565,33,ศรีสะเกษ,3302,อำเภอยางชุมน้อย,14827,14706,29533,14830,14710,29540,7726
2565,33,ศรีสะเกษ,3303,อำเภอกันทรารมย์,46430,46812,93242,46447,46824,93271,24903
2565,33,ศรีสะเกษ,3304,อำเภอกันทรลักษ์,91940,91669,183609,92122,91818,183940,52288
2565,33,ศรีสะเกษ,3305,อำเภอขุขันธ์,72054,72953,145007,72155,73035,145190,36060
2565,33,ศรีสะเกษ,3306,อำเภอไพรบึง,18045,18329,36374,18049,18330,36379,9266
2565,33,ศรีสะเกษ,3307,อำเภอปรางค์กู่,31431,31816,63247,31453,31831,63284,15450
2565,33,ศรีสะเกษ,3308,อำเภอขุนหาญ,34202,34641,68843,34266,34676,68942,18503
2565,33,ศรีสะเกษ,3309,อำเภอราษีไศล,37650,37962,75612,37671,37973,75644,20556
2565,33,ศรีสะเกษ,3310,อำเภออุทุมพรพิสัย,50597,51285,101882,50636,51311,101947,26917
2565,33,ศรีสะเกษ,3311,อำเภอบึงบูรพ์,2173,2185,4358,2174,2185,4359,1125
2565,33,ศรีสะเกษ,3312,อำเภอห้วยทับทัน,19456,19403,38859,19475,19413,38888,9163
2565,33,ศรีสะเกษ,3313,อำเภอโนนคูณ,19785,19603,39388,19797,19611,39408,11487
2565,33,ศรีสะเกษ,3314,อำเภอศรีรัตนะ,24098,24316,48414,24115,24322,48437,11709
2565,33,ศรีสะเกษ,3315,อำเภอน้ำเกลี้ยง,22450,21977,44427,22468,21986,44454,11491
2565,33,ศรีสะเกษ,3316,อำเภอวังหิน,20226,19990,40216,20245,20009,40254,9719
2565,33,ศรีสะเกษ,3317,อำเภอภูสิงห์,27602,27231,54833,27618,27247,54865,16256
2565,33,ศรีสะเกษ,3318,อำเภอเมืองจันทร์,9010,8783,17793,9016,8789,17805,4504
2565,33,ศรีสะเกษ,3319,อำเภอเบญจลักษ์,18138,17850,35988,18144,17852,35996,9461
2565,33,ศรีสะเกษ,3320,อำเภอพยุห์,15345,15674,31019,15354,15677,31031,8400
2565,33,ศรีสะเกษ,3321,อำเภอโพธิ์ศรีสุวรรณ,11834,11792,23626,11837,11799,23636,5780
2565,33,ศรีสะเกษ,3322,อำเภอศิลาลาด,9904,9805,19709,9907,9809,19716,5476
2565,33,ศรีสะเกษ,3381,ท้องถิ่นเทศบาลตำบลบุสูง,5184,5074,10258,5194,5078,10272,2830
2565,33,ศรีสะเกษ,3382,ท้องถิ่นเทศบาลตำบลกันทรอม,4585,4425,9010,4587,4426,9013,2296
2565,33,ศรีสะเกษ,3383,ท้องถิ่นเทศบาลตำบลกระหวัน,4329,4484,8813,4333,4487,8820,2230
2565,33,ศรีสะเกษ,3384,ท้องถิ่นเทศบาลตำบลน้ำคำ,5162,5353,10515,5164,5355,10519,3105
2565,33,ศรีสะเกษ,3385,ท้องถิ่นเทศบาลตำบลโพธิ์กระสังข์,4588,4589,9177,4589,4592,9181,2095
2565,33,ศรีสะเกษ,3386,ท้องถิ่นเทศบาลตำบลพยุห์,1927,1970,3897,1928,1971,3899,1484
2565,33,ศรีสะเกษ,3387,ท้องถิ่นเทศบาลตำบลศรีรัตนะ,2292,2355,4647,2294,2355,4649,1476
2565,33,ศรีสะเกษ,3388,ท้องถิ่นเทศบาลตำบลห้วยทับทัน,1669,1637,3306,1669,1637,3306,1084
2565,33,ศรีสะเกษ,3389,ท้องถิ่นเทศบาลตำบลบึงบูรพ์,2964,3106,6070,2966,3107,6073,1866
2565,33,ศรีสะเกษ,3390,ท้องถิ่นเทศบาลตำบลกำแพง,1233,1354,2587,1237,1359,2596,1337
2565,33,ศรีสะเกษ,3391,ท้องถิ่นเทศบาลตำบลเมืองคง,1876,2008,3884,1880,2008,3888,2132
2565,33,ศรีสะเกษ,3392,ท้องถิ่นเทศบาลตำบลขุนหาญ,5272,5440,10712,5291,5442,10733,3835
2565,33,ศรีสะเกษ,3393,ท้องถิ่นเทศบาลตำบลปรางค์กู่,1344,1396,2740,1346,1397,2743,1313
2565,33,ศรีสะเกษ,3394,ท้องถิ่นเทศบาลตำบลไพรบึง,5417,5403,10820,5420,5404,10824,2963
2565,33,ศรีสะเกษ,3395,ท้องถิ่นเทศบาลตำบลเมืองขุขันธ์,2033,2144,4177,2037,2145,4182,2192
2565,33,ศรีสะเกษ,3396,ท้องถิ่นเทศบาลเมืองกันทรลักษ์,8423,9135,17558,8463,9156,17619,7685
2565,33,ศรีสะเกษ,3397,ท้องถิ่นเทศบาลตำบลกันทรารมย์,2894,3104,5998,2902,3106,6008,3262
2565,33,ศรีสะเกษ,3398,ท้องถิ่นเทศบาลตำบลยางชุมน้อย,3082,3205,6287,3084,3209,6293,2462
2565,33,ศรีสะเกษ,3399,ท้องถิ่นเทศบาลเมืองศรีสะเกษ,18603,21000,39603,18692,21063,39755,21196
2565,34,อุบลราชธานี,3401,อำเภอเมืองอุบลราชธานี,47818,49394,97212,47942,49452,97394,37010
2565,34,อุบลราชธานี,3402,อำเภอศรีเมืองใหม่,33552,33021,66573,33689,33238,66927,19767
2565,34,อุบลราชธานี,3403,อำเภอโขงเจียม,17821,17193,35014,18175,17884,36059,10481
2565,34,อุบลราชธานี,3404,อำเภอเขื่องใน,50564,51626,102190,50596,51650,102246,28596
2565,34,อุบลราชธานี,3405,อำเภอเขมราฐ,15713,15552,31265,15893,15970,31863,9289
2565,34,อุบลราชธานี,3407,อำเภอเดชอุดม,66462,65623,132085,66505,65646,132151,53658
2565,34,อุบลราชธานี,3408,อำเภอนาจะหลวย,26212,25545,51757,26248,25577,51825,18751
2565,34,อุบลราชธานี,3409,อำเภอน้ำยืน,31029,30262,61291,31064,30304,61368,21108
2565,34,อุบลราชธานี,3410,อำเภอบุณฑริก,39274,38122,77396,39574,38512,78086,24787
2565,34,อุบลราชธานี,3411,อำเภอตระการพืชผล,56409,55965,112374,56470,56040,112510,30393
2565,34,อุบลราชธานี,3412,อำเภอกุดข้าวปุ้น,18361,18386,36747,18373,18403,36776,9730
2565,34,อุบลราชธานี,3414,อำเภอม่วงสามสิบ,40684,40678,81362,40716,40710,81426,23440
2565,34,อุบลราชธานี,3415,อำเภอวารินชำราบ,46036,46778,92814,46124,46838,92962,31639
2565,34,อุบลราชธานี,3419,อำเภอพิบูลมังสาหาร,52480,51750,104230,52579,51890,104469,35020
2565,34,อุบลราชธานี,3420,อำเภอตาลสุม,15175,14749,29924,15189,14762,29951,8649
2565,34,อุบลราชธานี,3421,อำเภอโพธิ์ไทร,22511,21669,44180,22751,22077,44828,12269
2565,34,อุบลราชธานี,3422,อำเภอสำโรง,27099,27012,54111,27109,27016,54125,15184
2565,34,อุบลราชธานี,3424,อำเภอดอนมดแดง,13683,13487,27170,13697,13504,27201,8146
2565,34,อุบลราชธานี,3425,อำเภอสิรินธร,22136,21183,43319,22359,21620,43979,14932
2565,34,อุบลราชธานี,3426,อำเภอทุ่งศรีอุดม,14760,14432,29192,14767,14440,29207,9352
2565,34,อุบลราชธานี,3429,อำเภอนาเยีย,10838,10171,21009,10847,10175,21022,7349
2565,34,อุบลราชธานี,3430,อำเภอนาตาล,19049,18842,37891,19298,19267,38565,11628
2565,34,อุบลราชธานี,3431,อำเภอเหล่าเสือโก้ก,14031,13966,27997,14046,13970,28016,8129
2565,34,อุบลราชธานี,3432,อำเภอสว่างวีระวงศ์,15660,15576,31236,15678,15593,31271,9473
2565,34,อุบลราชธานี,3433,อำเภอน้ำขุ่น,16821,16554,33375,16839,16559,33398,11181
2565,34,อุบลราชธานี,3463,ท้องถิ่นเทศบาลตำบลกุดชมภู,5889,5844,11733,5914,5881,11795,4498
2565,34,อุบลราชธานี,3464,ท้องถิ่นเทศบาลตำบลคำน้ำแซบ,4024,4136,8160,4043,4141,8184,3310
2565,34,อุบลราชธานี,3465,ท้องถิ่นเทศบาลตำบลหัวนา,6565,6631,13196,6587,6652,13239,3659
2565,34,อุบลราชธานี,3466,ท้องถิ่นเทศบาลตำบลโพนงาม,4510,4571,9081,4514,4571,9085,3306
2565,34,อุบลราชธานี,3467,ท้องถิ่นเทศบาลตำบลเมืองศรีไค,3146,3414,6560,3151,3415,6566,3470
2565,34,อุบลราชธานี,3468,ท้องถิ่นเทศบาลตำบลหนองผือ,4862,5037,9899,4868,5047,9915,3471
2565,34,อุบลราชธานี,3469,ท้องถิ่นเทศบาลตำบลขามป้อม,4757,4670,9427,4791,4741,9532,3267
2565,34,อุบลราชธานี,3470,ท้องถิ่นเทศบาลเมืองเทพวงศา,5884,5710,11594,6110,6185,12295,4222
2565,34,อุบลราชธานี,3471,ท้องถิ่นเทศบาลตำบลปทุม,4963,5552,10515,4994,5567,10561,4252
2565,34,อุบลราชธานี,3472,ท้องถิ่นเทศบาลตำบลคอแลน,6640,6423,13063,6707,6546,13253,4147
2565,34,อุบลราชธานี,3473,ท้องถิ่น ทต.นิคมสร้างตนเองลำโดมน้อย,3879,3840,7719,3918,3905,7823,2997
2565,34,อุบลราชธานี,3474,ท้องถิ่นเทศบาลตำบลกุดประทาย,6912,6738,13650,6915,6746,13661,5236
2565,34,อุบลราชธานี,3475,ท้องถิ่นเทศบาลตำบลขามใหญ่,18969,21223,40192,19131,21264,40395,21728
2565,34,อุบลราชธานี,3476,ท้องถิ่นเทศบาลตำบลแสนสุข,13252,11210,24462,13310,11228,24538,11542
2565,34,อุบลราชธานี,3477,ท้องถิ่นเทศบาลตำบลนาเยีย,3191,3266,6457,3193,3268,6461,1887
2565,34,อุบลราชธานี,3478,ท้องถิ่นเทศบาลตำบลช่องเม็ก,1821,1804,3625,1847,1940,3787,1946
2565,34,อุบลราชธานี,3479,ท้องถิ่นเทศบาลตำบลโพธิ์ไทร,1484,1519,3003,1487,1521,3008,1200
2565,34,อุบลราชธานี,3480,ท้องถิ่นเทศบาลตำบลตาลสุม,1581,1614,3195,1581,1614,3195,1114
2565,34,อุบลราชธานี,3481,ท้องถิ่นเทศบาลตำบลอ่างศิลา,1464,1612,3076,1465,1614,3079,1032
2565,34,อุบลราชธานี,3482,ท้องถิ่นเทศบาลตำบลห้วยขะยุง,1530,1608,3138,1535,1608,3143,995
2565,34,อุบลราชธานี,3483,ท้องถิ่นเทศบาลตำบลม่วงสามสิบ,1426,1588,3014,1431,1590,3021,1611
2565,34,อุบลราชธานี,3484,ท้องถิ่นเทศบาลตำบลกุดข้าวปุ้น,2084,2062,4146,2086,2064,4150,1504
2565,34,อุบลราชธานี,3485,ท้องถิ่นเทศบาลตำบลตระการพืชผล,4388,4600,8988,4403,4613,9016,4429
2565,34,อุบลราชธานี,3486,ท้องถิ่นเทศบาลตำบลบุณฑริก,2147,2242,4389,2150,2247,4397,2128
2565,34,อุบลราชธานี,3487,ท้องถิ่นเทศบาลตำบลน้ำยืน,4394,4471,8865,4396,4476,8872,3448
2565,34,อุบลราชธานี,3488,ท้องถิ่นเทศบาลตำบลนาจะหลวย,3518,3565,7083,3530,3570,7100,2673
2565,34,อุบลราชธานี,3489,ท้องถิ่นเทศบาลเมืองเดชอุดม,6255,6854,13109,6268,6865,13133,6822
2565,34,อุบลราชธานี,3490,ท้องถิ่นเทศบาลตำบลบัวงาม,3299,3325,6624,3300,3326,6626,1913
2565,34,อุบลราชธานี,3491,ท้องถิ่นเทศบาลตำบลนาส่วง,1510,1595,3105,1510,1597,3107,1017
2565,34,อุบลราชธานี,3492,ท้องถิ่นเทศบาลตำบลเขมราฐ,2773,2951,5724,2811,3058,5869,2574
2565,34,อุบลราชธานี,3493,ท้องถิ่นเทศบาลตำบลเขื่องใน,2169,2319,4488,2170,2321,4491,2108
2565,34,อุบลราชธานี,3494,ท้องถิ่นเทศบาลตำบลบ้านด่านโขงเจียม,1351,1310,2661,1407,1448,2855,1338
2565,34,อุบลราชธานี,3495,ท้องถิ่นเทศบาลตำบลศรีเมืองใหม่,2059,2044,4103,2064,2052,4116,2026
2565,34,อุบลราชธานี,3496,ท้องถิ่นเทศบาลตำบลอุบล,2570,3031,5601,2596,3034,5630,3159
2565,34,อุบลราชธานี,3497,ท้องถิ่นเทศบาลเมืองพิบูลมังสาหาร,4893,5241,10134,4907,5258,10165,4627
2565,34,อุบลราชธานี,3498,ท้องถิ่นเทศบาลเมืองวารินชำราบ,11782,13406,25188,11820,13428,25248,10994
2565,34,อุบลราชธานี,3499,ท้องถิ่นเทศบาลนครอุบลราชธานี,32313,37849,70162,32682,38188,70870,32404
2565,35,ยโสธร,3501,อำเภอเมืองยโสธร,53435,53499,106934,53497,53526,107023,39660
2565,35,ยโสธร,3502,อำเภอทรายมูล,12184,12210,24394,12193,12216,24409,8196
2565,35,ยโสธร,3503,อำเภอกุดชุม,30767,30472,61239,30782,30486,61268,20444
2565,35,ยโสธร,3504,อำเภอคำเขื่อนแก้ว,30782,30765,61547,30806,30779,61585,19579
2565,35,ยโสธร,3505,อำเภอป่าติ้ว,15865,16000,31865,15879,16006,31885,10336
2565,35,ยโสธร,3506,อำเภอมหาชนะชัย,25543,25614,51157,25553,25629,51182,14889
2565,35,ยโสธร,3507,อำเภอค้อวัง,10254,10390,20644,10258,10396,20654,5634
2565,35,ยโสธร,3508,อำเภอเลิงนกทา,44527,44889,89416,44556,44917,89473,30384
2565,35,ยโสธร,3509,อำเภอไทยเจริญ,15163,15295,30458,15170,15305,30475,10990
2565,35,ยโสธร,3591,ท้องถิ่นเทศบาลตำบลสามแยก,1872,1970,3842,1878,1970,3848,2284
2565,35,ยโสธร,3592,ท้องถิ่นเทศบาลตำบลเลิงนกทา,1392,1472,2864,1394,1475,2869,1107
2565,35,ยโสธร,3593,ท้องถิ่นเทศบาลตำบลค้อวัง,2160,2282,4442,2161,2282,4443,1662
2565,35,ยโสธร,3594,ท้องถิ่นเทศบาลตำบลฟ้าหยาด,2272,2363,4635,2272,2365,4637,1876
2565,35,ยโสธร,3595,ท้องถิ่นเทศบาลตำบลป่าติ้ว,1481,1527,3008,1483,1527,3010,1280
2565,35,ยโสธร,3596,ท้องถิ่นเทศบาลตำบลคำเขื่อนแก้ว,1834,1912,3746,1836,1914,3750,1569
2565,35,ยโสธร,3597,ท้องถิ่นเทศบาลตำบลกุดชุมพัฒนา,2351,2447,4798,2355,2447,4802,2255
2565,35,ยโสธร,3598,ท้องถิ่นเทศบาลตำบลทรายมูล,3012,3205,6217,3013,3208,6221,2197
2565,35,ยโสธร,3599,ท้องถิ่นเทศบาลเมืองยโสธร,9651,10381,20032,9670,10395,20065,9276
2565,36,ชัยภูมิ,3601,อำเภอเมืองชัยภูมิ,66475,69852,136327,66594,69896,136490,56113
2565,36,ชัยภูมิ,3602,อำเภอบ้านเขว้า,20734,21249,41983,20743,21262,42005,14960
2565,36,ชัยภูมิ,3603,อำเภอคอนสวรรค์,23568,24106,47674,23594,24117,47711,18348
2565,36,ชัยภูมิ,3604,อำเภอเกษตรสมบูรณ์,42303,42785,85088,42353,42804,85157,25608
2565,36,ชัยภูมิ,3605,อำเภอหนองบัวแดง,46503,46433,92936,46605,46483,93088,30495
2565,36,ชัยภูมิ,3606,อำเภอจัตุรัส,32726,34842,67568,32761,34856,67617,25370
2565,36,ชัยภูมิ,3607,อำเภอบำเหน็จณรงค์,19987,20503,40490,20008,20515,40523,13869
2565,36,ชัยภูมิ,3608,อำเภอหนองบัวระเหว,16314,16253,32567,16333,16258,32591,11829
2565,36,ชัยภูมิ,3609,อำเภอเทพสถิต,32933,32405,65338,32991,32421,65412,24459
2565,36,ชัยภูมิ,3610,อำเภอภูเขียว,52986,54926,107912,53100,54958,108058,35933
2565,36,ชัยภูมิ,3611,อำเภอบ้านแท่น,20194,20567,40761,20214,20574,40788,11907
2565,36,ชัยภูมิ,3612,อำเภอแก้งคร้อ,36241,36422,72663,36267,36435,72702,25737
2565,36,ชัยภูมิ,3613,อำเภอคอนสาร,20125,20505,40630,20151,20515,40666,14253
2565,36,ชัยภูมิ,3614,อำเภอภักดีชุมพล,15473,15166,30639,15510,15193,30703,12464
2565,36,ชัยภูมิ,3615,อำเภอเนินสง่า,12761,13147,25908,12767,13154,25921,8676
2565,36,ชัยภูมิ,3616,อำเภอซับใหญ่,7925,7708,15633,7935,7713,15648,5874
2565,36,ชัยภูมิ,3653,สาขาตำบลวังชมภู หนองบัวแดง,0,0,0,0,0,0,0
2565,36,ชัยภูมิ,3676,ท้องถิ่นเทศบาลตำบลห้วยยาง,7691,7653,15344,7698,7660,15358,4676
2565,36,ชัยภูมิ,3677,ท้องถิ่นเทศบาลตำบลบ้านเดื่อ,7661,7793,15454,7665,7794,15459,4621
2565,36,ชัยภูมิ,3680,ท้องถิ่นเทศบาลตำบลคอนสาร,1956,2167,4123,1961,2168,4129,1474
2565,36,ชัยภูมิ,3681,ท้องถิ่นเทศบาลตำบลแก้งคร้อ,3895,4409,8304,3902,4413,8315,4693
2565,36,ชัยภูมิ,3682,ท้องถิ่นเทศบาลตำบลนาหนองทุ่ม,5163,5544,10707,5169,5544,10713,3349
2565,36,ชัยภูมิ,3683,ท้องถิ่นเทศบาลตำบลบ้านแท่น,1956,2038,3994,1959,2038,3997,1652
2565,36,ชัยภูมิ,3684,ท้องถิ่นเทศบาลตำบลภูเขียว,2799,3212,6011,2817,3217,6034,3065
2565,36,ชัยภูมิ,3685,ท้องถิ่นเทศบาลตำบลบ้านเพชรภูเขียว,2734,2799,5533,2739,2801,5540,1786
2565,36,ชัยภูมิ,3686,ท้องถิ่นเทศบาลตำบลเทพสถิต,1866,1917,3783,1871,1919,3790,2325
2565,36,ชัยภูมิ,3687,ท้องถิ่นเทศบาลตำบลหนองบัวระเหว,2867,2950,5817,2875,2953,5828,2692
2565,36,ชัยภูมิ,3688,ท้องถิ่นเทศบาลตำบลบำเหน็จณรงค์,3236,3538,6774,3242,3539,6781,3033
2565,36,ชัยภูมิ,3689,ท้องถิ่นเทศบาลตำบลบ้านเพชร,2317,2468,4785,2321,2472,4793,2250
2565,36,ชัยภูมิ,3690,ท้องถิ่นเทศบาลตำบลหนองบัวโคก,924,955,1879,926,955,1881,790
2565,36,ชัยภูมิ,3691,ท้องถิ่นเทศบาลตำบลจัตุรัส,1949,2164,4113,1953,2165,4118,2245
2565,36,ชัยภูมิ,3692,ท้องถิ่นเทศบาลตำบลหนองบัวแดง,4239,4441,8680,4252,4449,8701,4355
2565,36,ชัยภูมิ,3693,ท้องถิ่นเทศบาลตำบลบ้านเป้า,3714,3898,7612,3717,3899,7616,2395
2565,36,ชัยภูมิ,3694,ท้องถิ่นเทศบาลตำบลเกษตรสมบูรณ์,1378,1508,2886,1382,1512,2894,1337
2565,36,ชัยภูมิ,3695,ท้องถิ่นเทศบาลตำบลคอนสวรรค์,1924,2178,4102,1936,2179,4115,1913
2565,36,ชัยภูมิ,3696,ท้องถิ่นเทศบาลตำบลบ้านเขว้า,3746,4122,7868,3752,4123,7875,3460
2565,36,ชัยภูมิ,3697,ท้องถิ่นเทศบาลตำบลลาดใหญ่,2113,2387,4500,2116,2388,4504,1774
2565,36,ชัยภูมิ,3698,ท้องถิ่นเทศบาลตำบลบ้านค่ายหมื่นแผ้ว,2361,2477,4838,2368,2477,4845,1936
2565,36,ชัยภูมิ,3699,ท้องถิ่นเทศบาลเมืองชัยภูมิ,16794,18675,35469,16860,18699,35559,21391
2565,37,อำนาจเจริญ,3701,อำเภอเมืองอำนาจเจริญ,48628,48643,97271,48693,48687,97380,32178
2565,37,อำนาจเจริญ,3702,อำเภอชานุมาน,19322,19145,38467,19447,19359,38806,12066
2565,37,อำนาจเจริญ,3703,อำเภอปทุมราชวงศา,22948,22681,45629,22959,22686,45645,13909
2565,37,อำนาจเจริญ,3704,อำเภอพนา,9623,9476,19099,9625,9477,19102,6900
2565,37,อำนาจเจริญ,3705,อำเภอเสนางคนิคม,17325,17669,34994,17345,17685,35030,11141
2565,37,อำนาจเจริญ,3706,อำเภอหัวตะพาน,21051,20939,41990,21058,20964,42022,11237
2565,37,อำนาจเจริญ,3707,อำเภอลืออำนาจ,16892,17160,34052,16899,17169,34068,9998
2565,37,อำนาจเจริญ,3790,ท้องถิ่นเทศบาลตำบลนายม,2589,2663,5252,2592,2667,5259,1568
2565,37,อำนาจเจริญ,3791,ท้องถิ่นเทศบาลตำบลพระเหลา,2989,2981,5970,2992,2981,5973,2275
2565,37,อำนาจเจริญ,3792,ท้องถิ่นเทศบาลตำบลอำนาจ,987,1124,2111,987,1125,2112,1021
2565,37,อำนาจเจริญ,3793,ท้องถิ่นเทศบาลตำบลหัวตะพาน,3319,3477,6796,3322,3484,6806,2253
2565,37,อำนาจเจริญ,3794,ท้องถิ่นเทศบาลตำบลเสนางคนิคม,2693,2927,5620,2700,2933,5633,1986
2565,37,อำนาจเจริญ,3795,ท้องถิ่นเทศบาลตำบลพนา,1236,1421,2657,1238,1421,2659,1134
2565,37,อำนาจเจริญ,3796,ท้องถิ่นเทศบาลตำบลปทุมราชวงศา,1683,1739,3422,1683,1740,3423,1728
2565,37,อำนาจเจริญ,3797,ท้องถิ่นเทศบาลตำบลชานุมาน,1459,1563,3022,1499,1629,3128,1462
2565,37,อำนาจเจริญ,3798,ท้องถิ่นเทศบาลตำบลน้ำปลีก,1776,1924,3700,1783,1925,3708,1257
2565,37,อำนาจเจริญ,3799,ท้องถิ่นเทศบาลเมืองอำนาจเจริญ,11732,12833,24565,11772,12856,24628,13005
2565,38,บึงกาฬ,3801,อำเภอเมืองบึงกาฬ,29309,29160,58469,29397,29252,58649,19212
2565,38,บึงกาฬ,3802,อำเภอพรเจริญ,14519,14368,28887,14530,14368,28898,8402
2565,38,บึงกาฬ,3803,อำเภอโซ่พิสัย,32682,32288,64970,32709,32308,65017,19573
2565,38,บึงกาฬ,3804,อำเภอเซกา,36923,36443,73366,37001,36483,73484,23893
2565,38,บึงกาฬ,3805,อำเภอปากคาด,14087,14064,28151,14118,14088,28206,9884
2565,38,บึงกาฬ,3806,อำเภอบึงโขงหลง,14041,13903,27944,14088,13932,28020,9220
2565,38,บึงกาฬ,3807,อำเภอศรีวิไล,14381,14231,28612,14386,14238,28624,9684
2565,38,บึงกาฬ,3808,อำเภอบุ่งคล้า,6990,6959,13949,7015,7030,14045,4340
2565,38,บึงกาฬ,3887,ท้องถิ่นเทศบาลตำบลหอคำ,3627,3629,7256,3633,3632,7265,2399
2565,38,บึงกาฬ,3888,ท้องถิ่นเทศบาลตำบลโนนสว่าง,3410,3481,6891,3413,3483,6896,2445
2565,38,บึงกาฬ,3889,ท้องถิ่นเทศบาลตำบลวิศิษฐ์,0,0,0,0,0,0,0
2565,38,บึงกาฬ,3890,ท้องถิ่นเทศบาลตำบลศรีวิไล,5460,5497,10957,5467,5499,10966,4009
2565,38,บึงกาฬ,3891,ท้องถิ่นเทศบาลตำบลบึงโขงหลง,4791,4916,9707,4816,4919,9735,3561
2565,38,บึงกาฬ,3892,ท้องถิ่นเทศบาลตำบลปากคาด,3269,3275,6544,3276,3279,6555,2762
2565,38,บึงกาฬ,3893,ท้องถิ่นเทศบาลตำบลศรีพนา,3255,3300,6555,3269,3301,6570,2751
2565,38,บึงกาฬ,3894,ท้องถิ่นเทศบาลตำบลท่าสะอาด,3346,3465,6811,3349,3472,6821,2027
2565,38,บึงกาฬ,3895,ท้องถิ่นเทศบาลตำบลโซ่พิสัย,3279,3269,6548,3289,3273,6562,2638
2565,38,บึงกาฬ,3896,ท้องถิ่นเทศบาลตำบลพรเจริญ,4994,5231,10225,5002,5242,10244,3614
2565,38,บึงกาฬ,3897,ท้องถิ่นเทศบาลตำบลดอนหญ้านาง,2495,2526,5021,2497,2527,5024,1535
2565,38,บึงกาฬ,3898,ท้องถิ่นเทศบาลเมืองบึงกาฬ,9852,10155,20007,9903,10200,20103,11419
2565,39,หนองบัวลำภู,3901,อำเภอเมืองหนองบัวลำภู,50991,50995,101986,51091,51026,102117,32142
2565,39,หนองบัวลำภู,3902,อำเภอนากลาง,33544,33149,66693,33603,33161,66764,19058
2565,39,หนองบัวลำภู,3903,อำเภอโนนสัง,26705,27096,53801,26739,27106,53845,14009
2565,39,หนองบัวลำภู,3904,อำเภอศรีบุญเรือง,45487,44865,90352,45569,44878,90447,25685
2565,39,หนองบัวลำภู,3905,อำเภอสุวรรณคูหา,26996,26872,53868,27031,26887,53918,15438
2565,39,หนองบัวลำภู,3906,อำเภอนาวัง,15149,15126,30275,15182,15134,30316,8865
2565,39,หนองบัวลำภู,3986,ท้องถิ่นเทศบาลตำบลยางหล่อ,4584,4705,9289,4587,4709,9296,2640
2565,39,หนองบัวลำภู,3987,ท้องถิ่นเทศบาลตำบลนาเหล่า,3332,3536,6868,3343,3538,6881,2465
2565,39,หนองบัวลำภู,3988,ท้องถิ่นเทศบาลตำบลสุวรรณคูหา,3777,3940,7717,3794,3942,7736,2915
2565,39,หนองบัวลำภู,3989,ท้องถิ่นเทศบาลตำบลบ้านโคก,2966,3273,6239,2973,3275,6248,1909
2565,39,หนองบัวลำภู,3990,ท้องถิ่นเทศบาลตำบลโนนสูงเปลือย,2185,2404,4589,2195,2408,4603,2672
2565,39,หนองบัวลำภู,3991,ท้องถิ่นเทศบาลตำบลจอมทอง,2510,2455,4965,2514,2457,4971,1537
2565,39,หนองบัวลำภู,3992,ท้องถิ่นเทศบาลตำบลโนนสัง,4115,4260,8375,4131,4264,8395,2927
2565,39,หนองบัวลำภู,3993,ท้องถิ่นเทศบาลตำบลกุดดู่,1375,1365,2740,1380,1365,2745,757
2565,39,หนองบัวลำภู,3994,ท้องถิ่นเทศบาลตำบลนากลาง,9722,10160,19882,9747,10166,19913,6752
2565,39,หนองบัวลำภู,3995,ท้องถิ่นเทศบาลตำบลกุดดินจี่,2730,2866,5596,2739,2866,5605,1855
2565,39,หนองบัวลำภู,3996,ท้องถิ่นเทศบาลตำบลหัวนา,1798,1792,3590,1802,1792,3594,1073
2565,39,หนองบัวลำภู,3997,ท้องถิ่นเทศบาลตำบลนามะเฟือง,1995,2144,4139,2001,2145,4146,1101
2565,39,หนองบัวลำภู,3998,ท้องถิ่นเทศบาลตำบลนาคำไฮ,2442,2492,4934,2451,2494,4945,1447
2565,39,หนองบัวลำภู,3999,ท้องถิ่นเทศบาลเมืองหนองบัวลำภู,10407,11337,21744,10470,11370,21840,12319
2565,40,ขอนแก่น,4001,อำเภอเมืองขอนแก่น,73502,77236,150738,73774,77296,151070,70748
2565,40,ขอนแก่น,4002,อำเภอบ้านฝาง,24934,25250,50184,24980,25257,50237,17752
2565,40,ขอนแก่น,4003,อำเภอพระยืน,12137,12651,24788,12158,12654,24812,7885
2565,40,ขอนแก่น,4004,อำเภอหนองเรือ,41091,42144,83235,41123,42158,83281,23585
2565,40,ขอนแก่น,4005,อำเภอชุมแพ,41440,41688,83128,41543,41703,83246,26514
2565,40,ขอนแก่น,4006,อำเภอสีชมพู,36511,37097,73608,36572,37108,73680,22887
2565,40,ขอนแก่น,4007,อำเภอน้ำพอง,35992,36674,72666,36027,36698,72725,22529
2565,40,ขอนแก่น,4008,อำเภออุบลรัตน์,15454,15832,31286,15473,15840,31313,8444
2565,40,ขอนแก่น,4009,อำเภอกระนวน,33766,34380,68146,33823,34385,68208,20711
2565,40,ขอนแก่น,4010,อำเภอบ้านไผ่,35635,36427,72062,35683,36434,72117,23755
2565,40,ขอนแก่น,4011,อำเภอเปือยน้อย,7198,7051,14249,7203,7054,14257,3999
2565,40,ขอนแก่น,4012,อำเภอพล,37241,38138,75379,37273,38154,75427,23569
2565,40,ขอนแก่น,4013,อำเภอแวงใหญ่,11893,12169,24062,11899,12179,24078,6565
2565,40,ขอนแก่น,4014,อำเภอแวงน้อย,19231,19316,38547,19244,19322,38566,11606
2565,40,ขอนแก่น,4015,อำเภอหนองสองห้อง,35181,35704,70885,35218,35722,70940,21223
2565,40,ขอนแก่น,4016,อำเภอภูเวียง,34141,34664,68805,34183,34677,68860,20862
2565,40,ขอนแก่น,4017,อำเภอมัญจาคีรี,32756,33540,66296,32784,33548,66332,22279
2565,40,ขอนแก่น,4018,อำเภอชนบท,19416,20157,39573,19436,20163,39599,11925
2565,40,ขอนแก่น,4019,อำเภอเขาสวนกวาง,10711,10724,21435,10735,10726,21461,6521
2565,40,ขอนแก่น,4020,อำเภอภูผาม่าน,9815,9749,19564,9824,9754,19578,5937
2565,40,ขอนแก่น,4021,อำเภอซำสูง,8921,9203,18124,8927,9207,18134,5379
2565,40,ขอนแก่น,4022,อำเภอโคกโพธิ์ไชย,10479,10533,21012,10488,10543,21031,6771
2565,40,ขอนแก่น,4023,อำเภอหนองนาคำ,11731,11889,23620,11746,11893,23639,6899
2565,40,ขอนแก่น,4024,อำเภอบ้านแฮด,12882,13165,26047,12891,13172,26063,8473
2565,40,ขอนแก่น,4025,อำเภอโนนศิลา,10489,10547,21036,10492,10550,21042,6630
2565,40,ขอนแก่น,4029,อำเภอเวียงเก่า,9830,9992,19822,9837,9993,19830,5816
2565,40,ขอนแก่น,4055,ท้องถิ่นเทศบาลตำบลโคกสูง,4444,4366,8810,4468,4371,8839,2518
2565,40,ขอนแก่น,4056,ท้องถิ่นเทศบาลตำบลสะอาด,4942,5010,9952,4947,5012,9959,2744
2565,40,ขอนแก่น,4057,ท้องถิ่นเทศบาลเมืองบ้านทุ่ม,9110,9856,18966,9145,9866,19011,9049
2565,40,ขอนแก่น,4058,ท้องถิ่นเทศบาลตำบลโนนสมบูรณ์,2948,2964,5912,2953,2965,5918,1812
2565,40,ขอนแก่น,4060,ท้องถิ่นเทศบาลตำบลม่วงหวาน,4969,5179,10148,4979,5183,10162,3580
2565,40,ขอนแก่น,4061,ท้องถิ่นเทศบาลตำบลหนองตูม,3673,3967,7640,3680,3969,7649,2272
2565,40,ขอนแก่น,4062,ท้องถิ่นเทศบาลตำบลเมืองเก่า,14747,17040,31787,14934,17059,31993,18191
2565,40,ขอนแก่น,4063,ท้องถิ่นเทศบาลตำบลโนนท่อน,4837,4981,9818,4839,4983,9822,3224
2565,40,ขอนแก่น,4064,ท้องถิ่นเทศบาลตำบลบ้านค้อ,8478,8769,17247,8493,8773,17266,7077
2565,40,ขอนแก่น,4065,ท้องถิ่นเทศบาลตำบลกุดน้ำใส,4185,4311,8496,4197,4320,8517,2718
2565,40,ขอนแก่น,4067,ท้องถิ่นเทศบาลตำบลสาวะถี,8892,9112,18004,8912,9123,18035,5918
2565,40,ขอนแก่น,4068,ท้องถิ่นเทศบาลเมืองบ้านเป็ด,21678,25212,46890,21927,25252,47179,29041
2565,40,ขอนแก่น,4069,ท้องถิ่นเทศบาลตำบลโนนศิลา,2768,2763,5531,2769,2765,5534,1879
2565,40,ขอนแก่น,4070,ท้องถิ่นเทศบาลตำบลบ้านแฮด,3286,3323,6609,3289,3325,6614,2305
2565,40,ขอนแก่น,4071,ท้องถิ่นเทศบาลตำบลบ้านโคก,1967,2125,4092,1970,2126,4096,1512
2565,40,ขอนแก่น,4072,ท้องถิ่นเทศบาลตำบลซำสูง,2548,2662,5210,2551,2663,5214,1970
2565,40,ขอนแก่น,4073,ท้องถิ่นเทศบาลตำบลภูผาม่าน,1666,1761,3427,1667,1762,3429,1282
2565,40,ขอนแก่น,4074,ท้องถิ่นเทศบาลตำบลเขาสวนกวาง,5302,5418,10720,5319,5426,10745,3822
2565,40,ขอนแก่น,4075,ท้องถิ่นเทศบาลตำบลชนบท,3655,4131,7786,3660,4132,7792,3370
2565,40,ขอนแก่น,4076,ท้องถิ่นเทศบาลตำบลมัญจาคีรี,1649,1823,3472,1654,1826,3480,1970
2565,40,ขอนแก่น,4077,ท้องถิ่นเทศบาลตำบลภูเวียง,1381,1541,2922,1385,1543,2928,1755
2565,40,ขอนแก่น,4078,ท้องถิ่นเทศบาลตำบลหนองสองห้อง,2739,2849,5588,2748,2853,5601,2807
2565,40,ขอนแก่น,4079,ท้องถิ่นเทศบาลตำบลแวงน้อย,1457,1592,3049,1457,1593,3050,1337
2565,40,ขอนแก่น,4080,ท้องถิ่นเทศบาลตำบลแวงใหญ่,2453,2678,5131,2459,2679,5138,1814
2565,40,ขอนแก่น,4081,ท้องถิ่นเทศบาลตำบลเปือยน้อย,2855,3002,5857,2861,3003,5864,2034
2565,40,ขอนแก่น,4082,ท้องถิ่นเทศบาลเมืองกระนวน,4622,5101,9723,4653,5110,9763,4573
2565,40,ขอนแก่น,4083,ท้องถิ่นเทศบาลตำบลเขื่อนอุบลรัตน์,1941,2042,3983,1950,2043,3993,2120
2565,40,ขอนแก่น,4084,ท้องถิ่นเทศบาลตำบลวังชัย,3021,3289,6310,3028,3291,6319,2968
2565,40,ขอนแก่น,4085,ท้องถิ่นเทศบาลตำบลน้ำพอง,2302,2515,4817,2309,2519,4828,2458
2565,40,ขอนแก่น,4086,ท้องถิ่นเทศบาลตำบลสีชมพู,1618,1683,3301,1629,1684,3313,1574
2565,40,ขอนแก่น,4087,ท้องถิ่นเทศบาลตำบลโนนหัน,2157,2396,4553,2165,2398,4563,1552
2565,40,ขอนแก่น,4088,ท้องถิ่นเทศบาลตำบลโคกสูงสัมพันธ์,2041,2296,4337,2054,2297,4351,1331
2565,40,ขอนแก่น,4089,ท้องถิ่นเทศบาลตำบลหนองเรือ,2113,2109,4222,2122,2113,4235,2216
2565,40,ขอนแก่น,4090,ท้องถิ่นเทศบาลตำบลหนองแก,710,689,1399,711,690,1401,709
2565,40,ขอนแก่น,4091,ท้องถิ่นเทศบาลตำบลดอนโมง,1673,1727,3400,1680,1730,3410,1867
2565,40,ขอนแก่น,4092,ท้องถิ่นเทศบาลตำบลพระยืน,1567,1731,3298,1567,1735,3302,1513
2565,40,ขอนแก่น,4093,ท้องถิ่นเทศบาลตำบลบ้านโต้น,3082,3337,6419,3090,3338,6428,2086
2565,40,ขอนแก่น,4094,ท้องถิ่นเทศบาลตำบลบ้านฝาง,2201,2325,4526,2215,2336,4551,1884
2565,40,ขอนแก่น,4095,ท้องถิ่นเทศบาลตำบลท่าพระ,4134,4546,8680,4159,4550,8709,4164
2565,40,ขอนแก่น,4096,ท้องถิ่นเทศบาลเมืองชุมแพ,14721,15991,30712,14885,16037,30922,15993
2565,40,ขอนแก่น,4097,ท้องถิ่นเทศบาลเมืองบ้านไผ่,12662,13941,26603,12874,14048,26922,12949
2565,40,ขอนแก่น,4098,ท้องถิ่นเทศบาลเมืองเมืองพล,4849,5365,10214,4859,5374,10233,5455
2565,40,ขอนแก่น,4099,ท้องถิ่นเทศบาลนครขอนแก่น,48909,54099,103008,49533,54504,104037,67862
2565,41,อุดรธานี,4101,อำเภอเมืองอุดรธานี,90027,95053,185080,90542,95149,185691,74562
2565,41,อุดรธานี,4102,อำเภอกุดจับ,21801,21755,43556,21887,21776,43663,13510
2565,41,อุดรธานี,4103,อำเภอหนองวัวซอ,22429,22530,44959,22496,22545,45041,12019
2565,41,อุดรธานี,4104,อำเภอกุมภวาปี,36585,37325,73910,36664,37350,74014,22176
2565,41,อุดรธานี,4105,อำเภอโนนสะอาด,22469,22636,45105,22506,22651,45157,12285
2565,41,อุดรธานี,4106,อำเภอหนองหาน,44170,44492,88662,44249,44527,88776,28095
2565,41,อุดรธานี,4107,อำเภอทุ่งฝน,12570,12437,25007,12607,12446,25053,7397
2565,41,อุดรธานี,4108,อำเภอไชยวาน,12059,11793,23852,12077,11797,23874,6371
2565,41,อุดรธานี,4109,อำเภอศรีธาตุ,11783,11909,23692,11792,11913,23705,6794
2565,41,อุดรธานี,4110,อำเภอวังสามหมอ,15729,15485,31214,15739,15497,31236,8967
2565,41,อุดรธานี,4111,อำเภอบ้านดุง,55750,55858,111608,55885,55898,111783,33349
2565,41,อุดรธานี,4117,อำเภอบ้านผือ,50969,50981,101950,51026,51011,102037,31803
2565,41,อุดรธานี,4118,อำเภอน้ำโสม,20699,20316,41015,20741,20340,41081,13641
2565,41,อุดรธานี,4119,อำเภอเพ็ญ,48208,48265,96473,48294,48295,96589,30176
2565,41,อุดรธานี,4120,อำเภอสร้างคอม,10952,10956,21908,10967,10965,21932,6782
2565,41,อุดรธานี,4121,อำเภอหนองแสง,11541,11609,23150,11585,11615,23200,6980
2565,41,อุดรธานี,4122,อำเภอนายูง,14481,14174,28655,14495,14181,28676,9993
2565,41,อุดรธานี,4123,อำเภอพิบูลย์รักษ์,12229,12428,24657,12248,12436,24684,8683
2565,41,อุดรธานี,4124,อำเภอกู่แก้ว,11068,10964,22032,11086,10973,22059,7072
2565,41,อุดรธานี,4125,อำเภอประจักษ์ศิลปาคม,12693,12698,25391,12733,12709,25442,7484
2565,41,อุดรธานี,4158,ท้องถิ่นเทศบาลตำบลหนองหว้า,4070,4121,8191,4079,4121,8200,2056
2565,41,อุดรธานี,4159,ท้องถิ่นเทศบาลตำบลหัวนาคำ,5733,5557,11290,5734,5560,11294,3237
2565,41,อุดรธานี,4160,ท้องถิ่นเทศบาลตำบลผาสุก,8026,7759,15785,8038,7765,15803,4842
2565,41,อุดรธานี,4161,ท้องถิ่นเทศบาลตำบลโพนสูง,3743,3690,7433,3743,3690,7433,1957
2565,41,อุดรธานี,4162,ท้องถิ่นเทศบาลตำบลจำปี,4136,4030,8166,4138,4032,8170,2200
2565,41,อุดรธานี,4163,ท้องถิ่นเทศบาลตำบลสร้างคอม,3568,3712,7280,3575,3715,7290,2722
2565,41,อุดรธานี,4164,ท้องถิ่นเทศบาลตำบลบ้านธาตุ,8240,8560,16800,8273,8580,16853,5268
2565,41,อุดรธานี,4165,ท้องถิ่นเทศบาลตำบลเวียงคำ,5187,5306,10493,5196,5308,10504,3283
2565,41,อุดรธานี,4166,ท้องถิ่นเทศบาลตำบลลำพันชาด,2807,2787,5594,2810,2787,5597,2091
2565,41,อุดรธานี,4167,ท้องถิ่นเทศบาลตำบลหนองไผ่,4644,4772,9416,4660,4778,9438,2799
2565,41,อุดรธานี,4168,ท้องถิ่นเทศบาลตำบลหนองไผ่,4047,4721,8768,4061,4725,8786,2811
2565,41,อุดรธานี,4169,ท้องถิ่นเทศบาลตำบลปะโค,5561,5628,11189,5575,5630,11205,3495
2565,41,อุดรธานี,4170,ท้องถิ่นเทศบาลตำบลแสงสว่าง,1983,1991,3974,1996,1991,3987,991
2565,41,อุดรธานี,4171,ท้องถิ่นเทศบาลตำบลเพ็ญ,1335,1366,2701,1338,1367,2705,1623
2565,41,อุดรธานี,4172,ท้องถิ่นเทศบาลตำบลน้ำโสม,4207,4381,8588,4210,4382,8592,2615
2565,41,อุดรธานี,4173,ท้องถิ่นเทศบาลตำบลนางัว,4407,4534,8941,4427,4541,8968,3505
2565,41,อุดรธานี,4174,ท้องถิ่นเทศบาลตำบลบ้านผือ,3614,3901,7515,3625,3918,7543,4183
2565,41,อุดรธานี,4175,ท้องถิ่นเทศบาลเมืองบ้านดุง,7236,7861,15097,7300,7883,15183,6477
2565,41,อุดรธานี,4176,ท้องถิ่นเทศบาลตำบลวังสามหมอ,2885,3060,5945,2888,3062,5950,2886
2565,41,อุดรธานี,4177,ท้องถิ่นเทศบาลตำบลศรีธาตุ,2641,2734,5375,2644,2734,5378,1936
2565,41,อุดรธานี,4178,ท้องถิ่นเทศบาลตำบลไชยวาน,3995,4209,8204,4002,4211,8213,2457
2565,41,อุดรธานี,4179,ท้องถิ่นเทศบาลตำบลทุ่งฝน,3390,3712,7102,3403,3716,7119,2235
2565,41,อุดรธานี,4180,ท้องถิ่นเทศบาลตำบลหนองหาน,1929,2173,4102,1939,2179,4118,1908
2565,41,อุดรธานี,4181,ท้องถิ่นเทศบาลตำบลหนองเม็ก,4051,4084,8135,4067,4087,8154,2308
2565,41,อุดรธานี,4182,ท้องถิ่นเทศบาลตำบลบ้านเชียง,2855,2883,5738,2876,2887,5763,2006
2565,41,อุดรธานี,4183,ท้องถิ่นเทศบาลตำบลโนนสะอาด,2131,2229,4360,2136,2230,4366,1757
2565,41,อุดรธานี,4184,ท้องถิ่นเทศบาลตำบลห้วยเกิ้ง,2530,2644,5174,2541,2644,5185,1724
2565,41,อุดรธานี,4185,ท้องถิ่นเทศบาลตำบลพันดอน,2564,2838,5402,2578,2854,5432,2679
2565,41,อุดรธานี,4186,ท้องถิ่นเทศบาลตำบลกุมภวาปี,3787,4153,7940,3822,4168,7990,4521
2565,41,อุดรธานี,4187,ท้องถิ่นเทศบาลตำบลภูผาแดง,3761,3992,7753,3784,3997,7781,2357
2565,41,อุดรธานี,4188,ท้องถิ่นเทศบาลตำบลหนองวัวซอ,4618,4858,9476,4648,4862,9510,2949
2565,41,อุดรธานี,4189,ท้องถิ่นเทศบาลตำบลสร้างก่อ,1943,1947,3890,1944,1947,3891,1099
2565,41,อุดรธานี,4190,ท้องถิ่นเทศบาลตำบลตาลเลียน,1849,1837,3686,1851,1840,3691,893
2565,41,อุดรธานี,4191,ท้องถิ่นเทศบาลตำบลเชียงเพ็ง,1969,2029,3998,1970,2029,3999,1193
2565,41,อุดรธานี,4192,ท้องถิ่นเทศบาลตำบลกุดจับ,4851,5218,10069,4878,5221,10099,3991
2565,41,อุดรธานี,4193,ท้องถิ่นเทศบาลตำบลหนองบัว,15331,17375,32706,15745,17436,33181,16465
2565,41,อุดรธานี,4194,ท้องถิ่นเทศบาลเมืองหนองสำโรง,14131,15329,29460,14330,15381,29711,15616
2565,41,อุดรธานี,4195,ท้องถิ่นเทศบาลตำบลบ้านจั่น,3189,3798,6987,3241,3806,7047,3501
2565,41,อุดรธานี,4196,ท้องถิ่นเทศบาลเมืองโนนสูง-น้ำคำ,4319,3927,8246,4347,3935,8282,3603
2565,41,อุดรธานี,4197,ท้องถิ่นเทศบาลตำบลนิคมสงเคราะห์,1771,1905,3676,1786,1907,3693,1337
2565,41,อุดรธานี,4198,ท้องถิ่นเทศบาลตำบลนาข่า,3071,3299,6370,3080,3301,6381,2652
2565,41,อุดรธานี,4199,ท้องถิ่นเทศบาลนครอุดรธานี,53036,59538,112574,55447,61423,116870,62158
2565,42,เลย,4201,อำเภอเมืองเลย,29966,29248,59214,30058,29346,59404,24345
2565,42,เลย,4202,อำเภอนาด้วง,4911,4853,9764,4946,4889,9835,3714
2565,42,เลย,4203,อำเภอเชียงคาน,18709,18627,37336,18969,19187,38156,14483
2565,42,เลย,4204,อำเภอปากชม,16913,16306,33219,17104,16577,33681,11539
2565,42,เลย,4205,อำเภอด่านซ้าย,24328,23782,48110,24393,23858,48251,16529
2565,42,เลย,4206,อำเภอนาแห้ว,4834,4791,9625,4862,4825,9687,3180
2565,42,เลย,4207,อำเภอภูเรือ,9965,9586,19551,10046,9713,19759,7490
2565,42,เลย,4208,อำเภอท่าลี่,12558,12248,24806,12988,12979,25967,10237
2565,42,เลย,4209,อำเภอวังสะพุง,49551,50191,99742,49615,50241,99856,34981
2565,42,เลย,4210,อำเภอภูกระดึง,13730,13602,27332,13743,13612,27355,8995
2565,42,เลย,4211,อำเภอภูหลวง,12619,12339,24958,12630,12351,24981,7962
2565,42,เลย,4212,อำเภอผาขาว,15462,15407,30869,15476,15416,30892,8589
2565,42,เลย,4213,อำเภอเอราวัณ,16953,16966,33919,16983,16983,33966,11712
2565,42,เลย,4214,อำเภอหนองหิน,10397,10188,20585,10416,10206,20622,6227
2565,42,เลย,4279,ท้องถิ่นเทศบาลตำบลโนนปอแดง,5522,5510,11032,5535,5514,11049,3517
2565,42,เลย,4280,ท้องถิ่นเทศบาลตำบลนาดอกคำ,4984,4843,9827,5009,4877,9886,3043
2565,42,เลย,4281,ท้องถิ่นเทศบาลตำบลธาตุ,4780,4823,9603,4804,4874,9678,3476
2565,42,เลย,4282,ท้องถิ่นเทศบาลตำบลนาดินดำ,5322,5277,10599,5332,5300,10632,3756
2565,42,เลย,4283,ท้องถิ่นเทศบาลตำบลนาโป่ง,5106,5189,10295,5110,5195,10305,3587
2565,42,เลย,4284,ท้องถิ่นเทศบาลตำบลนาอาน,6352,6584,12936,6371,6597,12968,6204
2565,42,เลย,4285,ท้องถิ่นเทศบาลตำบลเขาแก้ว,3871,3847,7718,3878,3861,7739,2202
2565,42,เลย,4286,ท้องถิ่นเทศบาลตำบลหนองหิน,2136,2236,4372,2141,2237,4378,2083
2565,42,เลย,4287,ท้องถิ่นเทศบาลตำบลภูกระดึง,3487,3547,7034,3491,3547,7038,2784
2565,42,เลย,4288,ท้องถิ่นเทศบาลเมืองวังสะพุง,5118,5547,10665,5128,5556,10684,4602
2565,42,เลย,4289,ท้องถิ่นเทศบาลตำบลท่าลี่,873,968,1841,876,977,1853,823
2565,42,เลย,4290,ท้องถิ่นเทศบาลตำบลภูเรือ,1380,1388,2768,1396,1398,2794,1594
2565,42,เลย,4291,ท้องถิ่นเทศบาลตำบลนาแห้ว,1020,969,1989,1027,992,2019,926
2565,42,เลย,4292,ท้องถิ่นเทศบาลตำบลด่านซ้าย,1643,1692,3335,1645,1693,3338,1986
2565,42,เลย,4293,ท้องถิ่นเทศบาลตำบลปากชม,1629,1724,3353,1652,1772,3424,1585
2565,42,เลย,4294,ท้องถิ่นเทศบาลตำบลเชียงกลม,2551,2586,5137,2565,2611,5176,1653
2565,42,เลย,4295,ท้องถิ่นเทศบาลตำบลเชียงคาน,2405,2595,5000,2428,2626,5054,2814
2565,42,เลย,4296,ท้องถิ่นเทศบาลตำบลนาด้วง,3247,3273,6520,3258,3282,6540,2394
2565,42,เลย,4297,ท้องถิ่นเทศบาลตำบลน้ำสวย,1781,1804,3585,1783,1808,3591,1243
2565,42,เลย,4298,ท้องถิ่นเทศบาลตำบลนาอ้อ,2963,3093,6056,2970,3097,6067,2349
2565,42,เลย,4299,ท้องถิ่นเทศบาลเมืองเลย,10418,10178,20596,10471,10245,20716,11459
2565,43,หนองคาย,4301,อำเภอเมืองหนองคาย,36929,37688,74617,37142,37959,75101,25135
2565,43,หนองคาย,4302,อำเภอท่าบ่อ,30000,30931,60931,30104,31064,61168,19095
2565,43,หนองคาย,4305,อำเภอโพนพิสัย,47303,47812,95115,47476,48074,95550,32547
2565,43,หนองคาย,4307,อำเภอศรีเชียงใหม่,11453,11741,23194,11574,11889,23463,7586
2565,43,หนองคาย,4308,อำเภอสังคม,11291,10990,22281,11317,11036,22353,7434
2565,43,หนองคาย,4314,อำเภอสระใคร,13350,13202,26552,13370,13231,26601,8694
2565,43,หนองคาย,4315,อำเภอเฝ้าไร่,19902,19960,39862,19932,19969,39901,11626
2565,43,หนองคาย,4316,อำเภอรัตนวาปี,18972,18915,37887,18983,18933,37916,13301
2565,43,หนองคาย,4317,อำเภอโพธิ์ตาก,7596,7557,15153,7619,7611,15230,5213
2565,43,หนองคาย,4378,ท้องถิ่นเทศบาลตำบลเฝ้าไร่,5422,5519,10941,5430,5521,10951,4078
2565,43,หนองคาย,4381,ท้องถิ่นเทศบาลตำบลโพธิ์ชัย,3827,4081,7908,3849,4103,7952,3944
2565,43,หนองคาย,4382,ท้องถิ่นเทศบาลตำบลหาดคำ,4527,4640,9167,4641,4840,9481,3062
2565,43,หนองคาย,4388,ท้องถิ่นเทศบาลตำบลสังคม,1604,1666,3270,1609,1671,3280,1472
2565,43,หนองคาย,4389,ท้องถิ่นเทศบาลตำบลศรีเชียงใหม่,3031,3177,6208,3073,3219,6292,2877
2565,43,หนองคาย,4391,ท้องถิ่นเทศบาลตำบลโพนพิสัย,1289,1275,2564,1297,1288,2585,1233
2565,43,หนองคาย,4395,ท้องถิ่นเทศบาลตำบลโพนสา,1711,1949,3660,1721,1968,3689,1163
2565,43,หนองคาย,4396,ท้องถิ่นเทศบาลเมืองท่าบ่อ,8288,8685,16973,8381,8783,17164,7482
2565,43,หนองคาย,4397,ท้องถิ่นเทศบาลตำบลหนองสองห้อง,2538,2601,5139,2577,2610,5187,2115
2565,43,หนองคาย,4398,ท้องถิ่นเทศบาลตำบลเวียงคุก,2789,3040,5829,2799,3054,5853,1935
2565,43,หนองคาย,4399,ท้องถิ่นเทศบาลเมืองหนองคาย,21274,22437,43711,22499,23579,46078,24917
2565,44,มหาสารคาม,4401,อำเภอเมืองมหาสารคาม,49810,52228,102038,49897,52249,102146,37154
2565,44,มหาสารคาม,4402,อำเภอแกดำ,12237,12165,24402,12244,12167,24411,6666
2565,44,มหาสารคาม,4403,อำเภอโกสุมพิสัย,53676,55397,109073,53737,55422,109159,32192
2565,44,มหาสารคาม,4404,อำเภอกันทรวิชัย,27089,28223,55312,27119,28232,55351,16693
2565,44,มหาสารคาม,4405,อำเภอเชียงยืน,27381,28272,55653,27416,28283,55699,18463
2565,44,มหาสารคาม,4406,อำเภอบรบือ,50329,50664,100993,50367,50686,101053,34839
2565,44,มหาสารคาม,4407,อำเภอนาเชือก,28491,28635,57126,28506,28648,57154,17703
2565,44,มหาสารคาม,4408,อำเภอพยัคฆภูมิพิสัย,39440,39958,79398,39453,39971,79424,22535
2565,44,มหาสารคาม,4409,อำเภอวาปีปทุม,53271,53907,107178,53308,53926,107234,31038
2565,44,มหาสารคาม,4410,อำเภอนาดูน,16205,16297,32502,16217,16312,32529,8820
2565,44,มหาสารคาม,4411,อำเภอยางสีสุราช,17339,17556,34895,17345,17566,34911,9972
2565,44,มหาสารคาม,4412,อำเภอกุดรัง,18562,18375,36937,18580,18382,36962,10851
2565,44,มหาสารคาม,4413,อำเภอชื่นชม,12012,12429,24441,12020,12437,24457,7105
2565,44,มหาสารคาม,4487,ท้องถิ่นเทศบาลตำบลขามเรียง,6101,8770,14871,6120,8774,14894,5751
2565,44,มหาสารคาม,4488,ท้องถิ่นเทศบาลตำบลท่าขอนยาง,4253,4607,8860,4263,4612,8875,6671
2565,44,มหาสารคาม,4489,ท้องถิ่นเทศบาลตำบลนาดูน,2382,2346,4728,2384,2347,4731,1875
2565,44,มหาสารคาม,4490,ท้องถิ่นเทศบาลตำบลวาปีปทุม,2194,2446,4640,2199,2450,4649,2401
2565,44,มหาสารคาม,4491,ท้องถิ่นเทศบาลตำบลพยัคฆภูมิพิสัย,3777,4196,7973,3788,4202,7990,4320
2565,44,มหาสารคาม,4492,ท้องถิ่นเทศบาลตำบลนาเชือก,1795,1944,3739,1798,1944,3742,2159
2565,44,มหาสารคาม,4493,ท้องถิ่นเทศบาลตำบลบรบือ,2486,2947,5433,2492,2949,5441,2360
2565,44,มหาสารคาม,4494,ท้องถิ่นเทศบาลตำบลเชียงยืน,2240,2383,4623,2244,2386,4630,2431
2565,44,มหาสารคาม,4495,ท้องถิ่นเทศบาลตำบลกันทรวิชัย,1575,1769,3344,1581,1769,3350,1494
2565,44,มหาสารคาม,4496,ท้องถิ่นเทศบาลตำบลโกสุมพิสัย,4265,4711,8976,4281,4713,8994,4374
2565,44,มหาสารคาม,4497,ท้องถิ่นเทศบาลตำบลแกดำ,2647,2651,5298,2649,2651,5300,1672
2565,44,มหาสารคาม,4498,ท้องถิ่นเทศบาลตำบลแวงน่าง,2724,2907,5631,2731,2907,5638,2271
2565,44,มหาสารคาม,4499,ท้องถิ่นเทศบาลเมืองมหาสารคาม,20080,25667,45747,20157,25724,45881,21786
2565,45,ร้อยเอ็ด,4501,อำเภอเมืองร้อยเอ็ด,54405,56398,110803,54574,56443,111017,42641
2565,45,ร้อยเอ็ด,4502,อำเภอเกษตรวิสัย,36600,36647,73247,36619,36655,73274,21440
2565,45,ร้อยเอ็ด,4503,อำเภอปทุมรัตต์,23327,23825,47152,23339,23831,47170,13190
2565,45,ร้อยเอ็ด,4504,อำเภอจตุรพักตรพิมาน,25130,25567,50697,25151,25581,50732,14090
2565,45,ร้อยเอ็ด,4505,อำเภอธวัชบุรี,18665,18671,37336,18684,18681,37365,11606
2565,45,ร้อยเอ็ด,4506,อำเภอพนมไพร,29829,30049,59878,29849,30063,59912,18213
2565,45,ร้อยเอ็ด,4507,อำเภอโพนทอง,47974,48500,96474,48028,48523,96551,29385
2565,45,ร้อยเอ็ด,4508,อำเภอโพธิ์ชัย,13442,13619,27061,13447,13623,27070,7799
2565,45,ร้อยเอ็ด,4509,อำเภอหนองพอก,30046,29928,59974,30074,29942,60016,16889
2565,45,ร้อยเอ็ด,4510,อำเภอเสลภูมิ,44572,45157,89729,44595,45179,89774,25523
2565,45,ร้อยเอ็ด,4511,อำเภอสุวรรณภูมิ,51995,52868,104863,52032,52892,104924,30502
2565,45,ร้อยเอ็ด,4512,อำเภอเมืองสรวง,6798,6804,13602,6806,6811,13617,3851
2565,45,ร้อยเอ็ด,4513,อำเภอโพนทราย,11084,11158,22242,11091,11161,22252,5255
2565,45,ร้อยเอ็ด,4514,อำเภออาจสามารถ,34634,34751,69385,34662,34767,69429,19368
2565,45,ร้อยเอ็ด,4515,อำเภอเมยวดี,11391,11681,23072,11397,11690,23087,7071
2565,45,ร้อยเอ็ด,4516,อำเภอศรีสมเด็จ,18489,17327,35816,18510,17339,35849,11318
2565,45,ร้อยเอ็ด,4517,อำเภอจังหาร,18843,19497,38340,18861,19507,38368,12399
2565,45,ร้อยเอ็ด,4518,อำเภอเชียงขวัญ,13334,13816,27150,13353,13824,27177,8381
2565,45,ร้อยเอ็ด,4519,อำเภอหนองฮี,12033,12153,24186,12039,12161,24200,6633
2565,45,ร้อยเอ็ด,4520,อำเภอทุ่งเขาหลวง,11377,11672,23049,11392,11675,23067,6587
2565,45,ร้อยเอ็ด,4565,ท้องถิ่นเทศบาลตำบลนิเวศน์,3356,3426,6782,3369,3430,6799,3095
2565,45,ร้อยเอ็ด,4566,ท้องถิ่นเทศบาลตำบลมะอึ,2591,2757,5348,2600,2758,5358,2168
2565,45,ร้อยเอ็ด,4569,ท้องถิ่นเทศบาลตำบลโพธิ์ชัย,3304,3345,6649,3305,3347,6652,1776
2565,45,ร้อยเอ็ด,4570,ท้องถิ่นเทศบาลตำบลดินดำ,3365,3448,6813,3368,3450,6818,2032
2565,45,ร้อยเอ็ด,4571,ท้องถิ่นเทศบาลตำบลเมืองไพร,3149,3075,6224,3152,3075,6227,1623
2565,45,ร้อยเอ็ด,4572,ท้องถิ่นเทศบาลตำบลขวาว,4305,4507,8812,4308,4509,8817,2234
2565,45,ร้อยเอ็ด,4573,ท้องถิ่นเทศบาลตำบลดงแดง,4258,4440,8698,4259,4445,8704,2466
2565,45,ร้อยเอ็ด,4574,ท้องถิ่นเทศบาลตำบลโคกล่าม,3613,3716,7329,3616,3720,7336,2122
2565,45,ร้อยเอ็ด,4575,ท้องถิ่นเทศบาลตำบลหัวช้าง,3980,4213,8193,3986,4217,8203,2765
2565,45,ร้อยเอ็ด,4576,ท้องถิ่นเทศบาลตำบลอุ่มเม้า,3550,3704,7254,3557,3708,7265,2077
2565,45,ร้อยเอ็ด,4577,ท้องถิ่นเทศบาลตำบลปอภาร,3448,3781,7229,3455,3782,7237,2498
2565,45,ร้อยเอ็ด,4578,ท้องถิ่นเทศบาลตำบลเมืองบัว,4124,4289,8413,4134,4292,8426,2854
2565,45,ร้อยเอ็ด,4579,ท้องถิ่นเทศบาลตำบลคำพอุง,4666,4594,9260,4679,4595,9274,2705
2565,45,ร้อยเอ็ด,4580,ท้องถิ่นเทศบาลตำบลอัคคะคำ,4103,4099,8202,4105,4100,8205,2175
2565,45,ร้อยเอ็ด,4581,ท้องถิ่นเทศบาลตำบลโนนตาล,2632,2640,5272,2633,2642,5275,1486
2565,45,ร้อยเอ็ด,4583,ท้องถิ่นเทศบาลตำบลอาจสามารถ,1915,2051,3966,1917,2053,3970,1822
2565,45,ร้อยเอ็ด,4584,ท้องถิ่นเทศบาลตำบลโพนทราย,2769,2829,5598,2769,2829,5598,2070
2565,45,ร้อยเอ็ด,4585,ท้องถิ่นเทศบาลตำบลเมืองสรวง,4655,4809,9464,4668,4810,9478,2943
2565,45,ร้อยเอ็ด,4586,ท้องถิ่นเทศบาลตำบลสุวรรณภูมิ,4190,4713,8903,4195,4718,8913,4279
2565,45,ร้อยเอ็ด,4587,ท้องถิ่นเทศบาลตำบลเสลภูมิ,6207,6683,12890,6223,6692,12915,5131
2565,45,ร้อยเอ็ด,4588,ท้องถิ่นเทศบาลตำบลหนองพอก,3088,3290,6378,3100,3291,6391,2706
2565,45,ร้อยเอ็ด,4589,ท้องถิ่นเทศบาลตำบลเชียงใหม่,4033,4185,8218,4036,4186,8222,2529
2565,45,ร้อยเอ็ด,4590,ท้องถิ่นเทศบาลตำบลชัยวารี,2581,2668,5249,2584,2668,5252,1717
2565,45,ร้อยเอ็ด,4591,ท้องถิ่นเทศบาลตำบลโพนทอง,5481,5743,11224,5500,5748,11248,5175
2565,45,ร้อยเอ็ด,4592,ท้องถิ่นเทศบาลตำบลพนมไพร,1976,2110,4086,1981,2112,4093,1816
2565,45,ร้อยเอ็ด,4593,ท้องถิ่นเทศบาลตำบลบ้านนิเวศน์,1190,1306,2496,1192,1306,2498,1188
2565,45,ร้อยเอ็ด,4594,ท้องถิ่นเทศบาลตำบลธงธานี,3678,3975,7653,3693,3977,7670,2579
2565,45,ร้อยเอ็ด,4595,ท้องถิ่นเทศบาลตำบลจตุรพักตรพิมาน,1756,2034,3790,1763,2039,3802,1617
2565,45,ร้อยเอ็ด,4596,ท้องถิ่นเทศบาลตำบลปทุมรัตต์,3067,3285,6352,3070,3286,6356,2167
2565,45,ร้อยเอ็ด,4597,ท้องถิ่นเทศบาลตำบลเกษตรวิสัย,5215,5567,10782,5217,5574,10791,4929
2565,45,ร้อยเอ็ด,4598,ท้องถิ่นเทศบาลตำบลกู่กาสิงห์,2226,2309,4535,2227,2310,4537,1643
2565,45,ร้อยเอ็ด,4599,ท้องถิ่นเทศบาลเมืองร้อยเอ็ด,15730,18051,33781,15845,18105,33950,16787
2565,46,กาฬสินธุ์,4601,อำเภอเมืองกาฬสินธุ์,39585,41088,80673,39687,41118,80805,26724
2565,46,กาฬสินธุ์,4602,อำเภอนามน,14618,14826,29444,14635,14829,29464,9630
2565,46,กาฬสินธุ์,4603,อำเภอกมลาไสย,22162,23126,45288,22181,23132,45313,12714
2565,46,กาฬสินธุ์,4604,อำเภอร่องคำ,5121,5282,10403,5124,5282,10406,3346
2565,46,กาฬสินธุ์,4605,อำเภอกุฉินารายณ์,30820,30757,61577,30857,30782,61639,21635
2565,46,กาฬสินธุ์,4606,อำเภอเขาวง,10363,10525,20888,10371,10532,20903,8842
2565,46,กาฬสินธุ์,4607,อำเภอยางตลาด,39712,41519,81231,39754,41531,81285,24710
2565,46,กาฬสินธุ์,4608,อำเภอห้วยเม็ก,20004,19974,39978,20029,19979,40008,12464
2565,46,กาฬสินธุ์,4609,อำเภอสหัสขันธ์,17199,17344,34543,17228,17353,34581,10636
2565,46,กาฬสินธุ์,4610,อำเภอคำม่วง,13393,13393,26786,13400,13394,26794,7584
2565,46,กาฬสินธุ์,4611,อำเภอท่าคันโท,14344,14383,28727,14363,14387,28750,8333
2565,46,กาฬสินธุ์,4612,อำเภอหนองกุงศรี,25492,25593,51085,25518,25604,51122,15717
2565,46,กาฬสินธุ์,4613,อำเภอสมเด็จ,27155,27789,54944,27209,27805,55014,18399
2565,46,กาฬสินธุ์,4614,อำเภอห้วยผึ้ง,6915,7108,14023,6926,7110,14036,4048
2565,46,กาฬสินธุ์,4615,อำเภอสามชัย,12847,12500,25347,12853,12508,25361,7804
2565,46,กาฬสินธุ์,4616,อำเภอนาคู,12820,12813,25633,12824,12817,25641,8426
2565,46,กาฬสินธุ์,4617,อำเภอดอนจาน,12891,13144,26035,12905,13149,26054,8044
2565,46,กาฬสินธุ์,4618,อำเภอฆ้องชัย,13122,13410,26532,13129,13413,26542,7728
2565,46,กาฬสินธุ์,4651,สาขาตำบลคำใหญ่ อำเภอห้วยเม็ก,0,0,0,0,0,0,0
2565,46,กาฬสินธุ์,4665,ท้องถิ่นเทศบาลตำบลจุมจัง,4757,4832,9589,4758,4832,9590,2557
2565,46,กาฬสินธุ์,4666,ท้องถิ่นเทศบาลตำบลนาทัน,7186,7055,14241,7186,7056,14242,3787
2565,46,กาฬสินธุ์,4667,ท้องถิ่นเทศบาลตำบลอิตื้อ,4260,4381,8641,4262,4385,8647,2552
2565,46,กาฬสินธุ์,4668,ท้องถิ่นเทศบาลตำบลภูสิงห์,1429,1358,2787,1429,1360,2789,837
2565,46,กาฬสินธุ์,4669,ท้องถิ่นเทศบาลตำบลหัวนาคำ,6124,6445,12569,6127,6448,12575,3823
2565,46,กาฬสินธุ์,4670,ท้องถิ่นเทศบาลตำบลบัวบาน,6257,6633,12890,6264,6636,12900,4534
2565,46,กาฬสินธุ์,4671,ท้องถิ่นเทศบาลตำบลนาขาม,6437,6589,13026,6439,6590,13029,3454
2565,46,กาฬสินธุ์,4672,ท้องถิ่นเทศบาลตำบลลำคลอง,2052,2212,4264,2054,2213,4267,1355
2565,46,กาฬสินธุ์,4673,ท้องถิ่นเทศบาลตำบลคำบง,5221,5151,10372,5224,5154,10378,3051
2565,46,กาฬสินธุ์,4674,ท้องถิ่นเทศบาลตำบลสระพังทอง,1366,1371,2737,1367,1372,2739,1013
2565,46,กาฬสินธุ์,4675,ท้องถิ่นเทศบาลตำบลห้วยโพธิ์,5757,5943,11700,5773,5945,11718,3468
2565,46,กาฬสินธุ์,4676,ท้องถิ่นเทศบาลตำบลนาคู,2488,2722,5210,2492,2725,5217,1951
2565,46,กาฬสินธุ์,4677,ท้องถิ่นเทศบาลตำบลห้วยผึ้ง,2779,2913,5692,2786,2916,5702,2302
2565,46,กาฬสินธุ์,4678,ท้องถิ่นเทศบาลตำบลสมเด็จ,3247,3464,6711,3257,3469,6726,3402
2565,46,กาฬสินธุ์,4679,ท้องถิ่นเทศบาลตำบลหนองหิน,2630,2690,5320,2633,2691,5324,1655
2565,46,กาฬสินธุ์,4680,ท้องถิ่นเทศบาลตำบลหนองกุงศรี,4323,4477,8800,4331,4480,8811,3470
2565,46,กาฬสินธุ์,4681,ท้องถิ่นเทศบาลตำบลท่าคันโท,4492,4596,9088,4497,4599,9096,2985
2565,46,กาฬสินธุ์,4682,ท้องถิ่นเทศบาลตำบลโพน,1858,1902,3760,1858,1902,3760,1120
2565,46,กาฬสินธุ์,4683,ท้องถิ่นเทศบาลตำบลคำม่วง,1927,1967,3894,1930,1968,3898,1758
2565,46,กาฬสินธุ์,4684,ท้องถิ่นเทศบาลตำบลโนนบุรี,2451,2701,5152,2461,2701,5162,2044
2565,46,กาฬสินธุ์,4685,ท้องถิ่นเทศบาลตำบลห้วยเม็ก,2757,2889,5646,2765,2891,5656,2262
2565,46,กาฬสินธุ์,4686,ท้องถิ่นเทศบาลตำบลคำใหญ่,2431,2508,4939,2435,2509,4944,1646
2565,46,กาฬสินธุ์,4687,ท้องถิ่นเทศบาลตำบลยางตลาด,3942,4405,8347,3952,4410,8362,3870
2565,46,กาฬสินธุ์,4688,ท้องถิ่นเทศบาลตำบลโคกศรี,1526,1620,3146,1527,1620,3147,1277
2565,46,กาฬสินธุ์,4689,ท้องถิ่นเทศบาลตำบลกุดสิม,4831,5157,9988,4844,5166,10010,4559
2565,46,กาฬสินธุ์,4690,ท้องถิ่นเทศบาลเมืองกุฉินารายณ์,5497,5770,11267,5509,5774,11283,5024
2565,46,กาฬสินธุ์,4691,ท้องถิ่นเทศบาลตำบลกุดหว้า,2507,2700,5207,2511,2701,5212,2096
2565,46,กาฬสินธุ์,4692,ท้องถิ่นเทศบาลตำบลร่องคำ,2931,3089,6020,2934,3091,6025,2273
2565,46,กาฬสินธุ์,4693,ท้องถิ่นเทศบาลตำบลหนองแปน,3210,3535,6745,3214,3535,6749,2232
2565,46,กาฬสินธุ์,4694,ท้องถิ่นเทศบาลตำบลธัญญา,3117,3207,6324,3124,3210,6334,1734
2565,46,กาฬสินธุ์,4695,ท้องถิ่นเทศบาลตำบลกมลาไสย,4554,5096,9650,4573,5099,9672,3721
2565,46,กาฬสินธุ์,4696,ท้องถิ่นเทศบาลตำบลนามน,3433,3488,6921,3435,3489,6924,2404
2565,46,กาฬสินธุ์,4697,ท้องถิ่นเทศบาลตำบลหนองสอ,3512,3769,7281,3521,3771,7292,2346
2565,46,กาฬสินธุ์,4698,ท้องถิ่นเทศบาลตำบลนาจารย์,4211,4212,8423,4219,4217,8436,2550
2565,46,กาฬสินธุ์,4699,ท้องถิ่นเทศบาลเมืองกาฬสินธุ์,15107,16550,31657,15190,16577,31767,16294
2565,47,สกลนคร,4701,อำเภอเมืองสกลนคร,56322,57912,114234,56388,57933,114321,43308
2565,47,สกลนคร,4702,อำเภอกุสุมาลย์,21753,21961,43714,21777,21971,43748,14291
2565,47,สกลนคร,4703,อำเภอกุดบาก,13963,13718,27681,13967,13720,27687,9338
2565,47,สกลนคร,4704,อำเภอพรรณานิคม,38506,39220,77726,38542,39249,77791,27538
2565,47,สกลนคร,4705,อำเภอพังโคน,22649,23230,45879,22704,23260,45964,17949
2565,47,สกลนคร,4706,อำเภอวาริชภูมิ,17668,18288,35956,17688,18298,35986,12599
2565,47,สกลนคร,4707,อำเภอนิคมน้ำอูน,7418,7443,14861,7422,7447,14869,4679
2565,47,สกลนคร,4708,อำเภอวานรนิวาส,60000,60626,120626,60056,60660,120716,35546
2565,47,สกลนคร,4709,อำเภอคำตากล้า,16372,16522,32894,16386,16529,32915,11909
2565,47,สกลนคร,4710,อำเภอบ้านม่วง,33836,33388,67224,33884,33404,67288,20539
2565,47,สกลนคร,4711,อำเภออากาศอำนวย,27198,26918,54116,27212,26936,54148,19758
2565,47,สกลนคร,4712,อำเภอสว่างแดนดิน,63332,64333,127665,63382,64369,127751,38120
2565,47,สกลนคร,4713,อำเภอส่องดาว,15036,14611,29647,15047,14619,29666,7837
2565,47,สกลนคร,4714,อำเภอเต่างอย,12162,12115,24277,12170,12120,24290,8945
2565,47,สกลนคร,4715,อำเภอโคกศรีสุพรรณ,10827,10948,21775,10833,10951,21784,7829
2565,47,สกลนคร,4716,อำเภอเจริญศิลป์,19316,19056,38372,19331,19062,38393,10881
2565,47,สกลนคร,4717,อำเภอโพนนาแก้ว,18519,18467,36986,18533,18476,37009,14201
2565,47,สกลนคร,4718,อำเภอภูพาน,18054,17775,35829,18075,17783,35858,10630
2565,47,สกลนคร,4751,สาขาตำบลกุดเรือคำ อำเภอวานรนิวาส,0,0,0,0,0,0,0
2565,47,สกลนคร,4779,ท้องถิ่นเทศบาลตำบลคำบ่อ,6808,6973,13781,6811,6975,13786,4220
2565,47,สกลนคร,4780,ท้องถิ่นเทศบาลตำบลตองโขบ,6235,6415,12650,6241,6418,12659,5883
2565,47,สกลนคร,4781,ท้องถิ่นเทศบาลตำบลบงใต้,5103,5023,10126,5106,5024,10130,3065
2565,47,สกลนคร,4782,ท้องถิ่นเทศบาลตำบลสามัคคีพัฒนา,4456,4552,9008,4458,4552,9010,2470
2565,47,สกลนคร,4783,ท้องถิ่นเทศบาลตำบลเชียงเครือ,8057,8406,16463,8062,8409,16471,6239
2565,47,สกลนคร,4784,ท้องถิ่นเทศบาลตำบลเจริญศิลป์,3331,3461,6792,3331,3462,6793,2378
2565,47,สกลนคร,4785,ท้องถิ่นเทศบาลตำบลส่องดาว,2449,2445,4894,2450,2446,4896,1635
2565,47,สกลนคร,4786,ท้องถิ่นเทศบาลตำบลสว่างแดนดิน,3818,4193,8011,3829,4213,8042,4931
2565,47,สกลนคร,4787,ท้องถิ่นเทศบาลตำบลดอนเขือง,2038,2099,4137,2039,2100,4139,1294
2565,47,สกลนคร,4788,ท้องถิ่นเทศบาลตำบลอากาศอำนวย,4344,4579,8923,4346,4582,8928,3104
2565,47,สกลนคร,4789,ท้องถิ่นเทศบาลตำบลบ้านม่วง,1704,1847,3551,1710,1849,3559,1514
2565,47,สกลนคร,4790,ท้องถิ่นเทศบาลตำบลคำตากล้า,3520,3678,7198,3529,3682,7211,2370
2565,47,สกลนคร,4791,ท้องถิ่นเทศบาลตำบลวานรนิวาส,2670,2978,5648,2673,2981,5654,2388
2565,47,สกลนคร,4792,ท้องถิ่นเทศบาลตำบลวาริชภูมิ,1346,1412,2758,1347,1412,2759,1385
2565,47,สกลนคร,4793,ท้องถิ่นเทศบาลตำบลพังโคน,3099,3229,6328,3123,3239,6362,4074
2565,47,สกลนคร,4794,ท้องถิ่นเทศบาลตำบลพรรณานิคม,1139,1253,2392,1141,1254,2395,1479
2565,47,สกลนคร,4795,ท้องถิ่นเทศบาลตำบลกุดบาก,2459,2610,5069,2461,2612,5073,1923
2565,47,สกลนคร,4796,ท้องถิ่นเทศบาลตำบลกุสุมาลย์,1964,2076,4040,1969,2077,4046,1746
2565,47,สกลนคร,4797,ท้องถิ่นเทศบาลตำบลท่าแร่,3156,3396,6552,3167,3401,6568,2346
2565,47,สกลนคร,4798,ท้องถิ่นเทศบาลตำบลดงมะไฟ,2778,3083,5861,2780,3086,5866,2302
2565,47,สกลนคร,4799,ท้องถิ่นเทศบาลนครสกลนคร,24462,25950,50412,24583,26073,50656,29373
2565,48,นครพนม,4801,อำเภอเมืองนครพนม,59128,58288,117416,59271,58458,117729,37230
2565,48,นครพนม,4802,อำเภอปลาปาก,25458,25125,50583,25487,25146,50633,16709
2565,48,นครพนม,4803,อำเภอท่าอุเทน,27472,27149,54621,27542,27248,54790,16227
2565,48,นครพนม,4804,อำเภอบ้านแพง,13343,13164,26507,13378,13223,26601,8455
2565,48,นครพนม,4805,อำเภอธาตุพนม,35450,36151,71601,35566,36255,71821,22468
2565,48,นครพนม,4806,อำเภอเรณูนคร,20757,20784,41541,20791,20798,41589,13334
2565,48,นครพนม,4807,อำเภอนาแก,35886,36404,72290,35937,36428,72365,22115
2565,48,นครพนม,4808,อำเภอศรีสงคราม,32119,32422,64541,32156,32468,64624,19786
2565,48,นครพนม,4809,อำเภอนาหว้า,19940,19962,39902,19956,19977,39933,13638
2565,48,นครพนม,4810,อำเภอโพนสวรรค์,26337,26386,52723,26353,26396,52749,17380
2565,48,นครพนม,4811,อำเภอนาทม,11884,11809,23693,11899,11817,23716,7739
2565,48,นครพนม,4812,อำเภอวังยาง,7889,7727,15616,7894,7727,15621,4876
2565,48,นครพนม,4890,ท้องถิ่นเทศบาลตำบลปลาปาก,1860,1986,3846,1861,1988,3849,1609
2565,48,นครพนม,4891,ท้องถิ่นเทศบาลตำบลโพนสวรรค์,2668,2666,5334,2673,2667,5340,1905
2565,48,นครพนม,4892,ท้องถิ่นเทศบาลตำบลนาหว้า,5952,6162,12114,5974,6166,12140,4359
2565,48,นครพนม,4893,ท้องถิ่นเทศบาลตำบลศรีสงคราม,2401,2539,4940,2407,2550,4957,2598
2565,48,นครพนม,4894,ท้องถิ่นเทศบาลตำบลนาแก,2001,2267,4268,2006,2267,4273,2366
2565,48,นครพนม,4895,ท้องถิ่นเทศบาลตำบลเรณูนคร,2057,2330,4387,2066,2338,4404,1729
2565,48,นครพนม,4896,ท้องถิ่นเทศบาลตำบลธาตุพนม,4768,5103,9871,4781,5113,9894,4178
2565,48,นครพนม,4897,ท้องถิ่นเทศบาลตำบลบ้านแพง,4282,4383,8665,4304,4435,8739,3693
2565,48,นครพนม,4898,ท้องถิ่นเทศบาลตำบลท่าอุเทน,2295,2406,4701,2315,2454,4769,2001
2565,48,นครพนม,4899,ท้องถิ่นเทศบาลเมืองนครพนม,12069,13714,25783,12217,13894,26111,15466
2565,49,มุกดาหาร,4901,อำเภอเมืองมุกดาหาร,40238,39627,79865,40399,39810,80209,27534
2565,49,มุกดาหาร,4902,อำเภอนิคมคำสร้อย,16952,17100,34052,16982,17109,34091,10349
2565,49,มุกดาหาร,4903,อำเภอดอนตาล,19444,19206,38650,19533,19352,38885,12041
2565,49,มุกดาหาร,4904,อำเภอดงหลวง,19733,19386,39119,19744,19398,39142,12514
2565,49,มุกดาหาร,4905,อำเภอคำชะอี,22113,22262,44375,22142,22277,44419,14831
2565,49,มุกดาหาร,4906,อำเภอหว้านใหญ่,9887,9896,19783,9951,10019,19970,6540
2565,49,มุกดาหาร,4907,อำเภอหนองสูง,10321,10404,20725,10328,10410,20738,7497
2565,49,มุกดาหาร,4989,ท้องถิ่นเทศบาลตำบลร่มเกล้า,1699,1628,3327,1702,1629,3331,1086
2565,49,มุกดาหาร,4993,ท้องถิ่นเทศบาลตำบลบ้านแก้ง,1504,1525,3029,1534,1564,3098,987
2565,49,มุกดาหาร,4994,ท้องถิ่นเทศบาลตำบลคำอาฮวน,6502,6416,12918,6524,6426,12950,4885
2565,49,มุกดาหาร,4995,ท้องถิ่นเทศบาลตำบลดงเย็น,5480,5304,10784,5487,5316,10803,3123
2565,49,มุกดาหาร,4996,ท้องถิ่นเทศบาลตำบลคำชะอี,1149,1159,2308,1151,1161,2312,1142
2565,49,มุกดาหาร,4997,ท้องถิ่นเทศบาลตำบลดอนตาล,1142,1311,2453,1168,1337,2505,978
2565,49,มุกดาหาร,4998,ท้องถิ่นเทศบาลตำบลนิคมคำสร้อย,3010,3145,6155,3019,3147,6166,2390
2565,49,มุกดาหาร,4999,ท้องถิ่นเทศบาลเมืองมุกดาหาร,14908,16099,31007,15878,17091,32969,16461
2565,50,เชียงใหม่,5001,อำเภอเมืองเชียงใหม่,6623,7559,14182,6817,7694,14511,11673
2565,50,เชียงใหม่,5002,อำเภอจอมทอง,27744,28777,56521,27941,28936,56877,20571
2565,50,เชียงใหม่,5003,อำเภอแม่แจ่ม,29062,28246,57308,29277,28403,57680,18732
2565,50,เชียงใหม่,5004,อำเภอเชียงดาว,10924,11503,22427,13628,14228,27856,11785
2565,50,เชียงใหม่,5005,อำเภอดอยสะเก็ด,21893,24292,46185,22343,24593,46936,23547
2565,50,เชียงใหม่,5006,อำเภอแม่แตง,24874,25462,50336,29678,30115,59793,25242
2565,50,เชียงใหม่,5007,อำเภอแม่ริม,37480,39927,77407,41378,43410,84788,39303
2565,50,เชียงใหม่,5008,อำเภอสะเมิง,9179,8850,18029,9319,8979,18298,6244
2565,50,เชียงใหม่,5009,อำเภอฝาง,40433,42161,82594,55871,56862,112733,41847
2565,50,เชียงใหม่,5010,อำเภอแม่อาย,28352,28834,57186,33813,33853,67666,26457
2565,50,เชียงใหม่,5011,อำเภอพร้าว,17873,18314,36187,18152,18594,36746,15884
2565,50,เชียงใหม่,5012,อำเภอสันป่าตอง,27504,31245,58749,27730,31450,59180,26281
2565,50,เชียงใหม่,5013,อำเภอสันกำแพง,20106,22843,42949,20425,23036,43461,23589
2565,50,เชียงใหม่,5014,อำเภอสันทราย,9321,10609,19930,9923,11210,21133,10849
2565,50,เชียงใหม่,5015,อำเภอหางดง,35450,40620,76070,36361,41088,77449,45897
2565,50,เชียงใหม่,5016,อำเภอฮอด,12481,12750,25231,12529,12795,25324,9835
2565,50,เชียงใหม่,5017,อำเภอดอยเต่า,11268,11396,22664,11282,11415,22697,8845
2565,50,เชียงใหม่,5018,อำเภออมก๋อย,30964,30563,61527,31099,30699,61798,23434
2565,50,เชียงใหม่,5019,อำเภอสารภี,21961,25276,47237,22425,25657,48082,24215
2565,50,เชียงใหม่,5020,อำเภอเวียงแหง,9966,9339,19305,27397,26902,54299,9790
2565,50,เชียงใหม่,5021,อำเภอไชยปราการ,11804,11796,23600,17642,17682,35324,11924
2565,50,เชียงใหม่,5022,อำเภอแม่วาง,13405,13647,27052,13649,13859,27508,10128
2565,50,เชียงใหม่,5023,อำเภอแม่ออน,10211,10460,20671,10358,10579,20937,9763
2565,50,เชียงใหม่,5024,อำเภอดอยหล่อ,11751,12590,24341,11969,12798,24767,11762
2565,50,เชียงใหม่,5025,อำเภอกัลยาณิวัฒนา,6636,6257,12893,6659,6266,12925,4526
2565,50,เชียงใหม่,5040,ท้องถิ่นเทศบาลตำบลบวกค้าง,4020,4520,8540,4097,4581,8678,4156
2565,50,เชียงใหม่,5041,ท้องถิ่นเทศบาลตำบลบ่อหลวง,5973,5966,11939,6001,6000,12001,3921
2565,50,เชียงใหม่,5042,ท้องถิ่นเทศบาลตำบลป่าไผ่,6861,7700,14561,7011,7823,14834,6764
2565,50,เชียงใหม่,5043,ท้องถิ่นเทศบาลตำบลสันนาเม็ง,5894,7091,12985,6097,7233,13330,8491
2565,50,เชียงใหม่,5044,ท้องถิ่นเทศบาลตำบลสันพระเนตร,2800,3316,6116,2865,3360,6225,3447
2565,50,เชียงใหม่,5046,ท้องถิ่นเทศบาลตำบลสันปูเลย,7999,9407,17406,8171,9497,17668,9898
2565,50,เชียงใหม่,5049,ท้องถิ่นเทศบาลตำบลเชิงดอย,3646,3996,7642,3753,4083,7836,3811
2565,50,เชียงใหม่,5050,ท้องถิ่นเทศบาลตำบลเมืองนะ,11591,11515,23106,18706,19466,38172,9637
2565,50,เชียงใหม่,5054,ท้องถิ่นเทศบาลตำบลทุ่งข้าวพวง,3298,3240,6538,5585,5491,11076,3128
2565,50,เชียงใหม่,5055,ท้องถิ่นเทศบาลตำบลปิงโค้ง,6587,5646,12233,7617,6648,14265,4650
2565,50,เชียงใหม่,5056,ท้องถิ่นเทศบาลตำบลพระธาตุปู่ก่ำ,980,1022,2002,1171,1208,2379,1153
2565,50,เชียงใหม่,5057,ท้องถิ่นเทศบาลเมืองแม่เหียะ,8647,10742,19389,8877,10854,19731,14083
2565,50,เชียงใหม่,5058,ท้องถิ่นเทศบาลตำบลสารภี,2858,3322,6180,3266,3711,6977,2764
2565,50,เชียงใหม่,5059,ท้องถิ่นเทศบาลตำบลฟ้าฮ่าม,3134,3740,6874,3218,3804,7022,9671
2565,50,เชียงใหม่,5060,ท้องถิ่นเทศบาลตำบลหนองจ๊อม,7606,9233,16839,7850,9425,17275,9496
2565,50,เชียงใหม่,5061,ท้องถิ่นเทศบาลตำบลหนองหอย,3454,4248,7702,3540,4297,7837,5647
2565,50,เชียงใหม่,5062,ท้องถิ่นเทศบาลตำบลแม่แฝก,4167,4770,8937,4206,4808,9014,3999
2565,50,เชียงใหม่,5063,ท้องถิ่นเทศบาลตำบลท่าศาลา,3175,3771,6946,3313,3844,7157,5525
2565,50,เชียงใหม่,5064,ท้องถิ่นเทศบาลตำบลหนองผึ้ง,7252,8573,15825,7396,8671,16067,9056
2565,50,เชียงใหม่,5065,ท้องถิ่นเทศบาลตำบลเจดีย์แม่ครัว,3840,4294,8134,3903,4341,8244,4133
2565,50,เชียงใหม่,5066,ท้องถิ่นเทศบาลตำบลแม่ปั๋ง,2948,3038,5986,2982,3078,6060,2668
2565,50,เชียงใหม่,5067,ท้องถิ่นเทศบาลตำบลชมภู,3682,3970,7652,3729,4026,7755,3285
2565,50,เชียงใหม่,5068,ท้องถิ่นเทศบาลตำบลป่าแดด,8010,9465,17475,8188,9591,17779,11281
2565,50,เชียงใหม่,5069,ท้องถิ่นเทศบาลเมืองสุเทพ,8299,8432,16731,8509,8588,17097,11589
2565,50,เชียงใหม่,5070,ท้องถิ่นเทศบาลตำบลหนองป่าครั่ง,3212,3779,6991,3394,3927,7321,6192
2565,50,เชียงใหม่,5071,ท้องถิ่นเทศบาลตำบลแม่วาง,2112,2371,4483,2142,2399,4541,2273
2565,50,เชียงใหม่,5072,ท้องถิ่นเทศบาลตำบลไชยปราการ,7025,7788,14813,7400,8147,15547,6672
2565,50,เชียงใหม่,5073,ท้องถิ่นเทศบาลตำบลยางเนิ้ง,4831,5831,10662,4873,5856,10729,5840
2565,50,เชียงใหม่,5074,ท้องถิ่นเทศบาลตำบลอมก๋อย,552,514,1066,558,516,1074,837
2565,50,เชียงใหม่,5075,ท้องถิ่นเทศบาลตำบลท่าเดื่อ-มืดกา,2026,2176,4202,2040,2184,4224,1890
2565,50,เชียงใหม่,5076,ท้องถิ่นเทศบาลตำบลท่าข้าม,2682,2921,5603,2696,2932,5628,3569
2565,50,เชียงใหม่,5077,ท้องถิ่นเทศบาลตำบลหางดง,2616,3331,5947,3196,3851,7047,3925
2565,50,เชียงใหม่,5078,ท้องถิ่นเทศบาลตำบลหนองตองพัฒนา,3794,4428,8222,3812,4437,8249,3570
2565,50,เชียงใหม่,5079,ท้องถิ่นเทศบาลตำบลสันทรายหลวง,12701,15557,28258,13077,15771,28848,15956
2565,50,เชียงใหม่,5080,ท้องถิ่นเทศบาลเมืองแม่โจ้,9866,12140,22006,10885,12980,23865,14738
2565,50,เชียงใหม่,5081,ท้องถิ่นเทศบาลตำบลสันกำแพง,7944,9379,17323,8086,9439,17525,9287
2565,50,เชียงใหม่,5082,ท้องถิ่นเทศบาลเมืองต้นเปา,8839,10725,19564,9014,10875,19889,13807
2565,50,เชียงใหม่,5083,ท้องถิ่นเทศบาลตำบลสันป่าตอง,1991,2363,4354,2001,2369,4370,2815
2565,50,เชียงใหม่,5084,ท้องถิ่นเทศบาลตำบลบ้านกลาง,4777,5433,10210,4808,5458,10266,5529
2565,50,เชียงใหม่,5085,ท้องถิ่นเทศบาลตำบลเวียงพร้าว,2103,2459,4562,2142,2493,4635,2876
2565,50,เชียงใหม่,5086,ท้องถิ่นเทศบาลตำบลแม่อาย,4318,4744,9062,5044,5488,10532,4479
2565,50,เชียงใหม่,5087,ท้องถิ่นเทศบาลตำบลเวียงฝาง,2746,3165,5911,4065,4459,8524,3997
2565,50,เชียงใหม่,5088,ท้องถิ่นเทศบาลตำบลบ้านแม่ข่า,895,931,1826,912,950,1862,889
2565,50,เชียงใหม่,5089,ท้องถิ่นเทศบาลตำบลสะเมิงใต้,2492,2546,5038,2650,2700,5350,2688
2565,50,เชียงใหม่,5090,ท้องถิ่นเทศบาลตำบลแม่ริม,4270,4906,9176,4338,4939,9277,5886
2565,50,เชียงใหม่,5091,ท้องถิ่นเทศบาลตำบลสันมหาพน,3683,4219,7902,3881,4422,8303,5161
2565,50,เชียงใหม่,5092,ท้องถิ่นเทศบาลเมืองเมืองแกนพัฒนา,5794,6401,12195,5869,6468,12337,5807
2565,50,เชียงใหม่,5093,ท้องถิ่นเทศบาลตำบลดอยสะเก็ด,1809,2100,3909,1937,2228,4165,2166
2565,50,เชียงใหม่,5094,ท้องถิ่นเทศบาลตำบลเมืองงาย,1678,1943,3621,1758,2006,3764,1998
2565,50,เชียงใหม่,5095,ท้องถิ่นเทศบาลตำบลเชียงดาว,1772,2008,3780,1790,2024,3814,2374
2565,50,เชียงใหม่,5096,ท้องถิ่นเทศบาลตำบลแม่แจ่ม,1247,1298,2545,1261,1309,2570,1635
2565,50,เชียงใหม่,5097,ท้องถิ่นเทศบาลตำบลจอมทอง,4155,4863,9018,4176,4877,9053,4603
2565,50,เชียงใหม่,5098,ท้องถิ่นเทศบาลตำบลช้างเผือก,3959,4589,8548,4139,4693,8832,9180
2565,50,เชียงใหม่,5099,ท้องถิ่นเทศบาลนครเชียงใหม่,51859,59932,111791,54679,62407,117086,91660
2565,51,ลำพูน,5101,อำเภอเมืองลำพูน,27702,30998,58700,28206,31427,59633,28880
2565,51,ลำพูน,5102,อำเภอแม่ทา,12110,12522,24632,12149,12545,24694,10880
2565,51,ลำพูน,5103,อำเภอบ้านโฮ่ง,12395,13079,25474,12440,13115,25555,10438
2565,51,ลำพูน,5104,อำเภอลี้,30585,30346,60931,30666,30454,61120,21708
2565,51,ลำพูน,5105,อำเภอทุ่งหัวช้าง,8829,8771,17600,8830,8772,17602,6574
2565,51,ลำพูน,5106,อำเภอป่าซาง,13413,14358,27771,13606,14562,28168,13030
2565,51,ลำพูน,5107,อำเภอบ้านธิ,3705,4146,7851,3787,4209,7996,3442
2565,51,ลำพูน,5108,อำเภอเวียงหนองล่อง,0,0,0,0,0,0,0
2565,51,ลำพูน,5176,ท้องถิ่นเทศบาลตำบลศรีเตี้ย,2578,2821,5399,2586,2832,5418,2266
2565,51,ลำพูน,5177,ท้องถิ่นเทศบาลตำบลทาสบชัย,2391,2505,4896,2422,2532,4954,2323
2565,51,ลำพูน,5178,ท้องถิ่นเทศบาลตำบลหนองล่อง,2621,2839,5460,2629,2846,5475,2573
2565,51,ลำพูน,5179,ท้องถิ่นเทศบาลตำบลหนองยวง,1705,1877,3582,1725,1892,3617,1810
2565,51,ลำพูน,5180,ท้องถิ่นเทศบาลตำบลมะกอก,2421,2733,5154,2431,2737,5168,2408
2565,51,ลำพูน,5181,ท้องถิ่นเทศบาลตำบลมะเขือแจ้,7645,8457,16102,7714,8525,16239,9032
2565,51,ลำพูน,5182,ท้องถิ่นเทศบาลตำบลเวียงยอง,3238,3756,6994,3284,3789,7073,3744
2565,51,ลำพูน,5183,ท้องถิ่นเทศบาลตำบลบ้านกลาง,5301,6199,11500,5339,6234,11573,11403
2565,51,ลำพูน,5184,ท้องถิ่นเทศบาลตำบลเหมืองง่า,7287,8734,16021,7326,8764,16090,8553
2565,51,ลำพูน,5185,ท้องถิ่นเทศบาลตำบลแม่แรง,3324,3631,6955,3337,3636,6973,2743
2565,51,ลำพูน,5186,ท้องถิ่นเทศบาลตำบลบ้านธิ,4342,4821,9163,4462,4941,9403,4454
2565,51,ลำพูน,5187,ท้องถิ่นเทศบาลตำบลวังผาง,3542,3951,7493,3554,3958,7512,3288
2565,51,ลำพูน,5188,ท้องถิ่นเทศบาลตำบลม่วงน้อย,1898,2232,4130,1902,2233,4135,2004
2565,51,ลำพูน,5189,ท้องถิ่นเทศบาลตำบลป่าซาง,3750,4473,8223,3770,4486,8256,4253
2565,51,ลำพูน,5190,ท้องถิ่นเทศบาลตำบลทุ่งหัวช้าง,1259,1273,2532,1260,1276,2536,1267
2565,51,ลำพูน,5191,ท้องถิ่นเทศบาลตำบลวังดิน,2050,2197,4247,2057,2211,4268,2759
2565,51,ลำพูน,5192,ท้องถิ่นเทศบาลตำบลแม่ตืน,1589,1751,3340,1621,1786,3407,1362
2565,51,ลำพูน,5193,ท้องถิ่นเทศบาลตำบลบ้านโฮ่ง,3430,4035,7465,3452,4050,7502,3669
2565,51,ลำพูน,5194,ท้องถิ่นเทศบาลตำบลทาสบเส้า,2517,2686,5203,2546,2710,5256,2568
2565,51,ลำพูน,5195,ท้องถิ่นเทศบาลตำบลทากาศ,1366,1523,2889,1373,1526,2899,1415
2565,51,ลำพูน,5196,ท้องถิ่นเทศบาลตำบลอุโมงค์,5884,6766,12650,5955,6829,12784,6118
2565,51,ลำพูน,5197,ท้องถิ่นเทศบาลตำบลริมปิง,3114,3551,6665,3132,3571,6703,2963
2565,51,ลำพูน,5198,ท้องถิ่นเทศบาลตำบลบ้านแป้น,2866,3350,6216,2889,3372,6261,2889
2565,51,ลำพูน,5199,ท้องถิ่นเทศบาลเมืองลำพูน,5113,6118,11231,5146,6141,11287,7245
2565,52,ลำปาง,5201,อำเภอเมืองลำปาง,43926,45862,89788,44030,45939,89969,39241
2565,52,ลำปาง,5202,อำเภอแม่เมาะ,12014,11898,23912,12037,11924,23961,9227
2565,52,ลำปาง,5203,อำเภอเกาะคา,17178,18408,35586,17204,18432,35636,13452
2565,52,ลำปาง,5204,อำเภอเสริมงาม,10980,10952,21932,11004,10971,21975,7745
2565,52,ลำปาง,5205,อำเภองาว,23909,24041,47950,24078,24230,48308,18342
2565,52,ลำปาง,5206,อำเภอแจ้ห่ม,16873,17424,34297,16950,17478,34428,13301
2565,52,ลำปาง,5207,อำเภอวังเหนือ,17858,17692,35550,18302,18196,36498,13531
2565,52,ลำปาง,5208,อำเภอเถิน,16272,16726,32998,16288,16759,33047,11609
2565,52,ลำปาง,5209,อำเภอแม่พริก,4572,4675,9247,4572,4682,9254,3253
2565,52,ลำปาง,5210,อำเภอแม่ทะ,13631,13983,27614,13642,13992,27634,10864
2565,52,ลำปาง,5211,อำเภอสบปราบ,10282,10643,20925,10288,10655,20943,6717
2565,52,ลำปาง,5212,อำเภอห้างฉัตร,23185,24058,47243,23252,24099,47351,19709
2565,52,ลำปาง,5213,อำเภอเมืองปาน,16160,16190,32350,16173,16210,32383,12349
2565,52,ลำปาง,5275,ท้องถิ่นเทศบาลตำบลน้ำโจ้,4651,4821,9472,4657,4825,9482,3542
2565,52,ลำปาง,5276,ท้องถิ่นเทศบาลตำบลแม่ทะ,3178,3267,6445,3182,3270,6452,3012
2565,52,ลำปาง,5279,ท้องถิ่นเทศบาลตำบลนาแก้ว,4295,4514,8809,4300,4516,8816,3166
2565,52,ลำปาง,5280,ท้องถิ่นเทศบาลตำบลลำปางหลวง,4331,4767,9098,4337,4771,9108,3375
2565,52,ลำปาง,5281,ท้องถิ่นเทศบาลตำบลสิริราช,2335,2242,4577,2338,2243,4581,1609
2565,52,ลำปาง,5282,ท้องถิ่นเทศบาลตำบลแม่เมาะ,7383,7757,15140,7394,7764,15158,8796
2565,52,ลำปาง,5283,ท้องถิ่นเทศบาลตำบลเวียงมอก,5024,5116,10140,5028,5123,10151,3560
2565,52,ลำปาง,5284,ท้องถิ่นเทศบาลตำบลห้างฉัตร,1218,1513,2731,1219,1515,2734,1315
2565,52,ลำปาง,5285,ท้องถิ่นเทศบาลตำบลสบปราบ,2589,2878,5467,2590,2879,5469,2102
2565,52,ลำปาง,5286,ท้องถิ่นเทศบาลตำบลป่าตันนาครัว,3753,3979,7732,3756,3979,7735,3009
2565,52,ลำปาง,5287,ท้องถิ่นเทศบาลตำบลแม่พริก,1201,1330,2531,1201,1330,2531,1142
2565,52,ลำปาง,5288,ท้องถิ่นเทศบาลตำบลแม่ปุ,1779,1984,3763,1783,1985,3768,1355
2565,52,ลำปาง,5289,ท้องถิ่นเทศบาลเมืองล้อมแรด,6423,7469,13892,6453,7500,13953,7207
2565,52,ลำปาง,5290,ท้องถิ่นเทศบาลตำบลวังเหนือ,1963,1991,3954,1976,1996,3972,2001
2565,52,ลำปาง,5291,ท้องถิ่นเทศบาลตำบลบ้านใหม่,1243,1266,2509,1244,1268,2512,897
2565,52,ลำปาง,5292,ท้องถิ่นเทศบาลตำบลแจ้ห่ม,1601,1798,3399,1604,1798,3402,1686
2565,52,ลำปาง,5293,ท้องถิ่นเทศบาลตำบลเสริมงาม,4015,4116,8131,4019,4119,8138,3059
2565,52,ลำปาง,5294,ท้องถิ่นเทศบาลตำบลหลวงเหนือ,1919,2152,4071,1926,2155,4081,2368
2565,52,ลำปาง,5295,ท้องถิ่นเทศบาลตำบลเกาะคา,2054,2397,4451,2077,2417,4494,2384
2565,52,ลำปาง,5296,ท้องถิ่นเทศบาลเมืองพิชัย,6167,7003,13170,6192,7010,13202,6571
2565,52,ลำปาง,5297,ท้องถิ่นเทศบาลตำบลบ่อแฮ้ว,4389,4934,9323,4404,4949,9353,4354
2565,52,ลำปาง,5298,ท้องถิ่นเทศบาลเมืองเขลางค์นคร,27901,31053,58954,27974,31091,59065,26494
2565,52,ลำปาง,5299,ท้องถิ่นเทศบาลนครลำปาง,21864,26959,48823,22100,27146,49246,29821
2565,53,อุตรดิตถ์,5301,อำเภอเมืองอุตรดิตถ์,22267,23433,45700,22284,23450,45734,18149
2565,53,อุตรดิตถ์,5302,อำเภอตรอน,14313,15201,29514,14321,15210,29531,10216
2565,53,อุตรดิตถ์,5303,อำเภอท่าปลา,14288,14443,28731,14303,14457,28760,9984
2565,53,อุตรดิตถ์,5304,อำเภอน้ำปาด,16441,16415,32856,16481,16503,32984,12156
2565,53,อุตรดิตถ์,5305,อำเภอฟากท่า,6422,6777,13199,6428,6795,13223,5195
2565,53,อุตรดิตถ์,5306,อำเภอบ้านโคก,5184,4924,10108,5304,5149,10453,4582
2565,53,อุตรดิตถ์,5307,อำเภอพิชัย,34422,36564,70986,34450,36584,71034,26122
2565,53,อุตรดิตถ์,5308,อำเภอลับแล,17888,18284,36172,17895,18290,36185,15285
2565,53,อุตรดิตถ์,5309,อำเภอทองแสนขัน,13030,13350,26380,13034,13352,26386,9628
2565,53,อุตรดิตถ์,5377,ท้องถิ่นเทศบาลตำบลท่าเสา,7477,7273,14750,7489,7278,14767,7743
2565,53,อุตรดิตถ์,5378,ท้องถิ่นเทศบาลตำบลน้ำริด,3369,3509,6878,3371,3510,6881,2634
2565,53,อุตรดิตถ์,5379,ท้องถิ่นเทศบาลตำบลหาดกรวด,3625,3895,7520,3636,3899,7535,2674
2565,53,อุตรดิตถ์,5380,ท้องถิ่นเทศบาลตำบลจริม,4273,4130,8403,4275,4131,8406,2342
2565,53,อุตรดิตถ์,5381,ท้องถิ่นเทศบาลตำบลคุ้งตะเภา,4219,4540,8759,4225,4544,8769,3544
2565,53,อุตรดิตถ์,5382,ท้องถิ่นเทศบาลตำบลผาจุก,3832,4105,7937,3835,4108,7943,3096
2565,53,อุตรดิตถ์,5383,ท้องถิ่นเทศบาลตำบลบ้านเกาะ,4322,4949,9271,4337,4955,9292,3891
2565,53,อุตรดิตถ์,5384,ท้องถิ่นเทศบาลตำบลทองแสนขัน,2159,2325,4484,2162,2327,4489,1839
2565,53,อุตรดิตถ์,5385,ท้องถิ่นเทศบาลตำบลหัวดง,2669,2794,5463,2670,2794,5464,2185
2565,53,อุตรดิตถ์,5386,ท้องถิ่นเทศบาลตำบลทุ่งยั้ง,4523,5229,9752,4532,5230,9762,4164
2565,53,อุตรดิตถ์,5387,ท้องถิ่นเทศบาลตำบลในเมือง,814,980,1794,821,981,1802,1013
2565,53,อุตรดิตถ์,5388,ท้องถิ่นเทศบาลตำบลท่าสัก,556,614,1170,557,616,1173,575
2565,53,อุตรดิตถ์,5389,ท้องถิ่นเทศบาลตำบลบ้านโคก,1867,1749,3616,1943,1928,3871,1929
2565,53,อุตรดิตถ์,5390,ท้องถิ่นเทศบาลตำบลฟากท่า,381,351,732,381,351,732,431
2565,53,อุตรดิตถ์,5391,ท้องถิ่นเทศบาลตำบลน้ำปาด,1355,1477,2832,1357,1482,2839,1607
2565,53,อุตรดิตถ์,5392,ท้องถิ่นเทศบาลตำบลร่วมจิต,1589,1758,3347,1589,1759,3348,1207
2565,53,อุตรดิตถ์,5393,ท้องถิ่นเทศบาลตำบลท่าปลา,1045,1170,2215,1049,1170,2219,967
2565,53,อุตรดิตถ์,5394,ท้องถิ่นเทศบาลตำบลบ้านแก่ง,994,1078,2072,994,1079,2073,898
2565,53,อุตรดิตถ์,5395,ท้องถิ่นเทศบาลตำบลตรอน,811,874,1685,812,874,1686,689
2565,53,อุตรดิตถ์,5396,ท้องถิ่นเทศบาลตำบลวังกะพี้,4439,5038,9477,4446,5042,9488,3464
2565,53,อุตรดิตถ์,5397,ท้องถิ่นเทศบาลตำบลบ้านด่านนาขาม,1852,1944,3796,1853,1944,3797,1396
2565,53,อุตรดิตถ์,5398,ท้องถิ่นเทศบาลตำบลศรีพนมมาศ,1339,1542,2881,1341,1542,2883,1202
2565,53,อุตรดิตถ์,5399,ท้องถิ่นเทศบาลเมืองอุตรดิตถ์,13419,15920,29339,13473,15967,29440,14931
2565,54,แพร่,5401,อำเภอเมืองแพร่,29173,32756,61929,29222,32780,62002,27997
2565,54,แพร่,5402,อำเภอร้องกวาง,16865,18208,35073,16905,18260,35165,12881
2565,54,แพร่,5403,อำเภอลอง,15001,15261,30262,15021,15270,30291,11569
2565,54,แพร่,5404,อำเภอสูงเม่น,32402,35604,68006,32427,35630,68057,28262
2565,54,แพร่,5405,อำเภอเด่นชัย,10004,9568,19572,10011,9578,19589,8540
2565,54,แพร่,5406,อำเภอสอง,20342,21266,41608,20383,21291,41674,16404
2565,54,แพร่,5407,อำเภอวังชิ้น,20956,21138,42094,21010,21189,42199,15545
2565,54,แพร่,5408,อำเภอหนองม่วงไข่,5862,6718,12580,5867,6722,12589,5104
2565,54,แพร่,5482,ท้องถิ่นเทศบาลตำบลแม่ลานนา,3144,3292,6436,3147,3295,6442,2696
2565,54,แพร่,5483,ท้องถิ่นเทศบาลตำบลแม่ปาน,1445,1454,2899,1445,1454,2899,1160
2565,54,แพร่,5484,ท้องถิ่นเทศบาลตำบลเวียงต้า,3146,3099,6245,3148,3100,6248,2468
2565,54,แพร่,5485,ท้องถิ่นเทศบาลตำบลป่าแมต,5579,6407,11986,5588,6409,11997,5039
2565,54,แพร่,5486,ท้องถิ่นเทศบาลตำบลแม่คำมี,3461,3609,7070,3462,3609,7071,2736
2565,54,แพร่,5487,ท้องถิ่นเทศบาลตำบลหนองม่วงไข่,2005,2349,4354,2005,2351,4356,1905
2565,54,แพร่,5488,ท้องถิ่นเทศบาลตำบลวังชิ้น,1378,1464,2842,1383,1464,2847,1447
2565,54,แพร่,5489,ท้องถิ่นเทศบาลตำบลสอง,2936,3551,6487,2945,3556,6501,3148
2565,54,แพร่,5490,ท้องถิ่นเทศบาลตำบลแม่จั๊วะ,1762,1917,3679,1768,1919,3687,1576
2565,54,แพร่,5491,ท้องถิ่นเทศบาลตำบลเด่นชัย,5108,5693,10801,5120,5698,10818,5239
2565,54,แพร่,5492,ท้องถิ่นเทศบาลตำบลสูงเม่น,1716,1955,3671,1718,1958,3676,1923
2565,54,แพร่,5493,ท้องถิ่นเทศบาลตำบลห้วยอ้อ,2201,2510,4711,2208,2510,4718,2238
2565,54,แพร่,5494,ท้องถิ่นเทศบาลตำบลบ้านปิน,1005,1198,2203,1009,1199,2208,824
2565,54,แพร่,5495,ท้องถิ่นเทศบาลตำบลร้องกวาง,5726,6425,12151,5736,6430,12166,6104
2565,54,แพร่,5496,ท้องถิ่นเทศบาลตำบลแม่หล่าย,2005,2309,4314,2009,2318,4327,2038
2565,54,แพร่,5497,ท้องถิ่นเทศบาลตำบลทุ่งโฮ้ง,2861,3293,6154,2866,3299,6165,3247
2565,54,แพร่,5498,ท้องถิ่นเทศบาลตำบลช่อแฮ,4207,4481,8688,4210,4482,8692,3745
2565,54,แพร่,5499,ท้องถิ่นเทศบาลเมืองแพร่,6514,7680,14194,6561,7724,14285,8840
2565,55,น่าน,5501,อำเภอเมืองน่าน,31290,31573,62863,31388,31676,63064,25464
2565,55,น่าน,5502,อำเภอแม่จริม,8327,8018,16345,8350,8042,16392,4993
2565,55,น่าน,5503,อำเภอบ้านหลวง,5737,5686,11423,5739,5693,11432,3996
2565,55,น่าน,5504,อำเภอนาน้อย,14809,14783,29592,14825,14798,29623,10655
2565,55,น่าน,5505,อำเภอปัว,26613,26993,53606,26665,27086,53751,16344
2565,55,น่าน,5506,อำเภอท่าวังผา,22438,22494,44932,22500,22590,45090,14918
2565,55,น่าน,5507,อำเภอเวียงสา,33208,33041,66249,33305,33151,66456,25160
2565,55,น่าน,5508,อำเภอทุ่งช้าง,7787,7594,15381,7886,7760,15646,5243
2565,55,น่าน,5509,อำเภอเชียงกลาง,8618,8777,17395,8641,8797,17438,5918
2565,55,น่าน,5510,อำเภอนาหมื่น,7103,6984,14087,7107,6989,14096,4563
2565,55,น่าน,5511,อำเภอสันติสุข,8032,7605,15637,8041,7617,15658,5244
2565,55,น่าน,5512,อำเภอบ่อเกลือ,7813,7492,15305,7842,7520,15362,5193
2565,55,น่าน,5513,อำเภอสองแคว,6323,5891,12214,6402,6016,12418,3923
2565,55,น่าน,5514,อำเภอภูเพียง,17632,18096,35728,17663,18126,35789,14007
2565,55,น่าน,5515,อำเภอเฉลิมพระเกียรติ,4946,4734,9680,5005,4784,9789,3424
2565,55,น่าน,5592,ท้องถิ่นเทศบาลตำบลเชียงกลาง,4674,4862,9536,4687,4871,9558,4014
2565,55,น่าน,5593,ท้องถิ่นเทศบาลตำบลทุ่งช้าง,1657,1604,3261,1668,1621,3289,1446
2565,55,น่าน,5594,ท้องถิ่นเทศบาลตำบลเวียงสา,1279,1488,2767,1279,1490,2769,1316
2565,55,น่าน,5595,ท้องถิ่นเทศบาลตำบลท่าวังผา,2449,2706,5155,2459,2725,5184,2786
2565,55,น่าน,5596,ท้องถิ่นเทศบาลตำบลปัว,4951,5337,10288,4980,5366,10346,5069
2565,55,น่าน,5597,ท้องถิ่นเทศบาลตำบลนาน้อย,1100,1240,2340,1102,1243,2345,1244
2565,55,น่าน,5598,ท้องถิ่นเทศบาลตำบลหนองแดง,0,0,0,0,0,0,0
2565,55,น่าน,5599,ท้องถิ่นเทศบาลเมืองน่าน,9366,9597,18963,9407,9637,19044,10897
2565,56,พะเยา,5601,อำเภอเมืองพะเยา,20723,22123,42846,20771,22167,42938,17701
2565,56,พะเยา,5602,อำเภอจุน,8470,9355,17825,8506,9374,17880,7424
2565,56,พะเยา,5603,อำเภอเชียงคำ,27159,27347,54506,27550,27793,55343,21854
2565,56,พะเยา,5604,อำเภอเชียงม่วน,4720,4832,9552,4749,4871,9620,3996
2565,56,พะเยา,5605,อำเภอดอกคำใต้,18301,19340,37641,18347,19389,37736,15075
2565,56,พะเยา,5606,อำเภอปง,19599,19581,39180,19696,19680,39376,12736
2565,56,พะเยา,5607,อำเภอแม่ใจ,9686,10311,19997,9704,10326,20030,9419
2565,56,พะเยา,5608,อำเภอภูซาง,11926,12076,24002,12050,12280,24330,9711
2565,56,พะเยา,5609,อำเภอภูกามยาว,5989,6528,12517,6008,6539,12547,5121
2565,56,พะเยา,5677,ท้องถิ่นเทศบาลตำบลบ้านต๋อม,5693,6702,12395,5810,6805,12615,7434
2565,56,พะเยา,5678,ท้องถิ่นเทศบาลตำบลห้วยลาน,4133,4535,8668,4143,4549,8692,3375
2565,56,พะเยา,5679,ท้องถิ่นเทศบาลตำบลฝายกวาง,4240,4494,8734,4256,4517,8773,3798
2565,56,พะเยา,5680,ท้องถิ่นเทศบาลตำบลเวียงลอ,2926,3160,6086,2933,3168,6101,2690
2565,56,พะเยา,5681,ท้องถิ่นเทศบาลตำบลหงส์หิน,3195,3419,6614,3204,3426,6630,2836
2565,56,พะเยา,5682,ท้องถิ่นเทศบาลตำบลจุน,4349,4613,8962,4362,4619,8981,4054
2565,56,พะเยา,5683,ท้องถิ่นเทศบาลตำบลบ้านเหล่า,3747,3914,7661,3752,3920,7672,2996
2565,56,พะเยา,5684,ท้องถิ่นเทศบาลตำบลแม่กา,6102,6713,12815,6128,6739,12867,6996
2565,56,พะเยา,5685,ท้องถิ่นเทศบาลตำบลแม่ปืม,4348,4562,8910,4351,4571,8922,3482
2565,56,พะเยา,5686,ท้องถิ่นเทศบาลตำบลบ้านต๊ำ,3392,3628,7020,3399,3635,7034,3299
2565,56,พะเยา,5687,ท้องถิ่นเทศบาลตำบลท่าวังทอง,7885,7688,15573,7905,7701,15606,9840
2565,56,พะเยา,5688,ท้องถิ่นเทศบาลตำบลดงเจน,3802,4332,8134,3812,4338,8150,3630
2565,56,พะเยา,5689,ท้องถิ่นเทศบาลตำบลสบบง,3864,4153,8017,3888,4201,8089,3538
2565,56,พะเยา,5690,ท้องถิ่นเทศบาลตำบลแม่ใจ,2334,2555,4889,2338,2557,4895,2214
2565,56,พะเยา,5691,ท้องถิ่นเทศบาลตำบลปง,2585,2888,5473,2595,2895,5490,2838
2565,56,พะเยา,5692,ท้องถิ่นเทศบาลตำบลงิม,3261,3341,6602,3264,3345,6609,2515
2565,56,พะเยา,5693,ท้องถิ่นเทศบาลเมืองดอกคำใต้,5682,6638,12320,5696,6650,12346,5429
2565,56,พะเยา,5694,ท้องถิ่นเทศบาลตำบลบ้านถ้ำ,4055,4045,8100,4057,4047,8104,3329
2565,56,พะเยา,5695,ท้องถิ่นเทศบาลตำบลเชียงม่วน,4216,4331,8547,4225,4338,8563,3912
2565,56,พะเยา,5696,ท้องถิ่นเทศบาลตำบลเวียง,2604,2788,5392,2608,2794,5402,2295
2565,56,พะเยา,5697,ท้องถิ่นเทศบาลตำบลเชียงคำ,2746,3347,6093,2758,3367,6125,3737
2565,56,พะเยา,5698,ท้องถิ่นเทศบาลตำบลห้วยข้าวก่ำ,3869,4230,8099,3879,4242,8121,4357
2565,56,พะเยา,5699,ท้องถิ่นเทศบาลเมืองพะเยา,7285,8504,15789,7319,8525,15844,8305
2565,57,เชียงราย,5701,อำเภอเมืองเชียงราย,49250,54234,103484,52012,57212,109224,54089
2565,57,เชียงราย,5702,อำเภอเวียงชัย,18793,19927,38720,18943,20036,38979,16006
2565,57,เชียงราย,5703,อำเภอเชียงของ,11959,12052,24011,12318,12736,25054,10761
2565,57,เชียงราย,5704,อำเภอเทิง,36240,36970,73210,36848,37618,74466,29433
2565,57,เชียงราย,5705,อำเภอพาน,53026,56242,109268,53846,57088,110934,49084
2565,57,เชียงราย,5706,อำเภอป่าแดด,5795,5944,11739,5803,5951,11754,4146
2565,57,เชียงราย,5707,อำเภอแม่จัน,29179,31061,60240,33878,36378,70256,29007
2565,57,เชียงราย,5708,อำเภอเชียงแสน,21096,21650,42746,23899,25092,48991,22006
2565,57,เชียงราย,5709,อำเภอแม่สาย,22426,24094,46520,35305,39622,74927,30163
2565,57,เชียงราย,5710,อำเภอแม่สรวย,36738,36317,73055,39502,39180,78682,29997
2565,57,เชียงราย,5711,อำเภอเวียงป่าเป้า,28660,29274,57934,30184,30763,60947,25109
2565,57,เชียงราย,5712,อำเภอพญาเม็งราย,13386,13678,27064,13551,13859,27410,10000
2565,57,เชียงราย,5713,อำเภอเวียงแก่น,17492,16776,34268,19063,18786,37849,13738
2565,57,เชียงราย,5714,อำเภอขุนตาล,6871,7146,14017,6892,7161,14053,5636
2565,57,เชียงราย,5715,อำเภอแม่ฟ้าหลวง,28937,28147,57084,38647,39093,77740,25782
2565,57,เชียงราย,5716,อำเภอแม่ลาว,11802,12581,24383,11891,12670,24561,11319
2565,57,เชียงราย,5717,อำเภอเวียงเชียงรุ้ง,11705,12087,23792,11753,12121,23874,9456
2565,57,เชียงราย,5718,อำเภอดอยหลวง,9207,9159,18366,9330,9316,18646,8830
2565,57,เชียงราย,5764,ท้องถิ่นเทศบาลตำบลแม่ยาว,8765,8940,17705,10854,11130,21984,9396
2565,57,เชียงราย,5765,ท้องถิ่นเทศบาลตำบลห้วยซ้อ,5993,5912,11905,6122,6153,12275,5315
2565,57,เชียงราย,5766,ท้องถิ่นเทศบาลตำบลไม้ยา,5257,5279,10536,5264,5287,10551,3856
2565,57,เชียงราย,5767,ท้องถิ่นเทศบาลตำบลครึ่ง,3112,3149,6261,3127,3165,6292,2732
2565,57,เชียงราย,5768,ท้องถิ่นเทศบาลตำบลป่าอ้อดอนชัย,5295,5864,11159,5437,5993,11430,5653
2565,57,เชียงราย,5769,ท้องถิ่นเทศบาลตำบลยางฮอม,5288,5496,10784,5327,5537,10864,4064
2565,57,เชียงราย,5770,ท้องถิ่นเทศบาลตำบลเวียง,4529,4607,9136,4749,4919,9668,4371
2565,57,เชียงราย,5771,ท้องถิ่นเทศบาลตำบลนางแล,5144,5746,10890,5765,6344,12109,6361
2565,57,เชียงราย,5772,ท้องถิ่นเทศบาลตำบลป่าซาง,4826,5403,10229,5460,6123,11583,5705
2565,57,เชียงราย,5773,ท้องถิ่นเทศบาลตำบลเวียงพางคำ,5038,5184,10222,10613,12218,22831,10072
2565,57,เชียงราย,5774,ท้องถิ่นเทศบาลตำบลบ้านดู่,8945,10286,19231,9992,11342,21334,14863
2565,57,เชียงราย,5775,ท้องถิ่นเทศบาลตำบลบ้านเหล่า,1979,2009,3988,1980,2011,3991,1752
2565,57,เชียงราย,5776,ท้องถิ่นเทศบาลตำบลแม่ลาว,846,938,1784,850,942,1792,827
2565,57,เชียงราย,5777,ท้องถิ่นเทศบาลตำบลป่าก่อดำ,1973,2188,4161,1993,2204,4197,2040
2565,57,เชียงราย,5778,ท้องถิ่นเทศบาลตำบลบ้านต้า,2857,3090,5947,2864,3096,5960,2286
2565,57,เชียงราย,5779,ท้องถิ่นเทศบาลตำบลพญาเม็งราย,1941,2135,4076,2004,2178,4182,2284
2565,57,เชียงราย,5780,ท้องถิ่นเทศบาลตำบลเวียงป่าเป้า,1940,2308,4248,1976,2357,4333,2410
2565,57,เชียงราย,5781,ท้องถิ่นเทศบาลตำบลแม่ขะจาน,1321,1529,2850,1326,1534,2860,1612
2565,57,เชียงราย,5782,ท้องถิ่นเทศบาลตำบลเจดีย์หลวง,2304,2359,4663,2320,2374,4694,2167
2565,57,เชียงราย,5783,ท้องถิ่นเทศบาลตำบลแม่สรวย,668,708,1376,715,755,1470,1128
2565,57,เชียงราย,5784,ท้องถิ่นเทศบาลตำบลห้วยไคร้,2074,2318,4392,2313,2658,4971,2554
2565,57,เชียงราย,5785,ท้องถิ่นเทศบาลตำบลแม่สาย,8362,8811,17173,12856,14820,27676,13762
2565,57,เชียงราย,5786,ท้องถิ่นเทศบาลตำบลเวียงเชียงแสน,2272,2568,4840,3001,3372,6373,3371
2565,57,เชียงราย,5787,ท้องถิ่นเทศบาลตำบลสันทราย,1185,1353,2538,1247,1399,2646,1280
2565,57,เชียงราย,5788,ท้องถิ่นเทศบาลตำบลแม่จัน,1423,1642,3065,1633,1901,3534,2478
2565,57,เชียงราย,5789,ท้องถิ่นเทศบาลตำบลแม่คำ,2075,2362,4437,2110,2401,4511,2190
2565,57,เชียงราย,5790,ท้องถิ่นเทศบาลตำบลจันจว้า,6591,7302,13893,6677,7412,14089,6286
2565,57,เชียงราย,5791,ท้องถิ่นเทศบาลตำบลป่าแดด,3042,3190,6232,3050,3203,6253,2480
2565,57,เชียงราย,5792,ท้องถิ่นเทศบาลตำบลป่าแงะ,3699,3802,7501,3704,3811,7515,3167
2565,57,เชียงราย,5793,ท้องถิ่นเทศบาลตำบลเมืองพาน,2875,3401,6276,2902,3423,6325,3546
2565,57,เชียงราย,5794,ท้องถิ่นเทศบาลตำบลเวียงเทิง,2255,2623,4878,2294,2669,4963,2822
2565,57,เชียงราย,5795,ท้องถิ่นเทศบาลตำบลบ้านปล้อง,1900,2026,3926,1902,2028,3930,1603
2565,57,เชียงราย,5796,ท้องถิ่นเทศบาลตำบลเวียงเชียงของ,1729,1966,3695,1743,1998,3741,2372
2565,57,เชียงราย,5797,ท้องถิ่นเทศบาลตำบลบุญเรือง,2873,3016,5889,2881,3031,5912,2552
2565,57,เชียงราย,5798,ท้องถิ่นเทศบาลตำบลเวียงชัย,3132,3575,6707,3163,3593,6756,3207
2565,57,เชียงราย,5799,ท้องถิ่นเทศบาลนครเชียงราย,33017,37610,70627,36740,40954,77694,52291
2565,58,แม่ฮ่องสอน,5801,อำเภอเมืองแม่ฮ่องสอน,19846,19302,39148,28556,28226,56782,23913
2565,58,แม่ฮ่องสอน,5802,อำเภอขุนยวม,9625,9217,18842,10339,9831,20170,7965
2565,58,แม่ฮ่องสอน,5803,อำเภอปาย,15454,14479,29933,18209,17008,35217,15640
2565,58,แม่ฮ่องสอน,5804,อำเภอแม่สะเรียง,25030,24867,49897,26409,26141,52550,22156
2565,58,แม่ฮ่องสอน,5805,อำเภอแม่ลาน้อย,16181,16019,32200,16284,16089,32373,11080
2565,58,แม่ฮ่องสอน,5806,อำเภอสบเมย,18520,18059,36579,23935,23233,47168,17730
2565,58,แม่ฮ่องสอน,5807,อำเภอปางมะผ้า,9015,8524,17539,11455,10713,22168,9081
2565,58,แม่ฮ่องสอน,5895,ท้องถิ่นเทศบาลตำบลแม่ลาน้อย,1719,1763,3482,1745,1785,3530,1825
2565,58,แม่ฮ่องสอน,5896,ท้องถิ่นเทศบาลตำบลแม่สะเรียง,1135,1327,2462,1297,1469,2766,1988
2565,58,แม่ฮ่องสอน,5897,ท้องถิ่นเทศบาลตำบลปาย,1070,1152,2222,1705,1752,3457,1921
2565,58,แม่ฮ่องสอน,5898,ท้องถิ่นเทศบาลตำบลขุนยวม,1612,1680,3292,1739,1808,3547,1803
2565,58,แม่ฮ่องสอน,5899,ท้องถิ่นเทศบาลเมืองแม่ฮ่องสอน,3176,3283,6459,3521,3537,7058,4739
2565,60,นครสวรรค์,6001,อำเภอเมืองนครสวรรค์,77862,83123,160985,78049,83226,161275,72755
2565,60,นครสวรรค์,6002,อำเภอโกรกพระ,12903,13561,26464,12917,13572,26489,9880
2565,60,นครสวรรค์,6003,อำเภอชุมแสง,25538,27183,52721,25564,27199,52763,18753
2565,60,นครสวรรค์,6004,อำเภอหนองบัว,26759,27262,54021,26779,27269,54048,23756
2565,60,นครสวรรค์,6005,อำเภอบรรพตพิสัย,39294,41016,80310,39362,41046,80408,29060
2565,60,นครสวรรค์,6006,อำเภอเก้าเลี้ยว,13819,14553,28372,13837,14565,28402,10755
2565,60,นครสวรรค์,6007,อำเภอตาคลี,37682,38839,76521,37730,38876,76606,30461
2565,60,นครสวรรค์,6008,อำเภอท่าตะโก,29199,30552,59751,29232,30566,59798,23947
2565,60,นครสวรรค์,6009,อำเภอไพศาลี,29400,30011,59411,29411,30029,59440,21568
2565,60,นครสวรรค์,6010,อำเภอพยุหะคีรี,24012,25530,49542,24050,25549,49599,21487
2565,60,นครสวรรค์,6011,อำเภอลาดยาว,35718,37232,72950,35752,37263,73015,28300
2565,60,นครสวรรค์,6012,อำเภอตากฟ้า,16624,17160,33784,16633,17164,33797,12893
2565,60,นครสวรรค์,6013,อำเภอแม่วงก์,24627,24966,49593,24654,24977,49631,19001
2565,60,นครสวรรค์,6014,อำเภอแม่เปิน,10447,10412,20859,10453,10413,20866,7084
2565,60,นครสวรรค์,6015,อำเภอชุมตาบง,8882,9017,17899,8884,9018,17902,6557
2565,60,นครสวรรค์,6082,ท้องถิ่นเทศบาลตำบลตากฟ้า,2539,2744,5283,2549,2751,5300,2794
2565,60,นครสวรรค์,6083,ท้องถิ่นเทศบาลตำบลลาดยาว,2733,3088,5821,2744,3098,5842,3496
2565,60,นครสวรรค์,6084,ท้องถิ่นเทศบาลตำบลศาลเจ้าไก่ต่อ,1530,1733,3263,1531,1736,3267,1476
2565,60,นครสวรรค์,6085,ท้องถิ่นเทศบาลตำบลพยุหะ,2525,2958,5483,2538,2967,5505,3035
2565,60,นครสวรรค์,6086,ท้องถิ่นเทศบาลตำบลท่าน้ำอ้อยม่วงหัก,2346,2592,4938,2354,2595,4949,2771
2565,60,นครสวรรค์,6087,ท้องถิ่นเทศบาลตำบลไพศาลี,4795,5345,10140,4806,5351,10157,5058
2565,60,นครสวรรค์,6088,ท้องถิ่นเทศบาลตำบลท่าตะโก,2545,2879,5424,2555,2892,5447,2904
2565,60,นครสวรรค์,6089,ท้องถิ่นเทศบาลตำบลช่องแค,1410,1546,2956,1412,1546,2958,1076
2565,60,นครสวรรค์,6090,ท้องถิ่นเทศบาลตำบลเก้าเลี้ยว,2690,2943,5633,2704,2949,5653,2353
2565,60,นครสวรรค์,6091,ท้องถิ่นเทศบาลตำบลบรรพตพิสัย,1777,1949,3726,1782,1949,3731,1867
2565,60,นครสวรรค์,6092,ท้องถิ่นเทศบาลเมืองหนองบัว,5402,6029,11431,5407,6041,11448,5117
2565,60,นครสวรรค์,6093,ท้องถิ่นเทศบาลตำบลทับกฤช,1001,1094,2095,1003,1095,2098,832
2565,60,นครสวรรค์,6094,ท้องถิ่นเทศบาลตำบลบางประมุง,2444,2517,4961,2450,2518,4968,1617
2565,60,นครสวรรค์,6095,ท้องถิ่นเทศบาลตำบลโกรกพระ,1055,1147,2202,1056,1149,2205,1001
2565,60,นครสวรรค์,6096,ท้องถิ่นเทศบาลตำบลหนองเบน,1313,1577,2890,1315,1583,2898,1521
2565,60,นครสวรรค์,6097,ท้องถิ่นเทศบาลเมืองตาคลี,10763,11796,22559,10808,11826,22634,10074
2565,60,นครสวรรค์,6098,ท้องถิ่นเทศบาลเมืองชุมแสง,3438,3891,7329,3446,3898,7344,3645
2565,60,นครสวรรค์,6099,ท้องถิ่นเทศบาลนครนครสวรรค์,36996,40527,77523,37468,40903,78371,43094
2565,61,อุทัยธานี,6101,อำเภอเมืองอุทัยธานี,16963,18505,35468,16978,18521,35499,14090
2565,61,อุทัยธานี,6102,อำเภอทัพทัน,7697,8142,15839,7702,8147,15849,5565
2565,61,อุทัยธานี,6103,อำเภอสว่างอารมณ์,14841,14915,29756,14850,14933,29783,11242
2565,61,อุทัยธานี,6104,อำเภอหนองฉาง,16422,17441,33863,16436,17452,33888,12085
2565,61,อุทัยธานี,6105,อำเภอหนองขาหย่าง,7227,8037,15264,7231,8038,15269,5994
2565,61,อุทัยธานี,6106,อำเภอบ้านไร่,31398,31850,63248,31469,31918,63387,25379
2565,61,อุทัยธานี,6107,อำเภอลานสัก,27345,27753,55098,27386,27802,55188,19362
2565,61,อุทัยธานี,6108,อำเภอห้วยคต,9954,10159,20113,9977,10168,20145,7630
2565,61,อุทัยธานี,6189,ท้องถิ่นเทศบาลตำบลหนองสระ,1001,1138,2139,1001,1138,2139,679
2565,61,อุทัยธานี,6190,ท้องถิ่นเทศบาลตำบลลานสัก,1654,1695,3349,1657,1698,3355,2186
2565,61,อุทัยธานี,6191,ท้องถิ่นเทศบาลตำบลเมืองการุ้ง,999,1117,2116,1002,1119,2121,1041
2565,61,อุทัยธานี,6192,ท้องถิ่นเทศบาลตำบลบ้านไร่,1229,1276,2505,1232,1277,2509,1417
2565,61,อุทัยธานี,6193,ท้องถิ่นเทศบาลตำบลหนองขาหย่าง,272,308,580,272,308,580,339
2565,61,อุทัยธานี,6194,ท้องถิ่นเทศบาลตำบลหนองฉาง,1264,1434,2698,1265,1436,2701,1941
2565,61,อุทัยธานี,6195,ท้องถิ่นเทศบาลตำบลเขาบางแกรก,2943,3195,6138,2948,3196,6144,2432
2565,61,อุทัยธานี,6196,ท้องถิ่นเทศบาลตำบลสว่างอารมณ์,769,821,1590,773,822,1595,993
2565,61,อุทัยธานี,6197,ท้องถิ่นเทศบาลตำบลทัพทัน,4192,4547,8739,4199,4554,8753,3727
2565,61,อุทัยธานี,6198,ท้องถิ่นเทศบาลตำบลตลุกดู่,5443,5748,11191,5446,5754,11200,3727
2565,61,อุทัยธานี,6199,ท้องถิ่นเทศบาลเมืองอุทัยธานี,6278,7413,13691,6315,7440,13755,9685
2565,62,กำแพงเพชร,6201,อำเภอเมืองกำแพงเพชร,66428,68761,135189,66509,68820,135329,54077
2565,62,กำแพงเพชร,6202,อำเภอไทรงาม,22304,22625,44929,22324,22639,44963,15229
2565,62,กำแพงเพชร,6203,อำเภอคลองลาน,20089,19519,39608,20145,19560,39705,15337
2565,62,กำแพงเพชร,6204,อำเภอขาณุวรลักษบุรี,33833,34386,68219,33864,34401,68265,26237
2565,62,กำแพงเพชร,6205,อำเภอคลองขลุง,27092,28244,55336,27172,28307,55479,23947
2565,62,กำแพงเพชร,6206,อำเภอพรานกระต่าย,24269,24389,48658,24278,24397,48675,16539
2565,62,กำแพงเพชร,6207,อำเภอลานกระบือ,16281,16294,32575,16292,16315,32607,11403
2565,62,กำแพงเพชร,6208,อำเภอทรายทองวัฒนา,6925,6922,13847,6931,6924,13855,4243
2565,62,กำแพงเพชร,6209,อำเภอปางศิลาทอง,15056,15080,30136,15082,15101,30183,11374
2565,62,กำแพงเพชร,6210,อำเภอบึงสามัคคี,9048,9087,18135,9063,9098,18161,7434
2565,62,กำแพงเพชร,6211,อำเภอโกสัมพีนคร,14057,14048,28105,14071,14053,28124,10958
2565,62,กำแพงเพชร,6278,ท้องถิ่นเทศบาลเมืองปางมะค่า,8803,8790,17593,8811,8800,17611,6891
2565,62,กำแพงเพชร,6279,ท้องถิ่นเทศบาลตำบลบ้านพราน,3521,3514,7035,3543,3532,7075,2963
2565,62,กำแพงเพชร,6280,ท้องถิ่นเทศบาลตำบลระหาน,3523,3664,7187,3553,3692,7245,3633
2565,62,กำแพงเพชร,6281,ท้องถิ่นเทศบาลตำบลคลองพิไกร,2833,2995,5828,2836,2998,5834,2269
2565,62,กำแพงเพชร,6282,ท้องถิ่นเทศบาลตำบลนิคมทุ่งโพธิ์ทะเล,4497,4630,9127,4505,4641,9146,3706
2565,62,กำแพงเพชร,6283,ท้องถิ่นเทศบาลตำบลวังยาง,2673,2742,5415,2682,2753,5435,2151
2565,62,กำแพงเพชร,6284,ท้องถิ่นเทศบาลตำบลทุ่งทราย,4254,4400,8654,4260,4405,8665,3309
2565,62,กำแพงเพชร,6285,ท้องถิ่นเทศบาลตำบลเทพนคร,9705,10191,19896,9716,10201,19917,8583
2565,62,กำแพงเพชร,6286,ท้องถิ่นเทศบาลตำบลคลองลานพัฒนา,10930,11343,22273,10985,11399,22384,8640
2565,62,กำแพงเพชร,6287,ท้องถิ่นเทศบาลตำบลช่องลม,2838,2864,5702,2841,2866,5707,1809
2565,62,กำแพงเพชร,6288,ท้องถิ่นเทศบาลตำบลลานกระบือ,2087,2146,4233,2103,2164,4267,2582
2565,62,กำแพงเพชร,6289,ท้องถิ่นเทศบาลตำบลพรานกระต่าย,4056,4451,8507,4060,4455,8515,3735
2565,62,กำแพงเพชร,6290,ท้องถิ่นเทศบาลตำบลท่ามะเขือ,1732,1869,3601,1745,1876,3621,2039
2565,62,กำแพงเพชร,6291,ท้องถิ่นเทศบาลตำบลท่าพุทรา,721,760,1481,723,760,1483,639
2565,62,กำแพงเพชร,6292,ท้องถิ่นเทศบาลตำบลคลองขลุง,923,991,1914,943,1004,1947,1036
2565,62,กำแพงเพชร,6293,ท้องถิ่นเทศบาลตำบลสลกบาตร,3816,4166,7982,3832,4195,8027,4477
2565,62,กำแพงเพชร,6294,ท้องถิ่นเทศบาลตำบลขาณุวรลักษบุรี,3795,4039,7834,3862,4105,7967,3474
2565,62,กำแพงเพชร,6295,ท้องถิ่นเทศบาลตำบลไทรงาม,2344,2575,4919,2351,2591,4942,2534
2565,62,กำแพงเพชร,6296,ท้องถิ่นเทศบาลตำบลปากดง,1509,1657,3166,1512,1659,3171,1347
2565,62,กำแพงเพชร,6297,ท้องถิ่นเทศบาลตำบลนครชุม,3166,3613,6779,3175,3617,6792,3534
2565,62,กำแพงเพชร,6298,ท้องถิ่นเทศบาลตำบลคลองแม่ลาย,2798,2962,5760,2803,2969,5772,2472
2565,62,กำแพงเพชร,6299,ท้องถิ่นเทศบาลเมืองกำแพงเพชร,12925,14625,27550,13124,14782,27906,16589
2565,63,ตาก,6301,อำเภอเมืองตาก,36855,37456,74311,36957,37536,74493,29952
2565,63,ตาก,6302,อำเภอบ้านตาก,15392,15666,31058,15439,15700,31139,11115
2565,63,ตาก,6303,อำเภอสามเงา,12486,12865,25351,12501,12882,25383,9637
2565,63,ตาก,6304,อำเภอแม่ระมาด,21291,20694,41985,25904,24581,50485,17327
2565,63,ตาก,6305,อำเภอท่าสองยาง,35890,34279,70169,47931,45170,93101,24958
2565,63,ตาก,6306,อำเภอแม่สอด,38697,38971,77668,50729,49808,100537,37899
2565,63,ตาก,6307,อำเภอพบพระ,30740,30120,60860,44664,42971,87635,20986
2565,63,ตาก,6308,อำเภออุ้มผาง,16196,15182,31378,23847,22019,45866,11826
2565,63,ตาก,6309,อำเภอวังเจ้า,14687,14528,29215,15267,15122,30389,9388
2565,63,ตาก,6386,ท้องถิ่นเทศบาลตำบลไม้งาม,6291,5181,11472,6307,5191,11498,6514
2565,63,ตาก,6387,ท้องถิ่นเทศบาลตำบลวังเจ้า,2086,2105,4191,2088,2109,4197,1972
2565,63,ตาก,6388,ท้องถิ่นเทศบาลตำบลอุ้มผาง,831,851,1682,2118,1972,4090,929
2565,63,ตาก,6389,ท้องถิ่นเทศบาลตำบลพบพระ,2473,2413,4886,3505,3334,6839,2813
2565,63,ตาก,6390,ท้องถิ่นเทศบาลตำบลแม่กุ,3133,3252,6385,3227,3360,6587,3051
2565,63,ตาก,6391,ท้องถิ่นเทศบาลตำบลท่าสายลวด,3065,3024,6089,12656,11932,24588,4842
2565,63,ตาก,6392,ท้องถิ่นเทศบาลตำบลแม่ต้าน,1274,1334,2608,2016,2084,4100,1419
2565,63,ตาก,6393,ท้องถิ่นเทศบาลตำบลแม่ระมาด,1818,1849,3667,1961,1974,3935,1883
2565,63,ตาก,6394,ท้องถิ่นเทศบาลตำบลแม่จะเรา,2474,2625,5099,2514,2673,5187,2176
2565,63,ตาก,6395,ท้องถิ่นเทศบาลตำบลสามเงา,2124,2347,4471,2134,2349,4483,2176
2565,63,ตาก,6396,ท้องถิ่นเทศบาลตำบลบ้านตาก,2923,3435,6358,2947,3452,6399,2745
2565,63,ตาก,6397,ท้องถิ่นเทศบาลตำบลทุ่งกระเชาะ,2951,3007,5958,2954,3013,5967,2154
2565,63,ตาก,6398,ท้องถิ่นเทศบาลนครแม่สอด,12772,13813,26585,20746,20922,41668,20001
2565,63,ตาก,6399,ท้องถิ่นเทศบาลเมืองตาก,7166,8118,15284,7320,8254,15574,7530
2565,64,สุโขทัย,6401,อำเภอเมืองสุโขทัย,29074,31498,60572,29109,31514,60623,23247
2565,64,สุโขทัย,6402,อำเภอบ้านด่านลานหอย,21896,22141,44037,22007,22237,44244,14741
2565,64,สุโขทัย,6403,อำเภอคีรีมาศ,22678,23238,45916,22695,23253,45948,14635
2565,64,สุโขทัย,6404,อำเภอกงไกรลาศ,28677,30213,58890,28695,30225,58920,20836
2565,64,สุโขทัย,6405,อำเภอศรีสัชนาลัย,34068,35250,69318,34114,35294,69408,27275
2565,64,สุโขทัย,6406,อำเภอศรีสำโรง,29230,31716,60946,29264,31736,61000,22848
2565,64,สุโขทัย,6407,อำเภอสวรรคโลก,23824,25903,49727,23839,25914,49753,20411
2565,64,สุโขทัย,6408,อำเภอศรีนคร,10829,11458,22287,10845,11466,22311,8280
2565,64,สุโขทัย,6409,อำเภอทุ่งเสลี่ยม,20493,21041,41534,20529,21063,41592,15059
2565,64,สุโขทัย,6484,ท้องถิ่นเทศบาลตำบลในเมือง,3960,4158,8118,3963,4162,8125,3438
2565,64,สุโขทัย,6485,ท้องถิ่นเทศบาลตำบลป่ากุมเกาะ,3686,3959,7645,3687,3961,7648,2820
2565,64,สุโขทัย,6486,ท้องถิ่นเทศบาลตำบลบ้านกล้วย,7445,8476,15921,7458,8492,15950,7311
2565,64,สุโขทัย,6487,ท้องถิ่นเทศบาลตำบลทุ่งเสลี่ยม,3387,3799,7186,3394,3807,7201,3065
2565,64,สุโขทัย,6488,ท้องถิ่นเทศบาลตำบลศรีนคร,1389,1613,3002,1394,1618,3012,1700
2565,64,สุโขทัย,6489,ท้องถิ่นเทศบาลตำบลศรีสำโรง,3286,3863,7149,3292,3869,7161,3545
2565,64,สุโขทัย,6490,ท้องถิ่นเทศบาลตำบลหาดเสี้ยว,3033,3416,6449,3038,3421,6459,3659
2565,64,สุโขทัย,6491,ท้องถิ่นเทศบาลเมืองศรีสัชนาลัย,7094,7780,14874,7095,7781,14876,5888
2565,64,สุโขทัย,6492,ท้องถิ่นเทศบาลตำบลกงไกรลาศ,1893,2125,4018,1895,2126,4021,2069
2565,64,สุโขทัย,6493,ท้องถิ่นเทศบาลตำบลบ้านโตนด,1384,1576,2960,1386,1576,2962,1647
2565,64,สุโขทัย,6494,ท้องถิ่นเทศบาลตำบลทุ่งหลวง,3369,3692,7061,3370,3692,7062,2423
2565,64,สุโขทัย,6495,ท้องถิ่นเทศบาลตำบลลานหอย,1699,1833,3532,1705,1834,3539,1737
2565,64,สุโขทัย,6496,ท้องถิ่นเทศบาลตำบลเมืองเก่า,3287,3813,7100,3291,3813,7104,2672
2565,64,สุโขทัย,6497,ท้องถิ่นเทศบาลตำบลบ้านสวน,2025,2239,4264,2025,2240,4265,1720
2565,64,สุโขทัย,6498,ท้องถิ่นเทศบาลเมืองสวรรคโลก,6931,7838,14769,6952,7852,14804,6791
2565,64,สุโขทัย,6499,ท้องถิ่นเทศบาลเมืองสุโขทัยธานี,6348,7286,13634,6371,7293,13664,7131
2565,65,พิษณุโลก,6501,อำเภอเมืองพิษณุโลก,86479,93149,179628,86667,93225,179892,88784
2565,65,พิษณุโลก,6502,อำเภอนครไทย,33166,33599,66765,33227,33656,66883,24201
2565,65,พิษณุโลก,6503,อำเภอชาติตระการ,18163,17833,35996,18215,17877,36092,12578
2565,65,พิษณุโลก,6504,อำเภอบางระกำ,36423,37700,74123,36477,37762,74239,26645
2565,65,พิษณุโลก,6505,อำเภอบางกระทุ่ม,15757,16726,32483,15766,16744,32510,12043
2565,65,พิษณุโลก,6506,อำเภอพรหมพิราม,39215,41217,80432,39250,41234,80484,31207
2565,65,พิษณุโลก,6507,อำเภอวัดโบสถ์,14577,14835,29412,14588,14848,29436,11431
2565,65,พิษณุโลก,6508,อำเภอวังทอง,55953,57643,113596,56226,57809,114035,44757
2565,65,พิษณุโลก,6509,อำเภอเนินมะปราง,19053,19285,38338,19072,19297,38369,15081
2565,65,พิษณุโลก,6580,ท้องถิ่นเทศบาลเมืองอรัญญิก,16317,13394,29711,16358,13418,29776,14302
2565,65,พิษณุโลก,6581,ท้องถิ่นเทศบาลตำบลบ้านมุง,3416,3469,6885,3425,3474,6899,2669
2565,65,พิษณุโลก,6582,ท้องถิ่นเทศบาลตำบลบึงระมาณ,2116,2281,4397,2119,2285,4404,1703
2565,65,พิษณุโลก,6583,ท้องถิ่นเทศบาลตำบลพลายชุมพล,3640,4115,7755,3650,4118,7768,4392
2565,65,พิษณุโลก,6584,ท้องถิ่นเทศบาลตำบลพันเสา,2980,3041,6021,2984,3044,6028,2118
2565,65,พิษณุโลก,6585,ท้องถิ่นเทศบาลตำบลไทรย้อย,4155,4263,8418,4162,4264,8426,3218
2565,65,พิษณุโลก,6586,ท้องถิ่นเทศบาลตำบลบ้านแยง,5050,4901,9951,5075,4928,10003,5079
2565,65,พิษณุโลก,6587,ท้องถิ่นเทศบาลตำบลเนินมะปราง,1649,1793,3442,1657,1794,3451,1659
2565,65,พิษณุโลก,6588,ท้องถิ่นเทศบาลตำบลวังทอง,1953,2220,4173,1958,2224,4182,1731
2565,65,พิษณุโลก,6589,ท้องถิ่นเทศบาลตำบลวัดโบสถ์,3752,4182,7934,3758,4184,7942,4079
2565,65,พิษณุโลก,6590,ท้องถิ่นเทศบาลตำบลวงฆ้อง,1468,1554,3022,1472,1554,3026,1572
2565,65,พิษณุโลก,6591,ท้องถิ่นเทศบาลตำบลพรหมพิราม,506,593,1099,511,596,1107,551
2565,65,พิษณุโลก,6592,ท้องถิ่นเทศบาลตำบลบางกระทุ่ม,656,675,1331,657,676,1333,623
2565,65,พิษณุโลก,6593,ท้องถิ่นเทศบาลตำบลเนินกุ่ม,5740,6071,11811,5748,6074,11822,4627
2565,65,พิษณุโลก,6594,ท้องถิ่นเทศบาลตำบลปลักแรด,1679,1844,3523,1683,1846,3529,1327
2565,65,พิษณุโลก,6595,ท้องถิ่นเทศบาลตำบลบางระกำ,1974,2198,4172,1976,2202,4178,2006
2565,65,พิษณุโลก,6596,ท้องถิ่นเทศบาลตำบลป่าแดง,2585,2732,5317,2590,2737,5327,2622
2565,65,พิษณุโลก,6597,ท้องถิ่นเทศบาลตำบลนครไทย,4240,4599,8839,4255,4605,8860,4160
2565,65,พิษณุโลก,6598,ท้องถิ่นเทศบาลตำบลบ้านใหม่,900,1005,1905,902,1007,1909,804
2565,65,พิษณุโลก,6599,ท้องถิ่นเทศบาลนครพิษณุโลก,28122,34136,62258,28314,34270,62584,37507
2565,66,พิจิตร,6601,อำเภอเมืองพิจิตร,35182,37528,72710,35217,37546,72763,26992
2565,66,พิจิตร,6602,อำเภอวังทรายพูน,8549,8765,17314,8556,8772,17328,6002
2565,66,พิจิตร,6603,อำเภอโพธิ์ประทับช้าง,16635,17178,33813,16653,17198,33851,11786
2565,66,พิจิตร,6604,อำเภอตะพานหิน,21729,22896,44625,21753,22910,44663,16241
2565,66,พิจิตร,6605,อำเภอบางมูลนาก,9757,10437,20194,9765,10443,20208,8073
2565,66,พิจิตร,6606,อำเภอโพทะเล,26431,27543,53974,26459,27562,54021,19103
2565,66,พิจิตร,6607,อำเภอสามง่าม,12639,12866,25505,12642,12871,25513,8889
2565,66,พิจิตร,6608,อำเภอทับคล้อ,16409,17025,33434,16414,17032,33446,12926
2565,66,พิจิตร,6609,อำเภอสากเหล็ก,8908,8996,17904,8913,9001,17914,6234
2565,66,พิจิตร,6610,อำเภอบึงนาราง,14060,14645,28705,14078,14661,28739,10969
2565,66,พิจิตร,6611,อำเภอดงเจริญ,8420,8691,17111,8436,8699,17135,6437
2565,66,พิจิตร,6612,อำเภอวชิรบารมี,15221,15623,30844,15232,15634,30866,11194
2565,66,พิจิตร,6676,ท้องถิ่นเทศบาลตำบลหนองพยอม,3295,3417,6712,3297,3417,6714,2354
2565,66,พิจิตร,6677,ท้องถิ่นเทศบาลตำบลหนองปล้อง,1652,1731,3383,1652,1731,3383,1176
2565,66,พิจิตร,6678,ท้องถิ่นเทศบาลตำบลเนินมะกอก,3235,3503,6738,3244,3520,6764,3054
2565,66,พิจิตร,6679,ท้องถิ่นเทศบาลตำบลหอไกร,2835,3010,5845,2844,3023,5867,2731
2565,66,พิจิตร,6680,ท้องถิ่นเทศบาลตำบลดงป่าคำ,2326,2403,4729,2326,2403,4729,1629
2565,66,พิจิตร,6681,ท้องถิ่นเทศบาลตำบลเนินปอ,4503,4552,9055,4503,4554,9057,3180
2565,66,พิจิตร,6682,ท้องถิ่นเทศบาลตำบลสำนักขุนเณร,1087,1085,2172,1089,1089,2178,909
2565,66,พิจิตร,6683,ท้องถิ่นเทศบาลตำบลสากเหล็ก,2458,2712,5170,2461,2715,5176,2414
2565,66,พิจิตร,6684,ท้องถิ่นเทศบาลตำบลทับคล้อ,2032,2232,4264,2037,2235,4272,1780
2565,66,พิจิตร,6685,ท้องถิ่นเทศบาลตำบลเขาทราย,2105,2138,4243,2106,2139,4245,1920
2565,66,พิจิตร,6686,ท้องถิ่นเทศบาลตำบลสามง่าม,2182,2527,4709,2183,2528,4711,2280
2565,66,พิจิตร,6687,ท้องถิ่นเทศบาลตำบลกำแพงดิน,1036,1117,2153,1037,1119,2156,829
2565,66,พิจิตร,6688,ท้องถิ่นเทศบาลตำบลโพทะเล,1131,1223,2354,1133,1224,2357,1024
2565,66,พิจิตร,6689,ท้องถิ่นเทศบาลตำบลท่าเสา,737,719,1456,737,719,1456,530
2565,66,พิจิตร,6690,ท้องถิ่นเทศบาลตำบลวังตะกู,787,780,1567,793,782,1575,658
2565,66,พิจิตร,6691,ท้องถิ่นเทศบาลตำบลบางไผ่,720,761,1481,721,764,1485,638
2565,66,พิจิตร,6692,ท้องถิ่นเทศบาลตำบลโพธิ์ประทับช้าง,4454,4751,9205,4465,4760,9225,3565
2565,66,พิจิตร,6693,ท้องถิ่นเทศบาลตำบลวังทรายพูน,1606,1645,3251,1607,1647,3254,1261
2565,66,พิจิตร,6694,ท้องถิ่นเทศบาลตำบลหัวดง,1472,1574,3046,1481,1578,3059,1200
2565,66,พิจิตร,6695,ท้องถิ่นเทศบาลตำบลวังกรด,1442,1473,2915,1445,1476,2921,1059
2565,66,พิจิตร,6696,ท้องถิ่นเทศบาลตำบลท่าฬ่อ,1501,1642,3143,1503,1646,3149,1213
2565,66,พิจิตร,6697,ท้องถิ่นเทศบาลเมืองบางมูลนาก,3726,4145,7871,3741,4149,7890,3714
2565,66,พิจิตร,6698,ท้องถิ่นเทศบาลเมืองตะพานหิน,6087,7038,13125,6118,7062,13180,6321
2565,66,พิจิตร,6699,ท้องถิ่นเทศบาลเมืองพิจิตร,9648,10959,20607,9700,10994,20694,12550
2565,67,เพชรบูรณ์,6701,อำเภอเมืองเพชรบูรณ์,79307,79619,158926,79521,79684,159205,63778
2565,67,เพชรบูรณ์,6702,อำเภอชนแดน,33699,33936,67635,33722,33962,67684,28407
2565,67,เพชรบูรณ์,6703,อำเภอหล่มสัก,69671,73461,143132,69794,73499,143293,50114
2565,67,เพชรบูรณ์,6704,อำเภอหล่มเก่า,28978,30387,59365,29018,30429,59447,19243
2565,67,เพชรบูรณ์,6705,อำเภอวิเชียรบุรี,49157,50483,99640,49225,50507,99732,34205
2565,67,เพชรบูรณ์,6706,อำเภอศรีเทพ,28043,28441,56484,28080,28472,56552,20028
2565,67,เพชรบูรณ์,6707,อำเภอหนองไผ่,37498,38026,75524,37539,38059,75598,25587
2565,67,เพชรบูรณ์,6708,อำเภอบึงสามพัน,30881,31557,62438,30931,31584,62515,26178
2565,67,เพชรบูรณ์,6709,อำเภอน้ำหนาว,9537,9136,18673,9547,9140,18687,7318
2565,67,เพชรบูรณ์,6710,อำเภอวังโป่ง,13907,14216,28123,13915,14227,28142,9449
2565,67,เพชรบูรณ์,6711,อำเภอเขาค้อ,17672,17721,35393,17934,18018,35952,12648
2565,67,เพชรบูรณ์,6778,ท้องถิ่นเทศบาลตำบลแคมป์สน,2603,2786,5389,2616,2788,5404,3193
2565,67,เพชรบูรณ์,6779,ท้องถิ่นเทศบาลตำบลโคกสะอาด,3227,3264,6491,3229,3268,6497,2221
2565,67,เพชรบูรณ์,6780,ท้องถิ่นเทศบาลตำบลบัววัฒนา,2893,2908,5801,2894,2908,5802,1929
2565,67,เพชรบูรณ์,6781,ท้องถิ่นเทศบาลตำบลบ่อไทย,4681,4847,9528,4690,4858,9548,3058
2565,67,เพชรบูรณ์,6782,ท้องถิ่นเทศบาลตำบลนางั่ว,5939,6764,12703,6012,6767,12779,5780
2565,67,เพชรบูรณ์,6783,ท้องถิ่นเทศบาลตำบลเฉลียงทอง,3709,3732,7441,3716,3734,7450,2604
2565,67,เพชรบูรณ์,6784,ท้องถิ่นเทศบาลตำบลวังโป่ง,1790,2002,3792,1792,2007,3799,1534
2565,67,เพชรบูรณ์,6785,ท้องถิ่นเทศบาลตำบลท้ายดง,1614,1740,3354,1615,1743,3358,1077
2565,67,เพชรบูรณ์,6786,ท้องถิ่นเทศบาลตำบลซับสมอทอด,4113,4299,8412,4152,4339,8491,5169
2565,67,เพชรบูรณ์,6787,ท้องถิ่นเทศบาลตำบลหนองไผ่,3417,3762,7179,3425,3768,7193,3866
2565,67,เพชรบูรณ์,6788,ท้องถิ่นเทศบาลตำบลนาเฉลียง,1965,2184,4149,1970,2186,4156,1750
2565,67,เพชรบูรณ์,6789,ท้องถิ่นเทศบาลตำบลสว่างวัฒนา,3119,3376,6495,3126,3377,6503,2935
2565,67,เพชรบูรณ์,6790,ท้องถิ่นเทศบาลเมืองวิเชียรบุรี,10371,11555,21926,10468,11580,22048,8872
2565,67,เพชรบูรณ์,6791,ท้องถิ่นเทศบาลตำบลพุเตย,3517,3682,7199,3525,3683,7208,3037
2565,67,เพชรบูรณ์,6792,ท้องถิ่นเทศบาลตำบลหล่มเก่า,2663,3015,5678,2668,3015,5683,2657
2565,67,เพชรบูรณ์,6793,ท้องถิ่นเทศบาลตำบลท่าข้าม,1216,1209,2425,1218,1211,2429,986
2565,67,เพชรบูรณ์,6794,ท้องถิ่นเทศบาลตำบลดงขุย,1205,1325,2530,1206,1325,2531,1065
2565,67,เพชรบูรณ์,6795,ท้องถิ่นเทศบาลตำบลชนแดน,1719,1625,3344,1726,1627,3353,1846
2565,67,เพชรบูรณ์,6796,ท้องถิ่นเทศบาลตำบลวังชมภู,1584,1842,3426,1593,1846,3439,1334
2565,67,เพชรบูรณ์,6797,ท้องถิ่นเทศบาลตำบลท่าพล,3569,3921,7490,3584,3929,7513,2609
2565,67,เพชรบูรณ์,6798,ท้องถิ่นเทศบาลเมืองหล่มสัก,5277,5907,11184,5305,5920,11225,6648
2565,67,เพชรบูรณ์,6799,ท้องถิ่นเทศบาลเมืองเพชรบูรณ์,9340,10774,20114,9378,10792,20170,12808
2565,70,ราชบุรี,7001,อำเภอเมืองราชบุรี,59720,63065,122785,60367,63646,124013,50002
2565,70,ราชบุรี,7002,อำเภอจอมบึง,28184,29094,57278,28411,29317,57728,19980
2565,70,ราชบุรี,7003,อำเภอสวนผึ้ง,15302,14622,29924,24609,22689,47298,15041
2565,70,ราชบุรี,7004,อำเภอดำเนินสะดวก,34870,37354,72224,35144,37584,72728,23869
2565,70,ราชบุรี,7005,อำเภอบ้านโป่ง,46087,50312,96399,46312,50501,96813,38349
2565,70,ราชบุรี,7006,อำเภอบางแพ,8450,9251,17701,8489,9285,17774,6721
2565,70,ราชบุรี,7007,อำเภอโพธาราม,34441,36720,71161,34587,36874,71461,26226
2565,70,ราชบุรี,7008,อำเภอปากท่อ,24426,25635,50061,24977,26126,51103,19249
2565,70,ราชบุรี,7009,อำเภอวัดเพลง,5107,5608,10715,5114,5616,10730,3752
2565,70,ราชบุรี,7010,อำเภอบ้านคา,12173,11842,24015,12859,12365,25224,9873
2565,70,ราชบุรี,7070,ท้องถิ่นเทศบาลตำบลดอนทราย,3280,3667,6947,3333,3702,7035,3196
2565,70,ราชบุรี,7071,ท้องถิ่นเทศบาลตำบลหลุมดิน,2521,2614,5135,2538,2628,5166,1821
2565,70,ราชบุรี,7072,ท้องถิ่นเทศบาลตำบลเบิกไพร,7544,8587,16131,7563,8601,16164,6845
2565,70,ราชบุรี,7073,ท้องถิ่นเทศบาลตำบลทุ่งหลวง,6880,6937,13817,6927,6966,13893,4512
2565,70,ราชบุรี,7074,ท้องถิ่นเทศบาลตำบลบ้านฆ้อง,4030,4528,8558,4057,4556,8613,3652
2565,70,ราชบุรี,7075,ท้องถิ่นเทศบาลตำบลกรับใหญ่,6146,6723,12869,6167,6732,12899,3975
2565,70,ราชบุรี,7076,ท้องถิ่นเทศบาลตำบลบ้านสิงห์,5695,6276,11971,5729,6306,12035,4666
2565,70,ราชบุรี,7077,ท้องถิ่นเทศบาลตำบลวัดเพลง,636,692,1328,646,705,1351,558
2565,70,ราชบุรี,7078,ท้องถิ่นเทศบาลตำบลปากท่อ,1314,1405,2719,1322,1406,2728,1433
2565,70,ราชบุรี,7079,ท้องถิ่นเทศบาลตำบลหนองโพ,1781,2013,3794,1785,2022,3807,2224
2565,70,ราชบุรี,7080,ท้องถิ่นเทศบาลตำบลบ้านเลือก,5224,5739,10963,5245,5758,11003,5372
2565,70,ราชบุรี,7081,ท้องถิ่นเทศบาลตำบลเจ็ดเสมียน,2668,2956,5624,2705,3002,5707,2330
2565,70,ราชบุรี,7082,ท้องถิ่นเทศบาลตำบลเขาขวาง,3504,3762,7266,3510,3770,7280,2689
2565,70,ราชบุรี,7083,ท้องถิ่นเทศบาลตำบลโพหัก,5029,5343,10372,5041,5353,10394,3761
2565,70,ราชบุรี,7084,ท้องถิ่นเทศบาลตำบลบางแพ,7485,8285,15770,7562,8349,15911,6769
2565,70,ราชบุรี,7085,ท้องถิ่นเทศบาลตำบลห้วยกระบอก,791,835,1626,805,841,1646,739
2565,70,ราชบุรี,7086,ท้องถิ่นเทศบาลเมืองท่าผา,9651,10389,20040,9698,10427,20125,8472
2565,70,ราชบุรี,7087,ท้องถิ่นเทศบาลตำบลกระจับ,3592,4030,7622,3649,4067,7716,3849
2565,70,ราชบุรี,7088,ท้องถิ่นเทศบาลตำบลศรีดอนไผ่,4955,5499,10454,4981,5517,10498,3480
2565,70,ราชบุรี,7089,ท้องถิ่นเทศบาลตำบลดำเนินสะดวก,3243,3749,6992,3257,3755,7012,3294
2565,70,ราชบุรี,7090,ท้องถิ่นเทศบาลตำบลสวนผึ้ง,1673,1691,3364,1710,1723,3433,1869
2565,70,ราชบุรี,7091,ท้องถิ่นเทศบาลตำบลบ้านชัฏป่าหวาย,1855,1868,3723,1943,1933,3876,1953
2565,70,ราชบุรี,7092,ท้องถิ่นเทศบาลตำบลด่านทับตะโก,1233,1182,2415,1236,1185,2421,846
2565,70,ราชบุรี,7093,ท้องถิ่นเทศบาลตำบลจอมบึง,2263,2556,4819,2268,2559,4827,3691
2565,70,ราชบุรี,7094,ท้องถิ่นเทศบาลตำบลห้วยชินสีห์,5299,5797,11096,5333,5831,11164,4505
2565,70,ราชบุรี,7095,ท้องถิ่นเทศบาลตำบลหลักเมือง,9336,7980,17316,9390,8019,17409,7462
2565,70,ราชบุรี,7096,ท้องถิ่นเทศบาลตำบลเขางู,4361,4794,9155,4384,4818,9202,3087
2565,70,ราชบุรี,7097,ท้องถิ่นเทศบาลเมืองโพธาราม,3699,4078,7777,3960,4335,8295,3766
2565,70,ราชบุรี,7098,ท้องถิ่นเทศบาลเมืองบ้านโป่ง,6847,7918,14765,7202,8253,15455,8324
2565,70,ราชบุรี,7099,ท้องถิ่นเทศบาลเมืองราชบุรี,14761,17657,32418,15507,18363,33870,16474
2565,71,กาญจนบุรี,7101,อำเภอเมืองกาญจนบุรี,51969,41371,93340,55145,43699,98844,40007
2565,71,กาญจนบุรี,7102,อำเภอไทรโยค,22024,21533,43557,31069,29218,60287,21286
2565,71,กาญจนบุรี,7103,อำเภอบ่อพลอย,23970,24124,48094,24068,24220,48288,18985
2565,71,กาญจนบุรี,7104,อำเภอศรีสวัสดิ์,12278,11689,23967,13334,12544,25878,10365
2565,71,กาญจนบุรี,7105,อำเภอท่ามะกา,43378,46229,89607,43694,46523,90217,32066
2565,71,กาญจนบุรี,7106,อำเภอท่าม่วง,28054,29927,57981,28214,30061,58275,24681
2565,71,กาญจนบุรี,7107,อำเภอทองผาภูมิ,21929,20510,42439,34653,32240,66893,28175
2565,71,กาญจนบุรี,7108,อำเภอสังขละบุรี,10968,10346,21314,21962,20551,42513,12494
2565,71,กาญจนบุรี,7109,อำเภอพนมทวน,15801,16737,32538,15819,16760,32579,11551
2565,71,กาญจนบุรี,7110,อำเภอเลาขวัญ,26660,26848,53508,26735,26901,53636,18928
2565,71,กาญจนบุรี,7111,อำเภอด่านมะขามเตี้ย,15562,15638,31200,15644,15707,31351,11155
2565,71,กาญจนบุรี,7112,อำเภอหนองปรือ,13644,13350,26994,13745,13421,27166,9743
2565,71,กาญจนบุรี,7113,อำเภอห้วยกระเจา,16592,17193,33785,16643,17220,33863,12157
2565,71,กาญจนบุรี,7167,ท้องถิ่นเทศบาลตำบลรางหวาย,3584,3591,7175,3596,3598,7194,2623
2565,71,กาญจนบุรี,7168,ท้องถิ่นเทศบาลตำบลหนองสาหร่าย,1703,1941,3644,1718,1947,3665,1228
2565,71,กาญจนบุรี,7169,ท้องถิ่นเทศบาลเมืองปากแพรก,13105,14731,27836,13264,14850,28114,16261
2565,71,กาญจนบุรี,7170,ท้องถิ่นเทศบาลตำบลวังศาลา,5687,6054,11741,5712,6084,11796,5284
2565,71,กาญจนบุรี,7171,ท้องถิ่นเทศบาลตำบลท่าล้อ,4250,4789,9039,4285,4809,9094,4015
2565,71,กาญจนบุรี,7172,ท้องถิ่นเทศบาลตำบลวังขนาย,4400,4829,9229,4435,4850,9285,3981
2565,71,กาญจนบุรี,7173,ท้องถิ่นเทศบาลตำบลหนองปรือ,2127,2238,4365,2130,2241,4371,1831
2565,71,กาญจนบุรี,7174,ท้องถิ่นเทศบาลตำบลด่านมะขามเตี้ย,1170,1246,2416,1213,1265,2478,1303
2565,71,กาญจนบุรี,7175,ท้องถิ่นเทศบาลตำบลหนองฝ้าย,1019,1117,2136,1061,1154,2215,960
2565,71,กาญจนบุรี,7176,ท้องถิ่นเทศบาลตำบลเลาขวัญ,1298,1299,2597,1305,1300,2605,1360
2565,71,กาญจนบุรี,7177,ท้องถิ่นเทศบาลตำบลตลาดเขต,1891,2141,4032,1899,2149,4048,1834
2565,71,กาญจนบุรี,7178,ท้องถิ่นเทศบาลตำบลพนมทวน,2397,2706,5103,2444,2736,5180,2227
2565,71,กาญจนบุรี,7179,ท้องถิ่นเทศบาลตำบลวังกะ,3558,3418,6976,4824,4704,9528,2673
2565,71,กาญจนบุรี,7180,ท้องถิ่นเทศบาลตำบลทองผาภูมิ,1400,1358,2758,1576,1512,3088,1608
2565,71,กาญจนบุรี,7181,ท้องถิ่นเทศบาลตำบลหนองตากยา,1451,1545,2996,1456,1548,3004,977
2565,71,กาญจนบุรี,7182,ท้องถิ่นเทศบาลตำบลหนองขาว,2359,2630,4989,2373,2633,5006,1622
2565,71,กาญจนบุรี,7183,ท้องถิ่นเทศบาลตำบลสำรอง,870,917,1787,878,919,1797,654
2565,71,กาญจนบุรี,7184,ท้องถิ่นเทศบาลตำบลท่าม่วง,4316,5066,9382,4455,5202,9657,5532
2565,71,กาญจนบุรี,7185,ท้องถิ่นเทศบาลตำบลหวายเหนียว,2087,2244,4331,2103,2261,4364,1932
2565,71,กาญจนบุรี,7186,ท้องถิ่นเทศบาลตำบลพระแท่น,2947,3198,6145,2959,3206,6165,2198
2565,71,กาญจนบุรี,7187,ท้องถิ่นเทศบาลตำบลท่าไม้,4297,4642,8939,4321,4652,8973,3946
2565,71,กาญจนบุรี,7188,ท้องถิ่นเทศบาลตำบลท่ามะกา,3431,4024,7455,3901,4466,8367,4755
2565,71,กาญจนบุรี,7189,ท้องถิ่นเทศบาลตำบลลูกแก,1604,1845,3449,1608,1847,3455,1517
2565,71,กาญจนบุรี,7190,ท้องถิ่นเทศบาลตำบลเอราวัณ,467,486,953,467,486,953,726
2565,71,กาญจนบุรี,7191,ท้องถิ่นเทศบาลตำบลหนองรี,1024,1089,2113,1026,1089,2115,814
2565,71,กาญจนบุรี,7192,ท้องถิ่นเทศบาลตำบลบ่อพลอย,3326,3378,6704,3408,3439,6847,2758
2565,71,กาญจนบุรี,7193,ท้องถิ่นเทศบาลตำบลวังโพธิ์,908,910,1818,1024,988,2012,899
2565,71,กาญจนบุรี,7194,ท้องถิ่นเทศบาลตำบลน้ำตกไทรโยคน้อย,1931,1985,3916,1949,2000,3949,1643
2565,71,กาญจนบุรี,7195,ท้องถิ่นเทศบาลตำบลหนองบัว,3203,3594,6797,3220,3609,6829,3195
2565,71,กาญจนบุรี,7196,ท้องถิ่นเทศบาลตำบลลาดหญ้า,2588,2820,5408,2601,2830,5431,2398
2565,71,กาญจนบุรี,7197,ท้องถิ่นเทศบาลตำบลแก่งเสี้ยน,2981,3400,6381,2994,3418,6412,3824
2565,71,กาญจนบุรี,7198,ท้องถิ่นเทศบาลเมืองท่าเรือพระแท่น,5062,5646,10708,5105,5687,10792,5121
2565,71,กาญจนบุรี,7199,ท้องถิ่นเทศบาลเมืองกาญจนบุรี,11777,13384,25161,12074,13630,25704,16056
2565,72,สุพรรณบุรี,7201,อำเภอเมืองสุพรรณบุรี,50676,56090,106766,50789,56181,106970,39229
2565,72,สุพรรณบุรี,7202,อำเภอเดิมบางนางบวช,19789,21270,41059,19824,21295,41119,15544
2565,72,สุพรรณบุรี,7203,อำเภอด่านช้าง,30234,31044,61278,30360,31118,61478,24073
2565,72,สุพรรณบุรี,7204,อำเภอบางปลาม้า,28191,29711,57902,28232,29767,57999,19987
2565,72,สุพรรณบุรี,7205,อำเภอศรีประจันต์,19044,20822,39866,19071,20852,39923,15336
2565,72,สุพรรณบุรี,7206,อำเภอดอนเจดีย์,19506,20821,40327,19522,20838,40360,15029
2565,72,สุพรรณบุรี,7207,อำเภอสองพี่น้อง,53651,55860,109511,53839,56028,109867,36839
2565,72,สุพรรณบุรี,7208,อำเภอสามชุก,18923,20542,39465,18965,20567,39532,15200
2565,72,สุพรรณบุรี,7209,อำเภออู่ทอง,31382,33230,64612,31490,33322,64812,22042
2565,72,สุพรรณบุรี,7210,อำเภอหนองหญ้าไซ,22539,23675,46214,22551,23693,46244,16913
2565,72,สุพรรณบุรี,7265,ท้องถิ่นเทศบาลตำบลปากน้ำ,2131,2342,4473,2132,2344,4476,1796
2565,72,สุพรรณบุรี,7266,ท้องถิ่นเทศบาลตำบลท้าวอู่ทอง,7618,8082,15700,7640,8096,15736,5975
2565,72,สุพรรณบุรี,7267,ท้องถิ่นเทศบาลตำบลกระจัน,3554,3729,7283,3559,3733,7292,2009
2565,72,สุพรรณบุรี,7268,ท้องถิ่นเทศบาลตำบลบ้านโข้ง,4421,4563,8984,4423,4565,8988,3225
2565,72,สุพรรณบุรี,7269,ท้องถิ่นเทศบาลตำบลเดิมบาง,3115,3579,6694,3117,3585,6702,2854
2565,72,สุพรรณบุรี,7270,ท้องถิ่นเทศบาลตำบลบางกุ้ง,904,982,1886,909,985,1894,591
2565,72,สุพรรณบุรี,7271,ท้องถิ่นเทศบาลตำบลท่าระหัด,4204,4972,9176,4221,4985,9206,5117
2565,72,สุพรรณบุรี,7272,ท้องถิ่นเทศบาลตำบลตะค่า,2611,2824,5435,2613,2827,5440,1942
2565,72,สุพรรณบุรี,7273,ท้องถิ่นเทศบาลตำบลบ้านดอน,3644,3867,7511,3646,3873,7519,2077
2565,72,สุพรรณบุรี,7274,ท้องถิ่นเทศบาลตำบลต้นคราม,2555,2831,5386,2575,2853,5428,2070
2565,72,สุพรรณบุรี,7275,ท้องถิ่นเทศบาลตำบลปลายนา,3938,4300,8238,3940,4304,8244,2942
2565,72,สุพรรณบุรี,7276,ท้องถิ่นเทศบาลตำบลขุนพัดเพ็ง,2659,2692,5351,2668,2696,5364,1906
2565,72,สุพรรณบุรี,7277,ท้องถิ่นเทศบาลตำบลวังยาง,3274,3611,6885,3280,3616,6896,2799
2565,72,สุพรรณบุรี,7278,ท้องถิ่นเทศบาลตำบลเขาดิน,2945,3077,6022,2947,3078,6025,2048
2565,72,สุพรรณบุรี,7279,ท้องถิ่นเทศบาลตำบลหนองหญ้าไซ,1161,1315,2476,1161,1315,2476,1113
2565,72,สุพรรณบุรี,7280,ท้องถิ่นเทศบาลตำบลอู่ทอง,3477,3872,7349,3491,3882,7373,3683
2565,72,สุพรรณบุรี,7281,ท้องถิ่นเทศบาลตำบลสระยายโสม,1322,1471,2793,1330,1474,2804,1067
2565,72,สุพรรณบุรี,7282,ท้องถิ่นเทศบาลตำบลสามชุก,5879,6666,12545,5897,6677,12574,6866
2565,72,สุพรรณบุรี,7283,ท้องถิ่นเทศบาลตำบลทุ่งคอก,1510,1751,3261,1526,1763,3289,1292
2565,72,สุพรรณบุรี,7284,ท้องถิ่นเทศบาลตำบลสระกระโจม,1197,1169,2366,1200,1171,2371,1025
2565,72,สุพรรณบุรี,7285,ท้องถิ่นเทศบาลตำบลดอนเจดีย์,1346,1442,2788,1393,1482,2875,1389
2565,72,สุพรรณบุรี,7286,ท้องถิ่นเทศบาลตำบลศรีประจันต์,2599,2961,5560,2614,2970,5584,2649
2565,72,สุพรรณบุรี,7287,ท้องถิ่นเทศบาลตำบลไผ่กองดิน,807,848,1655,807,854,1661,626
2565,72,สุพรรณบุรี,7288,ท้องถิ่นเทศบาลตำบลบ้านแหลม,584,591,1175,585,593,1178,454
2565,72,สุพรรณบุรี,7289,ท้องถิ่นเทศบาลตำบลบางปลาม้า,884,943,1827,915,947,1862,683
2565,72,สุพรรณบุรี,7290,ท้องถิ่นเทศบาลตำบลโคกคราม,715,787,1502,721,789,1510,875
2565,72,สุพรรณบุรี,7291,ท้องถิ่นเทศบาลตำบลด่านช้าง,2802,3086,5888,2822,3106,5928,3377
2565,72,สุพรรณบุรี,7292,ท้องถิ่นเทศบาลตำบลบ่อกรุ,930,1041,1971,930,1041,1971,776
2565,72,สุพรรณบุรี,7293,ท้องถิ่นเทศบาลตำบลนางบวช,2077,2218,4295,2078,2221,4299,1669
2565,72,สุพรรณบุรี,7294,ท้องถิ่นเทศบาลตำบลเขาพระ,2547,2947,5494,2573,2968,5541,3293
2565,72,สุพรรณบุรี,7295,ท้องถิ่นเทศบาลตำบลสวนแตง,3121,3343,6464,3135,3351,6486,2332
2565,72,สุพรรณบุรี,7296,ท้องถิ่นเทศบาลตำบลโพธิ์พระยา,1471,1846,3317,1475,1848,3323,1715
2565,72,สุพรรณบุรี,7297,ท้องถิ่นเทศบาลตำบลท่าเสด็จ,6652,7129,13781,6670,7147,13817,4503
2565,72,สุพรรณบุรี,7298,ท้องถิ่นเทศบาลเมืองสองพี่น้อง,5557,6322,11879,5669,6445,12114,5269
2565,72,สุพรรณบุรี,7299,ท้องถิ่นเทศบาลเมืองสุพรรณบุรี,10823,12886,23709,11061,13084,24145,13087
2565,73,นครปฐม,7301,อำเภอเมืองนครปฐม,83205,90555,173760,83496,90813,174309,69278
2565,73,นครปฐม,7302,อำเภอกำแพงแสน,57420,60693,118113,57828,61073,118901,40612
2565,73,นครปฐม,7303,อำเภอนครชัยศรี,47903,52940,100843,48095,53128,101223,40386
2565,73,นครปฐม,7304,อำเภอดอนตูม,17234,18082,35316,17258,18101,35359,11393
2565,73,นครปฐม,7305,อำเภอบางเลน,38882,40094,78976,39535,40724,80259,29968
2565,73,นครปฐม,7306,อำเภอสามพราน,46996,52193,99189,47285,52459,99744,50639
2565,73,นครปฐม,7307,อำเภอพุทธมณฑล,10143,11943,22086,10236,12054,22290,11868
2565,73,นครปฐม,7380,ท้องถิ่นเทศบาลตำบลบ่อพลับ,4481,4995,9476,4520,5011,9531,4933
2565,73,นครปฐม,7381,ท้องถิ่นเทศบาลตำบลบางกระทึก,6795,7827,14622,6827,7853,14680,9389
2565,73,นครปฐม,7382,ท้องถิ่นเทศบาลเมืองกระทุ่มล้ม,13317,15409,28726,13378,15470,28848,18807
2565,73,นครปฐม,7383,ท้องถิ่นเทศบาลเมืองไร่ขิง,15372,17544,32916,16195,18369,34564,25924
2565,73,นครปฐม,7384,ท้องถิ่นเทศบาลเมืองคลองโยง,5064,5664,10728,5092,5694,10786,4534
2565,73,นครปฐม,7385,ท้องถิ่นเทศบาลตำบลศาลายา,6310,5202,11512,6329,5214,11543,8389
2565,73,นครปฐม,7386,ท้องถิ่นเทศบาลตำบลอ้อมใหญ่,11349,12536,23885,11455,12649,24104,21928
2565,73,นครปฐม,7387,ท้องถิ่นเทศบาลเมืองสามพราน,7884,7247,15131,8647,7962,16609,8969
2565,73,นครปฐม,7388,ท้องถิ่นเทศบาลตำบลลำพญา,908,973,1881,911,975,1886,629
2565,73,นครปฐม,7389,ท้องถิ่นเทศบาลตำบลรางกระทุ่ม,989,1040,2029,996,1044,2040,722
2565,73,นครปฐม,7390,ท้องถิ่นเทศบาลตำบลบางหลวง,999,1071,2070,1004,1074,2078,741
2565,73,นครปฐม,7391,ท้องถิ่นเทศบาลตำบลบางเลน,3858,3950,7808,4162,4204,8366,4275
2565,73,นครปฐม,7392,ท้องถิ่นเทศบาลตำบลสามง่าม,6534,7181,13715,6591,7243,13834,5014
2565,73,นครปฐม,7393,ท้องถิ่นเทศบาลตำบลห้วยพลู,905,1011,1916,1024,1130,2154,909
2565,73,นครปฐม,7394,ท้องถิ่นเทศบาลตำบลนครชัยศรี,3618,4381,7999,3624,4385,8009,5135
2565,73,นครปฐม,7395,ท้องถิ่นเทศบาลตำบลกำแพงแสน,3175,3552,6727,3193,3566,6759,4291
2565,73,นครปฐม,7396,ท้องถิ่นเทศบาลตำบลโพรงมะเดื่อ,5137,5633,10770,5153,5647,10800,4332
2565,73,นครปฐม,7397,ท้องถิ่นเทศบาลตำบลธรรมศาลา,3248,3612,6860,3265,3617,6882,2990
2565,73,นครปฐม,7398,ท้องถิ่นเทศบาลตำบลดอนยายหอม,3065,3306,6371,3073,3312,6385,2247
2565,73,นครปฐม,7399,ท้องถิ่นเทศบาลนครนครปฐม,31538,35367,66905,33178,36761,69939,37903
2565,74,สมุทรสาคร,7401,อำเภอเมืองสมุทรสาคร,97940,107845,205785,99484,109143,208627,120210
2565,74,สมุทรสาคร,7402,อำเภอกระทุ่มแบน,31241,33960,65201,31818,34517,66335,39543
2565,74,สมุทรสาคร,7403,อำเภอบ้านแพ้ว,24016,26193,50209,24128,26300,50428,16319
2565,74,สมุทรสาคร,7491,ท้องถิ่นเทศบาลตำบลสวนหลวง,18183,18374,36557,18289,18482,36771,23098
2565,74,สมุทรสาคร,7492,ท้องถิ่นเทศบาลตำบลนาดี,13232,14730,27962,13342,14808,28150,16768
2565,74,สมุทรสาคร,7493,ท้องถิ่นเทศบาลตำบลหลักห้า,20399,21666,42065,20436,21709,42145,11024
2565,74,สมุทรสาคร,7494,ท้องถิ่นเทศบาลตำบลบ้านแพ้ว,1192,1314,2506,1482,1627,3109,1059
2565,74,สมุทรสาคร,7495,ท้องถิ่นเทศบาลตำบลเกษตรพัฒนา,2472,2671,5143,2494,2696,5190,1619
2565,74,สมุทรสาคร,7496,ท้องถิ่นเทศบาลตำบลบางปลา,3474,3776,7250,3483,3778,7261,4570
2565,74,สมุทรสาคร,7497,ท้องถิ่นเทศบาลนครอ้อมน้อย,25242,28062,53304,25393,28193,53586,50012
2565,74,สมุทรสาคร,7498,ท้องถิ่นเทศบาลเมืองกระทุ่มแบน,8337,9280,17617,12876,13433,26309,6604
2565,74,สมุทรสาคร,7499,ท้องถิ่นเทศบาลนครสมุทรสาคร,20728,22533,43261,30249,31268,61517,18997
2565,75,สมุทรสงคราม,7501,อำเภอเมืองสมุทรสงคราม,37450,40870,78320,37565,40984,78549,33252
2565,75,สมุทรสงคราม,7502,อำเภอบางคนที,12754,14086,26840,12777,14096,26873,10135
2565,75,สมุทรสงคราม,7503,อำเภออัมพวา,22765,24689,47454,22790,24723,47513,16070
2565,75,สมุทรสงคราม,7595,ท้องถิ่นเทศบาลตำบลเหมืองใหม่,914,981,1895,915,983,1898,788
2565,75,สมุทรสงคราม,7596,ท้องถิ่นเทศบาลตำบลบางนกแขวก,767,913,1680,771,917,1688,857
2565,75,สมุทรสงคราม,7597,ท้องถิ่นเทศบาลตำบลกระดังงา,982,1131,2113,989,1138,2127,864
2565,75,สมุทรสงคราม,7598,ท้องถิ่นเทศบาลตำบลอัมพวา,2165,2374,4539,2169,2382,4551,1999
2565,75,สมุทรสงคราม,7599,ท้องถิ่นเทศบาลเมืองสมุทรสงคราม,11694,13166,24860,12405,13849,26254,11083
2565,76,เพชรบุรี,7601,อำเภอเมืองเพชรบุรี,42343,48350,90693,42426,48443,90869,36552
2565,76,เพชรบุรี,7602,อำเภอเขาย้อย,11431,12072,23503,11464,12097,23561,10836
2565,76,เพชรบุรี,7603,อำเภอหนองหญ้าปล้อง,8197,8197,16394,8219,8231,16450,7058
2565,76,เพชรบุรี,7604,อำเภอชะอำ,10832,11022,21854,10893,11054,21947,9015
2565,76,เพชรบุรี,7605,อำเภอท่ายาง,23742,25111,48853,23777,25125,48902,20336
2565,76,เพชรบุรี,7606,อำเภอบ้านลาด,22941,25184,48125,22967,25206,48173,16146
2565,76,เพชรบุรี,7607,อำเภอบ้านแหลม,17643,18404,36047,17666,18414,36080,11910
2565,76,เพชรบุรี,7608,อำเภอแก่งกระจาน,16590,15765,32355,17499,16429,33928,15844
2565,76,เพชรบุรี,7688,ท้องถิ่นเทศบาลตำบลท่าแลง,3036,3248,6284,3038,3251,6289,2224
2565,76,เพชรบุรี,7689,ท้องถิ่นเทศบาลตำบลบ้านแหลม,5479,5894,11373,5522,5927,11449,4277
2565,76,เพชรบุรี,7690,ท้องถิ่นเทศบาลตำบลบางตะบูน,2422,2551,4973,2423,2553,4976,1882
2565,76,เพชรบุรี,7691,ท้องถิ่นเทศบาลตำบลบ้านลาด,1692,1978,3670,1695,1978,3673,1716
2565,76,เพชรบุรี,7692,ท้องถิ่นเทศบาลตำบลหนองจอก,1267,1433,2700,1270,1434,2704,1047
2565,76,เพชรบุรี,7693,ท้องถิ่นเทศบาลตำบลท่ายาง,13097,14569,27666,13171,14634,27805,11774
2565,76,เพชรบุรี,7694,ท้องถิ่นเทศบาลตำบลนายาง,9083,9784,18867,9163,9814,18977,7464
2565,76,เพชรบุรี,7695,ท้องถิ่นเทศบาลตำบลเขาย้อย,6936,7621,14557,7200,7898,15098,8374
2565,76,เพชรบุรี,7696,ท้องถิ่นเทศบาลตำบลหาดเจ้าสำราญ,2371,2577,4948,2377,2580,4957,2649
2565,76,เพชรบุรี,7697,ท้องถิ่นเทศบาลตำบลหัวสะพาน,2775,3110,5885,2778,3110,5888,2046
2565,76,เพชรบุรี,7698,ท้องถิ่นเทศบาลเมืองชะอำ,19083,21452,40535,19690,21639,41329,47570
2565,76,เพชรบุรี,7699,ท้องถิ่นเทศบาลเมืองเพชรบุรี,9099,10272,19371,9363,10532,19895,10372
2565,77,ประจวบคีรีขันธ์,7701,อำเภอเมืองประจวบคีรีขันธ์,31813,32179,63992,32269,32481,64750,27151
2565,77,ประจวบคีรีขันธ์,7702,อำเภอกุยบุรี,17034,17511,34545,17151,17628,34779,11551
2565,77,ประจวบคีรีขันธ์,7703,อำเภอทับสะแก,20336,20996,41332,21158,21647,42805,15362
2565,77,ประจวบคีรีขันธ์,7704,อำเภอบางสะพาน,29663,30283,59946,30531,31074,61605,27261
2565,77,ประจวบคีรีขันธ์,7705,อำเภอบางสะพานน้อย,17869,18090,35959,18301,18461,36762,16539
2565,77,ประจวบคีรีขันธ์,7706,อำเภอปราณบุรี,27732,24901,52633,28372,25271,53643,28182
2565,77,ประจวบคีรีขันธ์,7707,อำเภอหัวหิน,25573,28434,54007,26916,29123,56039,31227
2565,77,ประจวบคีรีขันธ์,7708,อำเภอสามร้อยยอด,15530,15948,31478,15673,16011,31684,12790
2565,77,ประจวบคีรีขันธ์,7785,ท้องถิ่นเทศบาลตำบลไร่เก่า,5159,5308,10467,5214,5357,10571,4275
2565,77,ประจวบคีรีขันธ์,7786,ท้องถิ่นเทศบาลตำบลหนองพลับ,2286,2504,4790,2303,2513,4816,2922
2565,77,ประจวบคีรีขันธ์,7787,ท้องถิ่นเทศบาลตำบลปากน้ำปราณ,3848,3833,7681,3869,3851,7720,3512
2565,77,ประจวบคีรีขันธ์,7788,ท้องถิ่นเทศบาลตำบลปราณบุรี,7860,8620,16480,7916,8656,16572,9572
2565,77,ประจวบคีรีขันธ์,7789,ท้องถิ่นเทศบาลตำบลบางสะพานน้อย,1439,1450,2889,1454,1459,2913,1584
2565,77,ประจวบคีรีขันธ์,7790,ท้องถิ่นเทศบาลตำบลร่อนทอง,3782,3948,7730,3837,3981,7818,3494
2565,77,ประจวบคีรีขันธ์,7791,ท้องถิ่นเทศบาลตำบลบ้านกรูด,1943,2140,4083,1967,2151,4118,2363
2565,77,ประจวบคีรีขันธ์,7792,ท้องถิ่นเทศบาลตำบลกำเนิดนพคุณ,1243,1290,2533,1260,1304,2564,1653
2565,77,ประจวบคีรีขันธ์,7793,ท้องถิ่นเทศบาลตำบลทับสะแก,3007,3381,6388,3021,3401,6422,3548
2565,77,ประจวบคีรีขันธ์,7794,ท้องถิ่นเทศบาลตำบลไร่ใหม่,3569,3878,7447,3699,3996,7695,2944
2565,77,ประจวบคีรีขันธ์,7795,ท้องถิ่นเทศบาลตำบลกุยบุรี,4121,4485,8606,4144,4502,8646,4315
2565,77,ประจวบคีรีขันธ์,7796,ท้องถิ่นเทศบาลตำบลคลองวาฬ,2072,2225,4297,2085,2233,4318,1868
2565,77,ประจวบคีรีขันธ์,7797,ท้องถิ่นเทศบาลตำบล กม.5,1698,1850,3548,1770,1872,3642,1423
2565,77,ประจวบคีรีขันธ์,7798,ท้องถิ่นเทศบาลนครหัวหิน,30242,32184,62426,32379,33145,65524,58355
2565,77,ประจวบคีรีขันธ์,7799,ท้องถิ่นเทศบาลเมืองประจวบคีรีขันธ์,7889,9376,17265,8236,9656,17892,11076
2565,80,นครศรีธรรมราช,8001,อำเภอเมืองนครศรีธรรมราช,78822,81235,160057,78894,81260,160154,64838
2565,80,นครศรีธรรมราช,8002,อำเภอพรหมคีรี,13435,13895,27330,13440,13899,27339,9316
2565,80,นครศรีธรรมราช,8003,อำเภอลานสกา,19151,20075,39226,19154,20080,39234,14917
2565,80,นครศรีธรรมราช,8004,อำเภอฉวาง,25745,27087,52832,25838,27176,53014,19481
2565,80,นครศรีธรรมราช,8005,อำเภอพิปูน,8856,9130,17986,8863,9139,18002,7423
2565,80,นครศรีธรรมราช,8006,อำเภอเชียรใหญ่,20156,20083,40239,20164,20090,40254,14820
2565,80,นครศรีธรรมราช,8007,อำเภอชะอวด,40709,41355,82064,40734,41378,82112,30430
2565,80,นครศรีธรรมราช,8008,อำเภอท่าศาลา,55830,58522,114352,55916,58564,114480,37427
2565,80,นครศรีธรรมราช,8009,อำเภอทุ่งสง,59316,57365,116681,59526,57569,117095,49062
2565,80,นครศรีธรรมราช,8010,อำเภอนาบอน,11826,12085,23911,11887,12156,24043,8710
2565,80,นครศรีธรรมราช,8011,อำเภอทุ่งใหญ่,34582,34852,69434,34596,34857,69453,24673
2565,80,นครศรีธรรมราช,8012,อำเภอปากพนัง,38949,38468,77417,38961,38483,77444,26600
2565,80,นครศรีธรรมราช,8013,อำเภอร่อนพิบูลย์,30648,30865,61513,30670,30890,61560,20709
2565,80,นครศรีธรรมราช,8014,อำเภอสิชล,40433,41014,81447,40551,41101,81652,29851
2565,80,นครศรีธรรมราช,8015,อำเภอขนอม,10055,10349,20404,10091,10379,20470,9906
2565,80,นครศรีธรรมราช,8016,อำเภอหัวไทร,21763,21962,43725,21777,21967,43744,18100
2565,80,นครศรีธรรมราช,8017,อำเภอบางขัน,23933,23425,47358,23957,23447,47404,17030
2565,80,นครศรีธรรมราช,8018,อำเภอถ้ำพรรณรา,9591,9581,19172,9610,9597,19207,7545
2565,80,นครศรีธรรมราช,8019,อำเภอจุฬาภรณ์,15500,15977,31477,15504,15979,31483,11014
2565,80,นครศรีธรรมราช,8020,อำเภอพระพรหม,22018,22661,44679,22023,22666,44689,16982
2565,80,นครศรีธรรมราช,8021,อำเภอนบพิตำ,16914,16854,33768,16916,16855,33771,12364
2565,80,นครศรีธรรมราช,8022,อำเภอช้างกลาง,13795,14338,28133,13800,14341,28141,11153
2565,80,นครศรีธรรมราช,8023,อำเภอเฉลิมพระเกียรติ,11113,11194,22307,11118,11195,22313,8112
2565,80,นครศรีธรรมราช,8070,ท้องถิ่นเทศบาลตำบลหน้าสตน,4073,4051,8124,4079,4057,8136,2956
2565,80,นครศรีธรรมราช,8071,ท้องถิ่นเทศบาลตำบลเขาพระ,4059,4070,8129,4060,4070,8130,3395
2565,80,นครศรีธรรมราช,8072,ท้องถิ่นเทศบาลตำบลเกาะเพชร,3428,3378,6806,3430,3381,6811,2194
2565,80,นครศรีธรรมราช,8073,ท้องถิ่นเทศบาลตำบลทางพูน,4525,4366,8891,4527,4368,8895,2924
2565,80,นครศรีธรรมราช,8074,ท้องถิ่นเทศบาลตำบลที่วัง,7195,7230,14425,7200,7232,14432,6619
2565,80,นครศรีธรรมราช,8075,ท้องถิ่นเทศบาลตำบลท้องเนียน,2800,2814,5614,2811,2820,5631,3358
2565,80,นครศรีธรรมราช,8076,ท้องถิ่นเทศบาลตำบลหัวไทร,1949,2146,4095,1953,2151,4104,1876
2565,80,นครศรีธรรมราช,8077,ท้องถิ่นเทศบาลตำบลขนอม,2009,2035,4044,2177,2208,4385,2492
2565,80,นครศรีธรรมราช,8078,ท้องถิ่นเทศบาลตำบลสิชล,3177,3473,6650,3345,3625,6970,4113
2565,80,นครศรีธรรมราช,8079,ท้องถิ่นเทศบาลตำบลหินตก,4147,4154,8301,4148,4156,8304,2848
2565,80,นครศรีธรรมราช,8080,ท้องถิ่นเทศบาลตำบลร่อนพิบูลย์,3603,3946,7549,3616,3951,7567,3385
2565,80,นครศรีธรรมราช,8081,ท้องถิ่นเทศบาลตำบลเขาชุมทอง,2087,2232,4319,2089,2234,4323,1404
2565,80,นครศรีธรรมราช,8082,ท้องถิ่นเทศบาลตำบลท่ายาง,2369,2556,4925,2450,2672,5122,3089
2565,80,นครศรีธรรมราช,8083,ท้องถิ่นเทศบาลตำบลนาบอน,1032,1102,2134,1043,1115,2158,1153
2565,80,นครศรีธรรมราช,8084,ท้องถิ่นเทศบาลตำบลท่าศาลา,1337,1488,2825,1339,1489,2828,1786
2565,80,นครศรีธรรมราช,8085,ท้องถิ่นเทศบาลตำบลชะอวด,1601,1856,3457,1603,1856,3459,1669
2565,80,นครศรีธรรมราช,8086,ท้องถิ่นเทศบาลตำบลเชียรใหญ่,778,818,1596,779,818,1597,771
2565,80,นครศรีธรรมราช,8087,ท้องถิ่นเทศบาลตำบลพิปูน,1301,1392,2693,1302,1392,2694,1137
2565,80,นครศรีธรรมราช,8088,ท้องถิ่นเทศบาลตำบลไม้เรียง,1130,1194,2324,1137,1202,2339,1260
2565,80,นครศรีธรรมราช,8089,ท้องถิ่นเทศบาลตำบลฉวาง,1192,1241,2433,1194,1242,2436,1297
2565,80,นครศรีธรรมราช,8090,ท้องถิ่นเทศบาลตำบลจันดี,3388,3772,7160,3433,3804,7237,4009
2565,80,นครศรีธรรมราช,8091,ท้องถิ่นเทศบาลตำบลลานสกา,867,944,1811,868,944,1812,1027
2565,80,นครศรีธรรมราช,8092,ท้องถิ่นเทศบาลตำบลพรหมโลก,3292,3429,6721,3299,3440,6739,2790
2565,80,นครศรีธรรมราช,8093,ท้องถิ่นเทศบาลตำบลทอนหงส์,1713,1735,3448,1716,1737,3453,1096
2565,80,นครศรีธรรมราช,8094,ท้องถิ่นเทศบาลตำบลปากนคร,3153,3095,6248,3155,3097,6252,2069
2565,80,นครศรีธรรมราช,8095,ท้องถิ่นเทศบาลตำบลบางจาก,877,953,1830,877,953,1830,683
2565,80,นครศรีธรรมราช,8096,ท้องถิ่นเทศบาลตำบลท่าแพ,1867,1931,3798,1870,1933,3803,1281
2565,80,นครศรีธรรมราช,8097,ท้องถิ่นเทศบาลเมืองทุ่งสง,13496,15949,29445,13510,15955,29465,11596
2565,80,นครศรีธรรมราช,8098,ท้องถิ่นเทศบาลเมืองปากพนัง,9349,9603,18952,9379,9620,18999,8112
2565,80,นครศรีธรรมราช,8099,ท้องถิ่นเทศบาลนครนครศรีธรรมราช,46091,51808,97899,46268,51910,98178,47085
2565,81,กระบี่,8101,อำเภอเมืองกระบี่,36813,37511,74324,37098,37657,74755,39830
2565,81,กระบี่,8102,อำเภอเขาพนม,25280,25073,50353,25336,25135,50471,18660
2565,81,กระบี่,8103,อำเภอเกาะลันตา,17660,17252,34912,17761,17310,35071,15120
2565,81,กระบี่,8104,อำเภอคลองท่อม,36401,35394,71795,36469,35474,71943,25552
2565,81,กระบี่,8105,อำเภออ่าวลึก,23192,23507,46699,23225,23538,46763,16935
2565,81,กระบี่,8106,อำเภอปลายพระยา,16274,16195,32469,16288,16216,32504,11318
2565,81,กระบี่,8107,อำเภอลำทับ,10313,10009,20322,10320,10013,20333,7478
2565,81,กระบี่,8108,อำเภอเหนือคลอง,29955,30563,60518,30004,30611,60615,21109
2565,81,กระบี่,8189,ท้องถิ่นเทศบาลตำบลกระบี่น้อย,9238,9553,18791,9251,9568,18819,9079
2565,81,กระบี่,8190,ท้องถิ่นเทศบาลตำบลเหนือคลอง,2108,2303,4411,2120,2307,4427,2461
2565,81,กระบี่,8191,ท้องถิ่นเทศบาลตำบลลำทับ,2076,2216,4292,2116,2251,4367,2430
2565,81,กระบี่,8192,ท้องถิ่นเทศบาลตำบลปลายพระยา,3020,3003,6023,3027,3019,6046,2604
2565,81,กระบี่,8193,ท้องถิ่นเทศบาลตำบลอ่าวลึกใต้,2631,2856,5487,2655,2873,5528,3008
2565,81,กระบี่,8194,ท้องถิ่นเทศบาลตำบลแหลมสัก,2062,2036,4098,2062,2037,4099,1273
2565,81,กระบี่,8195,ท้องถิ่นเทศบาลตำบลคลองพน,1392,1453,2845,1392,1455,2847,1341
2565,81,กระบี่,8196,ท้องถิ่นเทศบาลตำบลคลองท่อมใต้,1573,1731,3304,1573,1731,3304,1808
2565,81,กระบี่,8197,ท้องถิ่นเทศบาลตำบลเกาะลันตาใหญ่,556,575,1131,556,576,1132,504
2565,81,กระบี่,8198,ท้องถิ่นเทศบาลตำบลเขาพนม,2594,2816,5410,2656,2860,5516,2531
2565,81,กระบี่,8199,ท้องถิ่นเทศบาลเมืองกระบี่,14046,16562,30608,14546,16971,31517,18039
2565,82,พังงา,8201,อำเภอเมืองพังงา,15483,15939,31422,15510,15960,31470,12668
2565,82,พังงา,8202,อำเภอเกาะยาว,7300,7199,14499,7349,7243,14592,6033
2565,82,พังงา,8203,อำเภอกะปง,6652,6599,13251,6713,6645,13358,6114
2565,82,พังงา,8204,อำเภอตะกั่วทุ่ง,19668,19510,39178,19748,19599,39347,16404
2565,82,พังงา,8205,อำเภอตะกั่วป่า,20017,20458,40475,20835,21173,42008,24385
2565,82,พังงา,8206,อำเภอคุระบุรี,12261,11971,24232,12438,12161,24599,10499
2565,82,พังงา,8207,อำเภอทับปุด,12503,12479,24982,12534,12515,25049,8331
2565,82,พังงา,8208,อำเภอท้ายเหมือง,22834,22175,45009,23009,22292,45301,21274
2565,82,พังงา,8291,ท้องถิ่นเทศบาลตำบลท้ายเหมือง,1510,1627,3137,1517,1632,3149,1772
2565,82,พังงา,8292,ท้องถิ่นเทศบาลตำบลทับปุด,480,502,982,483,504,987,614
2565,82,พังงา,8293,ท้องถิ่นเทศบาลตำบลคุระบุรี,1648,1678,3326,1724,1740,3464,2162
2565,82,พังงา,8294,ท้องถิ่นเทศบาลเมืองโคกกลอย,1649,1853,3502,1741,1934,3675,1751
2565,82,พังงา,8295,ท้องถิ่นเทศบาลตำบลกระโสม,852,960,1812,853,964,1817,784
2565,82,พังงา,8296,ท้องถิ่นเทศบาลตำบลท่านา,483,519,1002,486,520,1006,598
2565,82,พังงา,8297,ท้องถิ่นเทศบาลตำบลเกาะยาว,0,0,0,0,0,0,0
2565,82,พังงา,8298,ท้องถิ่นเทศบาลเมืองตะกั่วป่า,3737,4065,7802,3752,4069,7821,2821
2565,82,พังงา,8299,ท้องถิ่นเทศบาลเมืองพังงา,4226,4552,8778,4767,5032,9799,6000
2565,83,ภูเก็ต,8301,อำเภอเมืองภูเก็ต,20885,23799,44684,21123,23893,45016,31380
2565,83,ภูเก็ต,8302,อำเภอกะทู้,3293,3654,6947,3377,3691,7068,6753
2565,83,ภูเก็ต,8303,อำเภอถลาง,46138,49049,95187,46722,49323,96045,73523
2565,83,ภูเก็ต,8391,ท้องถิ่นเทศบาลตำบลวิชิต,24272,27951,52223,24718,28338,53056,35517
2565,83,ภูเก็ต,8392,ท้องถิ่นเทศบาลตำบลราไวย์,8535,9992,18527,8794,10078,18872,19980
2565,83,ภูเก็ต,8393,ท้องถิ่นเทศบาลตำบลรัษฎา,23013,25830,48843,23326,26098,49424,31177
2565,83,ภูเก็ต,8394,ท้องถิ่นเทศบาลตำบลเทพกระษัตรี,4267,4564,8831,4672,4908,9580,5120
2565,83,ภูเก็ต,8395,ท้องถิ่นเทศบาลตำบลเชิงทะเล,3067,3791,6858,3128,3845,6973,3703
2565,83,ภูเก็ต,8396,ท้องถิ่นเทศบาลเมืองกะทู้,13850,16515,30365,14225,16592,30817,21728
2565,83,ภูเก็ต,8397,ท้องถิ่นเทศบาลตำบลกะรน,3499,3885,7384,3556,3915,7471,8853
2565,83,ภูเก็ต,8398,ท้องถิ่นเทศบาลเมืองป่าตอง,8500,9431,17931,9222,10018,19240,16577
2565,83,ภูเก็ต,8399,ท้องถิ่นเทศบาลนครภูเก็ต,31526,37680,69206,34238,40091,74329,26893
2565,84,สุราษฎร์ธานี,8401,อำเภอเมืองสุราษฎร์ธานี,8999,10000,18999,9006,10009,19015,8115
2565,84,สุราษฎร์ธานี,8402,อำเภอกาญจนดิษฐ์,40242,40906,81148,40410,41041,81451,34569
2565,84,สุราษฎร์ธานี,8403,อำเภอดอนสัก,12360,12424,24784,12449,12466,24915,10732
2565,84,สุราษฎร์ธานี,8405,อำเภอเกาะพะงัน,5004,5068,10072,5624,5419,11043,12725
2565,84,สุราษฎร์ธานี,8406,อำเภอไชยา,18851,19734,38585,18887,19758,38645,17193
2565,84,สุราษฎร์ธานี,8407,อำเภอท่าชนะ,26013,25740,51753,26049,25768,51817,23078
2565,84,สุราษฎร์ธานี,8408,อำเภอคีรีรัฐนิคม,21039,21167,42206,21088,21231,42319,17334
2565,84,สุราษฎร์ธานี,8409,อำเภอบ้านตาขุน,4538,4593,9131,4542,4596,9138,4035
2565,84,สุราษฎร์ธานี,8410,อำเภอพนม,12459,11986,24445,12470,11995,24465,9605
2565,84,สุราษฎร์ธานี,8411,อำเภอท่าฉาง,14808,14689,29497,14829,14706,29535,13273
2565,84,สุราษฎร์ธานี,8412,อำเภอบ้านนาสาร,25062,25640,50702,25070,25653,50723,18635
2565,84,สุราษฎร์ธานี,8413,อำเภอบ้านนาเดิม,10325,10510,20835,10330,10512,20842,7926
2565,84,สุราษฎร์ธานี,8414,อำเภอเคียนซา,13735,13713,27448,13846,13826,27672,11513
2565,84,สุราษฎร์ธานี,8415,อำเภอเวียงสระ,8522,8780,17302,8524,8781,17305,7078
2565,84,สุราษฎร์ธานี,8416,อำเภอพระแสง,31523,31213,62736,31532,31225,62757,24817
2565,84,สุราษฎร์ธานี,8417,อำเภอพุนพิน,37747,37303,75050,37864,37431,75295,36864
2565,84,สุราษฎร์ธานี,8418,อำเภอชัยบุรี,14262,14027,28289,14279,14044,28323,11700
2565,84,สุราษฎร์ธานี,8419,อำเภอวิภาวดี,8144,7582,15726,8210,7645,15855,7497
2565,84,สุราษฎร์ธานี,8471,ท้องถิ่นเทศบาลตำบลบ้านเสด็จ,9798,9609,19407,9801,9609,19410,7907
2565,84,สุราษฎร์ธานี,8472,ท้องถิ่นเทศบาลตำบลคลองชะอุ่น,4902,4847,9749,4902,4851,9753,3488
2565,84,สุราษฎร์ธานี,8473,ท้องถิ่นเทศบาลตำบลทุ่งหลวง,5459,5769,11228,5460,5771,11231,4270
2565,84,สุราษฎร์ธานี,8474,ท้องถิ่นเทศบาลตำบลขุนทะเล,7904,11160,19064,7920,11242,19162,11625
2565,84,สุราษฎร์ธานี,8475,ท้องถิ่นเทศบาลตำบลช้างซ้าย,5522,5592,11114,5533,5601,11134,4000
2565,84,สุราษฎร์ธานี,8476,ท้องถิ่นเทศบาลตำบลเขานิพันธ์,3367,3409,6776,3367,3409,6776,2995
2565,84,สุราษฎร์ธานี,8477,ท้องถิ่นเทศบาลตำบลวัดประดู่,9326,10433,19759,9344,10438,19782,11831
2565,84,สุราษฎร์ธานี,8478,ท้องถิ่นเทศบาลตำบลบ้านส้อง,8682,8869,17551,8683,8872,17555,7031
2565,84,สุราษฎร์ธานี,8479,ท้องถิ่นเทศบาลตำบลย่านดินแดง,1135,1179,2314,1158,1195,2353,1089
2565,84,สุราษฎร์ธานี,8480,ท้องถิ่นเทศบาลตำบลบางสวรรค์,2060,2097,4157,2060,2097,4157,2005
2565,84,สุราษฎร์ธานี,8481,ท้องถิ่นเทศบาลเมืองเวียงสระ,4327,4849,9176,4398,4923,9321,5885
2565,84,สุราษฎร์ธานี,8482,ท้องถิ่นเทศบาลตำบลเคียนซา,857,814,1671,858,814,1672,754
2565,84,สุราษฎร์ธานี,8483,ท้องถิ่นเทศบาลตำบลบ้านนา,1555,1655,3210,1568,1663,3231,1705
2565,84,สุราษฎร์ธานี,8484,ท้องถิ่นเทศบาลตำบลท่าฉาง,2211,2376,4587,2242,2404,4646,1983
2565,84,สุราษฎร์ธานี,8485,ท้องถิ่นเทศบาลตำบลพนม,2460,2415,4875,2479,2434,4913,2029
2565,84,สุราษฎร์ธานี,8486,ท้องถิ่นเทศบาลตำบลบ้านตาขุน,1149,1220,2369,1151,1221,2372,1870
2565,84,สุราษฎร์ธานี,8487,ท้องถิ่นเทศบาลตำบลบ้านเชี่ยวหลาน,2282,2256,4538,2284,2256,4540,2022
2565,84,สุราษฎร์ธานี,8488,ท้องถิ่นเทศบาลตำบลท่าขนอน,913,925,1838,920,927,1847,1110
2565,84,สุราษฎร์ธานี,8489,ท้องถิ่นเทศบาลตำบลท่าชนะ,1354,1518,2872,1356,1521,2877,1783
2565,84,สุราษฎร์ธานี,8490,ท้องถิ่นเทศบาลตำบลพุมเรียง,3844,4013,7857,3844,4014,7858,2866
2565,84,สุราษฎร์ธานี,8491,ท้องถิ่นเทศบาลตำบลตลาดไชยา,2239,2569,4808,2409,2734,5143,2943
2565,84,สุราษฎร์ธานี,8492,ท้องถิ่นเทศบาลตำบลเกาะพะงัน,3539,3720,7259,3807,3842,7649,5726
2565,84,สุราษฎร์ธานี,8493,ท้องถิ่นเทศบาลนครเกาะสมุย,30465,33750,64215,32361,35087,67448,57931
2565,84,สุราษฎร์ธานี,8494,ท้องถิ่นเทศบาลเมืองดอนสัก,5807,6142,11949,5835,6173,12008,5940
2565,84,สุราษฎร์ธานี,8495,ท้องถิ่นเทศบาลตำบลท่าทองใหม่,3525,3588,7113,3530,3591,7121,3247
2565,84,สุราษฎร์ธานี,8496,ท้องถิ่นเทศบาลตำบลกาญจนดิษฐ์,4488,4909,9397,4492,4911,9403,4860
2565,84,สุราษฎร์ธานี,8497,ท้องถิ่นเทศบาลเมืองท่าข้าม,8741,9319,18060,8841,9430,18271,9152
2565,84,สุราษฎร์ธานี,8498,ท้องถิ่นเทศบาลเมืองนาสาร,9256,9759,19015,9283,9775,19058,8389
2565,84,สุราษฎร์ธานี,8499,ท้องถิ่นเทศบาลนครสุราษฎร์ธานี,61831,68490,130321,62660,69197,131857,77587
2565,85,ระนอง,8501,อำเภอเมืองระนอง,32519,32264,64783,35717,34975,70692,39155
2565,85,ระนอง,8502,อำเภอละอุ่น,6314,6173,12487,6362,6222,12584,5691
2565,85,ระนอง,8503,อำเภอกะเปอร์,10190,9980,20170,10414,10186,20600,8232
2565,85,ระนอง,8504,อำเภอกระบุรี,22304,21620,43924,22698,21987,44685,22924
2565,85,ระนอง,8505,อำเภอสุขสำราญ,6971,7015,13986,7232,7259,14491,4713
2565,85,ระนอง,8594,ท้องถิ่นเทศบาลตำบลน้ำจืด,1599,1655,3254,1765,1784,3549,1965
2565,85,ระนอง,8595,ท้องถิ่นเทศบาลตำบลกะเปอร์,714,751,1465,718,755,1473,678
2565,85,ระนอง,8596,ท้องถิ่นเทศบาลตำบลละอุ่น,1277,1218,2495,1362,1297,2659,1225
2565,85,ระนอง,8597,ท้องถิ่นเทศบาลตำบลหงาว,1131,1216,2347,1176,1273,2449,1108
2565,85,ระนอง,8598,ท้องถิ่นเทศบาลตำบลปากน้ำ,1232,1109,2341,1271,1164,2435,1815
2565,85,ระนอง,8599,ท้องถิ่นเทศบาลเมืองระนอง,5892,6456,12348,9088,9521,18609,8246
2565,86,ชุมพร,8601,อำเภอเมืองชุมพร,46113,46765,92878,46179,46828,93007,45963
2565,86,ชุมพร,8602,อำเภอท่าแซะ,40905,41135,82040,41295,41509,82804,36366
2565,86,ชุมพร,8603,อำเภอปะทิว,19641,20174,39815,19738,20245,39983,18530
2565,86,ชุมพร,8604,อำเภอหลังสวน,27225,28480,55705,27437,28656,56093,24738
2565,86,ชุมพร,8605,อำเภอละแม,12977,12951,25928,13114,13064,26178,12110
2565,86,ชุมพร,8606,อำเภอพะโต๊ะ,11841,11398,23239,11846,11400,23246,11018
2565,86,ชุมพร,8607,อำเภอสวี,34717,35076,69793,34778,35137,69915,33052
2565,86,ชุมพร,8608,อำเภอทุ่งตะโก,10783,10712,21495,10812,10737,21549,9942
2565,86,ชุมพร,8685,ท้องถิ่นเทศบาลเมืองท่ายาง,5019,5275,10294,5031,5278,10309,4855
2565,86,ชุมพร,8686,ท้องถิ่นเทศบาลตำบลปากตะโก,2035,2025,4060,2037,2026,4063,1680
2565,86,ชุมพร,8687,ท้องถิ่นเทศบาลตำบลนาโพธิ์,1362,1552,2914,1365,1553,2918,1700
2565,86,ชุมพร,8688,ท้องถิ่นเทศบาลตำบลพะโต๊ะ,740,727,1467,748,732,1480,696
2565,86,ชุมพร,8689,ท้องถิ่นเทศบาลตำบลละแม,1499,1642,3141,1506,1652,3158,1964
2565,86,ชุมพร,8690,ท้องถิ่นเทศบาลตำบลปากน้ำหลังสวน,3130,3214,6344,3157,3240,6397,3122
2565,86,ชุมพร,8691,ท้องถิ่นเทศบาลตำบลสะพลี,1036,1119,2155,1040,1119,2159,1183
2565,86,ชุมพร,8692,ท้องถิ่นเทศบาลตำบลมาบอำมฤต,1688,1700,3388,1848,1882,3730,2252
2565,86,ชุมพร,8693,ท้องถิ่นเทศบาลตำบลปะทิว,540,623,1163,608,700,1308,888
2565,86,ชุมพร,8694,ท้องถิ่นเทศบาลตำบลเนินสันติ,916,958,1874,919,964,1883,1295
2565,86,ชุมพร,8695,ท้องถิ่นเทศบาลตำบลท่าแซะ,943,1058,2001,943,1061,2004,1389
2565,86,ชุมพร,8696,ท้องถิ่นเทศบาลตำบลวังไผ่,3193,3530,6723,3200,3533,6733,4742
2565,86,ชุมพร,8697,ท้องถิ่นเทศบาลตำบลปากน้ำชุมพร,2847,3038,5885,3055,3220,6275,3460
2565,86,ชุมพร,8698,ท้องถิ่นเทศบาลเมืองหลังสวน,5123,5827,10950,5138,5836,10974,7012
2565,86,ชุมพร,8699,ท้องถิ่นเทศบาลเมืองชุมพร,14810,17285,32095,15432,17787,33219,20354
2565,90,สงขลา,9001,อำเภอเมืองสงขลา,7284,7967,15251,7297,7970,15267,5697
2565,90,สงขลา,9002,อำเภอสทิงพระ,21737,22843,44580,21747,22848,44595,14132
2565,90,สงขลา,9003,อำเภอจะนะ,50363,51216,101579,50396,51247,101643,28718
2565,90,สงขลา,9004,อำเภอนาทวี,31839,31217,63056,31874,31246,63120,20023
2565,90,สงขลา,9005,อำเภอเทพา,31163,29437,60600,31210,29492,60702,17093
2565,90,สงขลา,9006,อำเภอสะบ้าย้อย,40131,39293,79424,40210,39357,79567,19896
2565,90,สงขลา,9007,อำเภอระโนด,23691,24335,48026,23710,24363,48073,19812
2565,90,สงขลา,9008,อำเภอกระแสสินธุ์,7289,7532,14821,7293,7534,14827,5358
2565,90,สงขลา,9009,อำเภอรัตภูมิ,33453,34066,67519,33700,34075,67775,22685
2565,90,สงขลา,9010,อำเภอสะเดา,29263,29008,58271,29475,29215,58690,21868
2565,90,สงขลา,9011,อำเภอหาดใหญ่,15126,16440,31566,15163,16469,31632,13833
2565,90,สงขลา,9012,อำเภอนาหม่อม,11050,11903,22953,11069,11910,22979,9464
2565,90,สงขลา,9013,อำเภอควนเนียง,14761,15424,30185,14782,15440,30222,10189
2565,90,สงขลา,9014,อำเภอบางกล่ำ,4988,5138,10126,5068,5191,10259,3713
2565,90,สงขลา,9015,อำเภอสิงหนคร,21430,22595,44025,21438,22596,44034,15197
2565,90,สงขลา,9016,อำเภอคลองหอยโข่ง,6020,5822,11842,6061,5873,11934,5354
2565,90,สงขลา,9066,ท้องถิ่นเทศบาลเมืองทุ่งตำเสา,8318,8793,17111,8329,8803,17132,6353
2565,90,สงขลา,9067,ท้องถิ่นเทศบาลตำบลโคกม่วง,4305,3516,7821,4308,3523,7831,2825
2565,90,สงขลา,9068,ท้องถิ่นเทศบาลตำบลทุ่งลาน,3626,3898,7524,3632,3898,7530,2667
2565,90,สงขลา,9069,ท้องถิ่นเทศบาลตำบลเกาะแต้ว,5699,5979,11678,5704,5981,11685,3923
2565,90,สงขลา,9070,ท้องถิ่นเทศบาลตำบลคูเต่า,5762,5829,11591,5768,5830,11598,3321
2565,90,สงขลา,9071,ท้องถิ่นเทศบาลตำบลท่าช้าง,11357,11527,22884,11372,11535,22907,10301
2565,90,สงขลา,9072,ท้องถิ่นเทศบาลตำบลน้ำน้อย,7153,8038,15191,7173,8040,15213,6402
2565,90,สงขลา,9073,ท้องถิ่นเทศบาลตำบลลำไพล,7823,8001,15824,7853,8020,15873,4713
2565,90,สงขลา,9074,ท้องถิ่นเทศบาลตำบลบ้านไร่,3943,4213,8156,3957,4217,8174,3536
2565,90,สงขลา,9075,ท้องถิ่นเทศบาลตำบลพะวง,16231,17786,34017,16708,18245,34953,16075
2565,90,สงขลา,9076,ท้องถิ่นเทศบาลเมืองเขารูปช้าง,20230,22816,43046,20274,22828,43102,21361
2565,90,สงขลา,9077,ท้องถิ่นเทศบาลตำบลสำนักขาม,6196,7272,13468,6261,7314,13575,9392
2565,90,สงขลา,9078,ท้องถิ่นเทศบาลเมืองคลองแห,19982,22606,42588,20012,22626,42638,22007
2565,90,สงขลา,9079,ท้องถิ่นเทศบาลเมืองควนลัง,23679,27050,50729,23758,27111,50869,27106
2565,90,สงขลา,9080,ท้องถิ่นเทศบาลเมืองคอหงส์,21646,24031,45677,21762,24096,45858,29026
2565,90,สงขลา,9081,ท้องถิ่นเทศบาลเมืองสิงหนคร,19664,20124,39788,19682,20130,39812,13624
2565,90,สงขลา,9082,ท้องถิ่นเทศบาลตำบลควนเนียง,1872,2158,4030,1886,2168,4054,1790
2565,90,สงขลา,9083,ท้องถิ่นเทศบาลตำบลพะตง,3556,4052,7608,3592,4078,7670,4824
2565,90,สงขลา,9084,ท้องถิ่นเทศบาลตำบลคลองแงะ,3904,4134,8038,3964,4188,8152,3502
2565,90,สงขลา,9085,ท้องถิ่นเทศบาลเมืองปาดังเบซาร์,7608,8030,15638,7638,8053,15691,6327
2565,90,สงขลา,9086,ท้องถิ่นเทศบาลตำบลปริก,3100,3287,6387,3109,3288,6397,2094
2565,90,สงขลา,9087,ท้องถิ่นเทศบาลตำบลนาสีทอง,1364,1528,2892,1365,1529,2894,1159
2565,90,สงขลา,9088,ท้องถิ่นเทศบาลตำบลกำแพงเพชร,2297,2480,4777,2345,2535,4880,2644
2565,90,สงขลา,9089,ท้องถิ่นเทศบาลตำบลระโนด,2050,2288,4338,2052,2290,4342,1987
2565,90,สงขลา,9090,ท้องถิ่นเทศบาลตำบลบ่อตรุ,5355,5598,10953,5356,5598,10954,3568
2565,90,สงขลา,9091,ท้องถิ่นเทศบาลตำบลสะบ้าย้อย,612,663,1275,612,663,1275,796
2565,90,สงขลา,9092,ท้องถิ่นเทศบาลตำบลเทพา,1125,1150,2275,1133,1158,2291,1084
2565,90,สงขลา,9093,ท้องถิ่นเทศบาลตำบลนาทวี,2902,2952,5854,3105,3125,6230,3751
2565,90,สงขลา,9094,ท้องถิ่นเทศบาลตำบลจะนะ,3297,3464,6761,3361,3506,6867,3404
2565,90,สงขลา,9095,ท้องถิ่นเทศบาลตำบลสทิงพระ,1275,1440,2715,1277,1440,2717,1312
2565,90,สงขลา,9096,ท้องถิ่นเทศบาลเมืองบ้านพรุ,12883,14244,27127,12930,14270,27200,13187
2565,90,สงขลา,9097,ท้องถิ่นเทศบาลเมืองสะเดา,10225,10914,21139,10481,11161,21642,8964
2565,90,สงขลา,9098,ท้องถิ่นเทศบาลนครหาดใหญ่,64873,76623,141496,67536,78992,146528,68976
2565,90,สงขลา,9099,ท้องถิ่นเทศบาลนครสงขลา,27627,29471,57098,27694,29516,57210,27612
2565,91,สตูล,9101,อำเภอเมืองสตูล,32646,33452,66098,32679,33481,66160,19042
2565,91,สตูล,9102,อำเภอควนโดน,10925,10996,21921,10934,10997,21931,6181
2565,91,สตูล,9103,อำเภอควนกาหลง,17882,17809,35691,17890,17818,35708,12164
2565,91,สตูล,9104,อำเภอท่าแพ,14755,15005,29760,14770,15008,29778,8984
2565,91,สตูล,9105,อำเภอละงู,34210,34589,68799,34328,34696,69024,21598
2565,91,สตูล,9106,อำเภอทุ่งหว้า,10704,10620,21324,10725,10634,21359,6888
2565,91,สตูล,9107,อำเภอมะนัง,9498,9157,18655,9502,9158,18660,6531
2565,91,สตูล,9193,ท้องถิ่นเทศบาลตำบลคลองขุด,10529,9938,20467,10539,9944,20483,9347
2565,91,สตูล,9194,ท้องถิ่นเทศบาลตำบลทุ่งหว้า,1581,1636,3217,1583,1636,3219,1250
2565,91,สตูล,9195,ท้องถิ่นเทศบาลตำบลกำแพง,2352,2601,4953,2355,2604,4959,2909
2565,91,สตูล,9196,ท้องถิ่นเทศบาลตำบลควนโดน,2705,2754,5459,2707,2757,5464,1979
2565,91,สตูล,9197,ท้องถิ่นเทศบาลตำบลฉลุง,1115,1219,2334,1115,1219,2334,1013
2565,91,สตูล,9198,ท้องถิ่นเทศบาลตำบลเจ๊ะบิลัง,2005,2009,4014,2014,2018,4032,1017
2565,91,สตูล,9199,ท้องถิ่นเทศบาลเมืองสตูล,10669,11402,22071,10737,11455,22192,10127
2565,92,ตรัง,9201,อำเภอเมืองตรัง,45857,49497,95354,45924,49534,95458,41675
2565,92,ตรัง,9202,อำเภอกันตัง,37333,37666,74999,37353,37688,75041,24679
2565,92,ตรัง,9203,อำเภอย่านตาขาว,27773,28864,56637,27814,28891,56705,18271
2565,92,ตรัง,9204,อำเภอปะเหลียน,30903,31708,62611,30956,31751,62707,21985
2565,92,ตรัง,9205,อำเภอสิเกา,17610,17264,34874,17636,17292,34928,12826
2565,92,ตรัง,9206,อำเภอห้วยยอด,38488,39655,78143,38568,39724,78292,27302
2565,92,ตรัง,9207,อำเภอวังวิเศษ,20084,20439,40523,20097,20453,40550,14164
2565,92,ตรัง,9208,อำเภอนาโยง,19902,21214,41116,19911,21216,41127,13834
2565,92,ตรัง,9209,อำเภอรัษฎา,13283,13579,26862,13306,13606,26912,10024
2565,92,ตรัง,9210,อำเภอหาดสำราญ,8467,8391,16858,8473,8398,16871,5000
2565,92,ตรัง,9286,ท้องถิ่นเทศบาลตำบลคลองปาง,1068,1154,2222,1069,1155,2224,1363
2565,92,ตรัง,9287,ท้องถิ่นเทศบาลตำบลนาโยงเหนือ,1650,1832,3482,1653,1835,3488,1586
2565,92,ตรัง,9288,ท้องถิ่นเทศบาลตำบลวังวิเศษ,1449,1470,2919,1470,1490,2960,1370
2565,92,ตรัง,9289,ท้องถิ่นเทศบาลตำบลลำภูรา,1902,1457,3359,1903,1457,3360,1514
2565,92,ตรัง,9290,ท้องถิ่นเทศบาลตำบลนาวง,1930,2073,4003,1937,2073,4010,1849
2565,92,ตรัง,9291,ท้องถิ่นเทศบาลตำบลสิเกา,630,689,1319,662,715,1377,667
2565,92,ตรัง,9292,ท้องถิ่นเทศบาลตำบลควนกุน,1035,1087,2122,1035,1087,2122,773
2565,92,ตรัง,9293,ท้องถิ่นเทศบาลตำบลทุ่งยาว,1125,1291,2416,1131,1295,2426,1105
2565,92,ตรัง,9294,ท้องถิ่นเทศบาลตำบลท่าข้าม,681,678,1359,683,680,1363,667
2565,92,ตรัง,9295,ท้องถิ่นเทศบาลตำบลย่านตาขาว,3440,4014,7454,3458,4035,7493,3842
2565,92,ตรัง,9296,ท้องถิ่นเทศบาลตำบลคลองเต็ง,1809,1983,3792,1816,1985,3801,1780
2565,92,ตรัง,9297,ท้องถิ่นเทศบาลตำบลห้วยยอด,3813,4200,8013,3822,4205,8027,4178
2565,92,ตรัง,9298,ท้องถิ่นเทศบาลเมืองกันตัง,5589,5802,11391,5640,5845,11485,5105
2565,92,ตรัง,9299,ท้องถิ่นเทศบาลนครตรัง,25280,29705,54985,25532,29947,55479,25600
2565,93,พัทลุง,9301,อำเภอเมืองพัทลุง,42669,46618,89287,42706,46632,89338,34908
2565,93,พัทลุง,9302,อำเภอกงหรา,14662,14762,29424,14664,14765,29429,9651
2565,93,พัทลุง,9303,อำเภอเขาชัยสน,15155,15818,30973,15163,15822,30985,11777
2565,93,พัทลุง,9304,อำเภอตะโหมด,7098,7201,14299,7102,7203,14305,4827
2565,93,พัทลุง,9305,อำเภอควนขนุน,37817,40983,78800,37827,40987,78814,30712
2565,93,พัทลุง,9306,อำเภอปากพะยูน,16129,16663,32792,16131,16667,32798,11253
2565,93,พัทลุง,9307,อำเภอศรีบรรพต,9013,9056,18069,9017,9065,18082,7012
2565,93,พัทลุง,9308,อำเภอป่าบอน,21654,22111,43765,21659,22112,43771,16123
2565,93,พัทลุง,9309,อำเภอบางแก้ว,8901,9039,17940,8907,9042,17949,6577
2565,93,พัทลุง,9310,อำเภอป่าพะยอม,13209,13754,26963,13215,13763,26978,10992
2565,93,พัทลุง,9311,อำเภอศรีนครินทร์,5124,5285,10409,5126,5288,10414,3695
2565,93,พัทลุง,9382,ท้องถิ่นเทศบาลตำบลเขาหัวช้าง,3611,3606,7217,3611,3607,7218,2193
2565,93,พัทลุง,9383,ท้องถิ่นเทศบาลตำบลชะรัด,3605,3683,7288,3607,3684,7291,2323
2565,93,พัทลุง,9384,ท้องถิ่นเทศบาลตำบลหารเทา,4898,5111,10009,4902,5111,10013,3538
2565,93,พัทลุง,9385,ท้องถิ่นเทศบาลตำบลบางแก้ว,1863,1928,3791,1865,1929,3794,1462
2565,93,พัทลุง,9386,ท้องถิ่นเทศบาลตำบลอ่าวพะยูน,2274,2348,4622,2279,2350,4629,1670
2565,93,พัทลุง,9387,ท้องถิ่นเทศบาลตำบลชุมพล,4714,4136,8850,4717,4136,8853,3616
2565,93,พัทลุง,9388,ท้องถิ่นเทศบาลตำบลโคกม่วง,5091,5309,10400,5091,5310,10401,3696
2565,93,พัทลุง,9389,ท้องถิ่นเทศบาลตำบลบ้านนา,3692,3775,7467,3694,3776,7470,3171
2565,93,พัทลุง,9390,ท้องถิ่นเทศบาลตำบลลานข่อย,4194,4478,8672,4199,4478,8677,3018
2565,93,พัทลุง,9391,ท้องถิ่นเทศบาลตำบลท่ามะเดื่อ,1946,2121,4067,1948,2123,4071,1857
2565,93,พัทลุง,9392,ท้องถิ่นเทศบาลตำบลป่าบอน,1920,2004,3924,1921,2004,3925,1770
2565,93,พัทลุง,9393,ท้องถิ่นเทศบาลตำบลปากพะยูน,1501,1612,3113,1505,1615,3120,1532
2565,93,พัทลุง,9394,ท้องถิ่นเทศบาลตำบลมะกอกเหนือ,997,1150,2147,999,1153,2152,805
2565,93,พัทลุง,9395,ท้องถิ่นเทศบาลตำบลควนขนุน,940,1094,2034,943,1097,2040,1194
2565,93,พัทลุง,9396,ท้องถิ่นเทศบาลตำบลแม่ขรี,3010,3206,6216,3017,3210,6227,3486
2565,93,พัทลุง,9397,ท้องถิ่นเทศบาลตำบลตะโหมด,2105,2219,4324,2105,2219,4324,1581
2565,93,พัทลุง,9398,ท้องถิ่นเทศบาลตำบลเขาชัยสน,1644,1826,3470,1648,1831,3479,1633
2565,93,พัทลุง,9399,ท้องถิ่นเทศบาลเมืองพัทลุง,14180,16766,30946,14249,16823,31072,16295
2565,94,ปัตตานี,9401,อำเภอเมืองปัตตานี,43923,47366,91289,43987,47422,91409,32235
2565,94,ปัตตานี,9402,อำเภอโคกโพธิ์,30574,32016,62590,30589,32023,62612,18229
2565,94,ปัตตานี,9403,อำเภอหนองจิก,29914,30191,60105,29921,30193,60114,13970
2565,94,ปัตตานี,9404,อำเภอปะนาเระ,18172,18837,37009,18181,18843,37024,9823
2565,94,ปัตตานี,9405,อำเภอมายอ,28139,28798,56937,28154,28813,56967,13188
2565,94,ปัตตานี,9406,อำเภอทุ่งยางแดง,12613,13041,25654,12615,13046,25661,6027
2565,94,ปัตตานี,9407,อำเภอสายบุรี,28006,29289,57295,28015,29294,57309,13907
2565,94,ปัตตานี,9408,อำเภอไม้แก่น,6440,6647,13087,6440,6648,13088,3497
2565,94,ปัตตานี,9409,อำเภอยะหริ่ง,35527,35964,71491,35566,35998,71564,16523
2565,94,ปัตตานี,9410,อำเภอยะรัง,45624,45724,91348,45642,45736,91378,21952
2565,94,ปัตตานี,9411,อำเภอกะพ้อ,9481,9750,19231,9483,9751,19234,4559
2565,94,ปัตตานี,9412,อำเภอแม่ลาน,8763,9055,17818,8769,9060,17829,4648
2565,94,ปัตตานี,9488,ท้องถิ่นเทศบาลตำบลยะรัง,2487,2640,5127,2487,2641,5128,1405
2565,94,ปัตตานี,9489,ท้องถิ่นเทศบาลตำบลยะหริ่ง,3187,3087,6274,3189,3089,6278,1973
2565,94,ปัตตานี,9490,ท้องถิ่นเทศบาลตำบลบางปู,5205,5286,10491,5207,5287,10494,2363
2565,94,ปัตตานี,9491,ท้องถิ่นเทศบาลตำบลตันหยง,1337,1524,2861,1341,1525,2866,743
2565,94,ปัตตานี,9492,ท้องถิ่นเทศบาลตำบลมายอ,2457,2468,4925,2460,2469,4929,1248
2565,94,ปัตตานี,9493,ท้องถิ่นเทศบาลตำบลปะนาเระ,5380,5390,10770,5381,5391,10772,2783
2565,94,ปัตตานี,9494,ท้องถิ่นเทศบาลตำบลหนองจิก,3116,3119,6235,3121,3126,6247,2052
2565,94,ปัตตานี,9495,ท้องถิ่นเทศบาลตำบลบ่อทอง,9773,6435,16208,9778,6438,16216,6011
2565,94,ปัตตานี,9496,ท้องถิ่นเทศบาลตำบลนาประดู่,1473,1618,3091,1476,1619,3095,1443
2565,94,ปัตตานี,9497,ท้องถิ่นเทศบาลตำบลโคกโพธิ์,1557,1778,3335,1558,1779,3337,1875
2565,94,ปัตตานี,9498,ท้องถิ่นเทศบาลเมืองตะลุบัน,7110,7396,14506,7134,7417,14551,4590
2565,94,ปัตตานี,9499,ท้องถิ่นเทศบาลเมืองปัตตานี,21194,22537,43731,21769,23084,44853,16389
2565,95,ยะลา,9501,อำเภอเมืองยะลา,38170,39156,77326,38178,39161,77339,19449
2565,95,ยะลา,9502,อำเภอเบตง,18451,17322,35773,18677,17595,36272,16004
2565,95,ยะลา,9503,อำเภอบันนังสตา,29018,27904,56922,29072,27954,57026,16226
2565,95,ยะลา,9504,อำเภอธารโต,12748,11701,24449,12811,11741,24552,9261
2565,95,ยะลา,9505,อำเภอยะหา,31355,31144,62499,31362,31148,62510,14882
2565,95,ยะลา,9506,อำเภอรามัน,43137,44056,87193,43153,44065,87218,21223
2565,95,ยะลา,9507,อำเภอกาบัง,13223,12663,25886,13235,12673,25908,7315
2565,95,ยะลา,9508,อำเภอกรงปินัง,15391,15172,30563,15395,15172,30567,6501
2565,95,ยะลา,9590,ท้องถิ่นเทศบาลเมืองสะเตงนอก,17252,18645,35897,17258,18653,35911,16144
2565,95,ยะลา,9591,ท้องถิ่นเทศบาลตำบลเขื่อนบางลาง,2382,2196,4578,2382,2196,4578,2048
2565,95,ยะลา,9592,ท้องถิ่นเทศบาลตำบลโกตาบารู,2886,3016,5902,2887,3016,5903,1724
2565,95,ยะลา,9593,ท้องถิ่นเทศบาลตำบลเมืองรามันห์,2493,2585,5078,2498,2586,5084,1913
2565,95,ยะลา,9594,ท้องถิ่นเทศบาลตำบลยะหา,1260,1203,2463,1260,1203,2463,794
2565,95,ยะลา,9595,ท้องถิ่นเทศบาลตำบลคอกช้าง,736,719,1455,736,719,1455,595
2565,95,ยะลา,9596,ท้องถิ่นเทศบาลตำบลบันนังสตา,1286,1259,2545,1286,1259,2545,1026
2565,95,ยะลา,9597,ท้องถิ่นเทศบาลตำบลลำใหม่,487,485,972,487,485,972,381
2565,95,ยะลา,9598,ท้องถิ่นเทศบาลเมืองเบตง,12535,13456,25991,12625,13555,26180,11472
2565,95,ยะลา,9599,ท้องถิ่นเทศบาลนครยะลา,27913,30968,58881,28178,31252,59430,29023
2565,96,นราธิวาส,9601,อำเภอเมืองนราธิวาส,43795,43020,86815,43826,43043,86869,27194
2565,96,นราธิวาส,9602,อำเภอตากใบ,27015,27686,54701,27038,27700,54738,12359
2565,96,นราธิวาส,9603,อำเภอบาเจาะ,20540,21272,41812,20552,21278,41830,9685
2565,96,นราธิวาส,9604,อำเภอยี่งอ,21918,22627,44545,21929,22640,44569,10801
2565,96,นราธิวาส,9605,อำเภอระแงะ,38787,40278,79065,38799,40289,79088,17948
2565,96,นราธิวาส,9606,อำเภอรือเสาะ,33589,33754,67343,33593,33758,67351,16135
2565,96,นราธิวาส,9607,อำเภอศรีสาคร,18855,18318,37173,18866,18328,37194,9757
2565,96,นราธิวาส,9608,อำเภอแว้ง,21786,22325,44111,21812,22357,44169,10656
2565,96,นราธิวาส,9609,อำเภอสุคิริน,11747,11400,23147,11752,11414,23166,7538
2565,96,นราธิวาส,9610,อำเภอสุไหงโกลก,18470,19768,38238,18488,19784,38272,11448
2565,96,นราธิวาส,9611,อำเภอสุไหงปาดี,23948,24634,48582,23977,24658,48635,12505
2565,96,นราธิวาส,9612,อำเภอจะแนะ,20298,19704,40002,20317,19715,40032,9936
2565,96,นราธิวาส,9613,อำเภอเจาะไอร้อง,20623,20722,41345,20633,20728,41361,9974
2565,96,นราธิวาส,9686,ท้องถิ่นเทศบาลตำบลปะลุรู,3406,3545,6951,3423,3558,6981,2128
2565,96,นราธิวาส,9687,ท้องถิ่นเทศบาลตำบลสุคิริน,1718,1649,3367,1724,1661,3385,1593
2565,96,นราธิวาส,9688,ท้องถิ่นเทศบาลตำบลแว้ง,2586,2716,5302,2587,2718,5305,1704
2565,96,นราธิวาส,9689,ท้องถิ่นเทศบาลตำบลบูเก๊ะตา,2496,2638,5134,2498,2640,5138,1436
2565,96,นราธิวาส,9690,ท้องถิ่นเทศบาลตำบลศรีสาคร,2573,2515,5088,2586,2524,5110,1834
2565,96,นราธิวาส,9691,ท้องถิ่นเทศบาลตำบลรือเสาะ,3663,3837,7500,3683,3841,7524,3669
2565,96,นราธิวาส,9692,ท้องถิ่นเทศบาลตำบลมะรือโบตก,4299,4203,8502,4303,4204,8507,1808
2565,96,นราธิวาส,9693,ท้องถิ่นเทศบาลตำบลตันหยงมัส,3308,3555,6863,3337,3572,6909,3865
2565,96,นราธิวาส,9694,ท้องถิ่นเทศบาลตำบลยี่งอ,1541,1528,3069,1545,1529,3074,1116
2565,96,นราธิวาส,9695,ท้องถิ่นเทศบาลตำบลบาเจาะ,4810,4814,9624,4815,4820,9635,2335
2565,96,นราธิวาส,9696,ท้องถิ่นเทศบาลตำบลต้นไทร,2376,2605,4981,2377,2605,4982,1432
2565,96,นราธิวาส,9697,ท้องถิ่นเทศบาลเมืองตากใบ,9633,10235,19868,9642,10249,19891,5848
2565,96,นราธิวาส,9698,ท้องถิ่นเทศบาลเมืองสุไหงโกลก,18824,21042,39866,18969,21191,40160,15572
2565,96,นราธิวาส,9699,ท้องถิ่นเทศบาลเมืองนราธิวาส,19416,20515,39931,19594,20652,40246,16229
2566,10,กรุงเทพมหานคร,1001,เขตพระนคร,19000,20545,39545,19439,20815,40254,19042
2566,10,กรุงเทพมหานคร,1002,เขตดุสิต,39404,34919,74323,40238,35576,75814,32601
2566,10,กรุงเทพมหานคร,1003,เขตหนองจอก,89075,94513,183588,89388,94750,184138,73048
2566,10,กรุงเทพมหานคร,1004,เขตบางรัก,15742,19205,34947,20114,22807,42921,35410
2566,10,กรุงเทพมหานคร,1005,เขตบางเขน,85491,98188,183679,86030,98581,184611,117364
2566,10,กรุงเทพมหานคร,1006,เขตบางกะปิ,62839,76510,139349,64035,77325,141360,114722
2566,10,กรุงเทพมหานคร,1007,เขตปทุมวัน,17238,19916,37154,18868,21209,40077,32138
2566,10,กรุงเทพมหานคร,1008,เขตป้อมปราบศัตรูพ่าย,17385,18498,35883,18579,19521,38100,19619
2566,10,กรุงเทพมหานคร,1009,เขตพระโขนง,37887,47052,84939,38329,47367,85696,63570
2566,10,กรุงเทพมหานคร,1010,เขตมีนบุรี,65867,74225,140092,66423,74595,141018,65464
2566,10,กรุงเทพมหานคร,1011,เขตลาดกระบัง,84475,94483,178958,84999,94900,179899,105461
2566,10,กรุงเทพมหานคร,1012,เขตยานนาวา,32717,38734,71451,33899,39517,73416,53804
2566,10,กรุงเทพมหานคร,1013,เขตสัมพันธวงศ์,9100,9815,18915,9485,10061,19546,13176
2566,10,กรุงเทพมหานคร,1014,เขตพญาไท,30406,32548,62954,31042,32995,64037,45792
2566,10,กรุงเทพมหานคร,1015,เขตธนบุรี,45047,51874,96921,45771,52515,98286,61682
2566,10,กรุงเทพมหานคร,1016,เขตบางกอกใหญ่,27917,32208,60125,28204,32471,60675,32989
2566,10,กรุงเทพมหานคร,1017,เขตห้วยขวาง,35974,45283,81257,37345,46347,83692,92916
2566,10,กรุงเทพมหานคร,1018,เขตคลองสาน,27698,33176,60874,29875,35086,64961,42133
2566,10,กรุงเทพมหานคร,1019,เขตตลิ่งชัน,46825,53915,100740,47149,54181,101330,44465
2566,10,กรุงเทพมหานคร,1020,เขตบางกอกน้อย,44487,51241,95728,45674,52354,98028,54010
2566,10,กรุงเทพมหานคร,1021,เขตบางขุนเทียน,86263,97614,183877,86943,98216,185159,94280
2566,10,กรุงเทพมหานคร,1022,เขตภาษีเจริญ,55748,65151,120899,56262,65571,121833,68956
2566,10,กรุงเทพมหานคร,1023,เขตหนองแขม,71381,82642,154023,71962,83162,155124,65367
2566,10,กรุงเทพมหานคร,1024,เขตราษฎร์บูรณะ,35434,39310,74744,35863,39671,75534,38962
2566,10,กรุงเทพมหานคร,1025,เขตบางพลัด,39118,47464,86582,39439,47766,87205,59630
2566,10,กรุงเทพมหานคร,1026,เขตดินแดง,49625,59285,108910,50113,59689,109802,64834
2566,10,กรุงเทพมหานคร,1027,เขตบึงกุ่ม,61863,74406,136269,62314,74811,137125,77044
2566,10,กรุงเทพมหานคร,1028,เขตสาทร,31960,36581,68541,33606,37700,71306,45052
2566,10,กรุงเทพมหานคร,1029,เขตบางซื่อ,54148,63531,117679,54698,63936,118634,78240
2566,10,กรุงเทพมหานคร,1030,เขตจตุจักร,69697,83040,152737,70456,83547,154003,137877
2566,10,กรุงเทพมหานคร,1031,เขตบางคอแหลม,35467,40330,75797,36489,41184,77673,40879
2566,10,กรุงเทพมหานคร,1032,เขตประเวศ,84267,96716,180983,85937,97956,183893,97044
2566,10,กรุงเทพมหานคร,1033,เขตคลองเตย,40848,46350,87198,42264,47250,89514,80552
2566,10,กรุงเทพมหานคร,1034,เขตสวนหลวง,54758,66052,120810,56017,66977,122994,85273
2566,10,กรุงเทพมหานคร,1035,เขตจอมทอง,65132,73346,138478,66564,74534,141098,74464
2566,10,กรุงเทพมหานคร,1036,เขตดอนเมือง,81672,83597,165269,82085,83856,165941,82504
2566,10,กรุงเทพมหานคร,1037,เขตราชเทวี,27201,31334,58535,30392,34076,64468,58039
2566,10,กรุงเทพมหานคร,1038,เขตลาดพร้าว,50934,61557,112491,51323,61874,113197,58514
2566,10,กรุงเทพมหานคร,1039,เขตวัฒนา,30151,37151,67302,37258,43257,80515,85834
2566,10,กรุงเทพมหานคร,1040,เขตบางแค,87974,102599,190573,88840,103394,192234,97036
2566,10,กรุงเทพมหานคร,1041,เขตหลักสี่,46057,51864,97921,46308,52069,98377,61013
2566,10,กรุงเทพมหานคร,1042,เขตสายไหม,97412,111505,208917,98552,112402,210954,111381
2566,10,กรุงเทพมหานคร,1043,เขตคันนายาว,40055,47108,87163,44258,50943,95201,47803
2566,10,กรุงเทพมหานคร,1044,เขตสะพานสูง,44043,52360,96403,44428,52633,97061,43293
2566,10,กรุงเทพมหานคร,1045,เขตวังทองหลาง,46481,56118,102599,46968,56488,103456,64542
2566,10,กรุงเทพมหานคร,1046,เขตคลองสามวา,98997,112181,211178,99493,112523,212016,92321
2566,10,กรุงเทพมหานคร,1047,เขตบางนา,38432,45473,83905,39291,46054,85345,74932
2566,10,กรุงเทพมหานคร,1048,เขตทวีวัฒนา,36449,42617,79066,36811,42960,79771,36186
2566,10,กรุงเทพมหานคร,1049,เขตทุ่งครุ,57503,65767,123270,57975,66118,124093,56853
2566,10,กรุงเทพมหานคร,1050,เขตบางบอน,46496,51529,98025,47631,52572,100203,53510
2566,11,สมุทรปราการ,1101,อำเภอเมืองสมุทรปราการ,60545,67724,128269,60705,67857,128562,60914
2566,11,สมุทรปราการ,1102,อำเภอบางบ่อ,47218,50444,97662,47705,50861,98566,50389
2566,11,สมุทรปราการ,1103,อำเภอบางพลี,129898,147961,277859,130865,148628,279493,186756
2566,11,สมุทรปราการ,1104,อำเภอพระประแดง,17963,19593,37556,18001,19627,37628,13642
2566,11,สมุทรปราการ,1105,อำเภอพระสมุทรเจดีย์,59336,64779,124115,59471,64903,124374,59891
2566,11,สมุทรปราการ,1106,อำเภอบางเสาธง,29943,32428,62371,30066,32508,62574,47447
2566,11,สมุทรปราการ,1183,ท้องถิ่นเทศบาลเมืองปากน้ำสมุทรปราการ,18525,21280,39805,18603,21334,39937,17591
2566,11,สมุทรปราการ,1184,ท้องถิ่นเทศบาลตำบลบางเสาธง,9705,10752,20457,9734,10774,20508,18654
2566,11,สมุทรปราการ,1185,ท้องถิ่นเทศบาลตำบลแหลมฟ้าผ่า,10589,11215,21804,10616,11255,21871,9591
2566,11,สมุทรปราการ,1186,ท้องถิ่นเทศบาลตำบลพระสมุทรเจดีย์,5353,5579,10932,5578,5791,11369,5740
2566,11,สมุทรปราการ,1187,ท้องถิ่นเทศบาลตำบลบางพลี,3237,3421,6658,5641,5642,11283,2244
2566,11,สมุทรปราการ,1188,ท้องถิ่นเทศบาลตำบลบางบ่อ,3012,3341,6353,3031,3350,6381,2504
2566,11,สมุทรปราการ,1189,ท้องถิ่นเทศบาลตำบลคลองสวน,1385,1451,2836,1387,1451,2838,907
2566,11,สมุทรปราการ,1190,ท้องถิ่นเทศบาลตำบลคลองด่าน,5408,5683,11091,5427,5702,11129,3266
2566,11,สมุทรปราการ,1191,ท้องถิ่นเทศบาลตำบลบางปู,57024,62058,119082,57234,62240,119474,62281
2566,11,สมุทรปราการ,1192,ท้องถิ่นเทศบาลตำบลแพรกษา,12084,13764,25848,12129,13811,25940,15787
2566,11,สมุทรปราการ,1193,ท้องถิ่นเทศบาลตำบลบางเมือง,44703,51456,96159,44906,51630,96536,50697
2566,11,สมุทรปราการ,1194,ท้องถิ่นเทศบาลตำบลด่านสำโรง,24823,28573,53396,24959,28677,53636,28694
2566,11,สมุทรปราการ,1195,ท้องถิ่นเทศบาลเมืองปู่เจ้าสมิงพราย,33006,35237,68243,33159,35357,68516,36347
2566,11,สมุทรปราการ,1196,ท้องถิ่นเทศบาลตำบลสำโรงเหนือ,13661,16626,30287,13827,16722,30549,31550
2566,11,สมุทรปราการ,1197,ท้องถิ่นเทศบาลเมืองลัดหลวง,31250,34446,65696,31931,35127,67058,37827
2566,11,สมุทรปราการ,1198,ท้องถิ่นเทศบาลเมืองพระประแดง,3902,4195,8097,3957,4255,8212,2187
2566,11,สมุทรปราการ,1199,ท้องถิ่นเทศบาลนครสมุทรปราการ,19673,21353,41026,22523,24013,46536,23051
2566,12,นนทบุรี,1201,อำเภอเมืองนนทบุรี,27223,31693,58916,27316,31771,59087,32325
2566,12,นนทบุรี,1202,อำเภอบางกรวย,16566,19548,36114,16638,19619,36257,21128
2566,12,นนทบุรี,1203,อำเภอบางใหญ่,50390,58794,109184,50710,59052,109762,56352
2566,12,นนทบุรี,1204,อำเภอบางบัวทอง,88809,102101,190910,89120,102395,191515,103712
2566,12,นนทบุรี,1205,อำเภอไทรน้อย,34908,38642,73550,35101,38842,73943,36921
2566,12,นนทบุรี,1206,อำเภอปากเกร็ด,24654,27536,52190,24921,27968,52889,26760
2566,12,นนทบุรี,1286,ท้องถิ่นเทศบาลเมืองเสาธงหิน,18113,21964,40077,18227,22052,40279,27037
2566,12,นนทบุรี,1287,ท้องถิ่นเทศบาลเมืองบางพลับ,5482,6344,11826,5517,6358,11875,6714
2566,12,นนทบุรี,1288,ท้องถิ่นเทศบาลเมืองพิมลราช,23475,27556,51031,23535,27624,51159,24967
2566,12,นนทบุรี,1289,ท้องถิ่นเทศบาลเมืองศาลากลาง,10890,12876,23766,10922,12895,23817,13399
2566,12,นนทบุรี,1290,ท้องถิ่นเทศบาลเมืองไทรม้า,11112,13205,24317,11174,13249,24423,16060
2566,12,นนทบุรี,1291,ท้องถิ่นเทศบาลตำบลไทรน้อย,1228,1245,2473,1246,1251,2497,1195
2566,12,นนทบุรี,1292,ท้องถิ่นเทศบาลเมืองบางใหญ่,6460,7135,13595,6491,7158,13649,6453
2566,12,นนทบุรี,1293,ท้องถิ่นเทศบาลตำบลบางม่วง,3162,3343,6505,3181,3352,6533,3128
2566,12,นนทบุรี,1294,ท้องถิ่นเทศบาลเมืองปลายบาง,21866,25899,47765,21970,25978,47948,24719
2566,12,นนทบุรี,1295,ท้องถิ่นเทศบาลเมืองบางศรีเมือง,15223,17869,33092,15256,17903,33159,13751
2566,12,นนทบุรี,1296,ท้องถิ่นเทศบาลเมืองบางกรวย,20123,23997,44120,20307,24179,44486,22946
2566,12,นนทบุรี,1297,ท้องถิ่นเทศบาลนครปากเกร็ด,86185,101236,187421,87327,102063,189390,138849
2566,12,นนทบุรี,1298,ท้องถิ่นเทศบาลนครบางบัวทอง,23583,28058,51641,23845,28299,52144,27617
2566,12,นนทบุรี,1299,ท้องถิ่นเทศบาลนครนนทบุรี,111230,128230,239460,113330,129950,243280,152852
2566,13,ปทุมธานี,1301,อำเภอเมืองปทุมธานี,63358,70645,134003,63589,70787,134376,73233
2566,13,ปทุมธานี,1302,อำเภอคลองหลวง,73046,81015,154061,73329,81201,154530,76736
2566,13,ปทุมธานี,1303,อำเภอธัญบุรี,0,0,0,0,0,0,0
2566,13,ปทุมธานี,1304,อำเภอหนองเสือ,26041,26630,52671,26130,26705,52835,17870
2566,13,ปทุมธานี,1305,อำเภอลาดหลุมแก้ว,29838,31385,61223,29885,31423,61308,31676
2566,13,ปทุมธานี,1306,อำเภอลำลูกกา,43484,46741,90225,43659,46911,90570,46407
2566,13,ปทุมธานี,1307,อำเภอสามโคก,22011,23630,45641,22081,23684,45765,21593
2566,13,ปทุมธานี,1379,ท้องถิ่นเทศบาลเมืองลาดสวาย,33497,38510,72007,33652,38612,72264,42218
2566,13,ปทุมธานี,1380,ท้องถิ่นเทศบาลตำบลบางพูน,12405,13964,26369,12452,13992,26444,22095
2566,13,ปทุมธานี,1381,ท้องถิ่นเทศบาลตำบลบ้านกลาง,6187,7032,13219,6226,7058,13284,7354
2566,13,ปทุมธานี,1382,ท้องถิ่นเทศบาลเมืองลำสามแก้ว,30216,35191,65407,30311,35253,65564,34011
2566,13,ปทุมธานี,1384,ท้องถิ่นเทศบาลเมืองบึงยี่โถ,15555,18532,34087,15630,18567,34197,16705
2566,13,ปทุมธานี,1386,ท้องถิ่นเทศบาลเมืองบางกะดี,7421,8443,15864,7461,8464,15925,8220
2566,13,ปทุมธานี,1387,ท้องถิ่นเทศบาลตำบลบางเตย,5464,5798,11262,5485,5814,11299,5125
2566,13,ปทุมธานี,1388,ท้องถิ่นเทศบาลตำบลลำลูกกา,9870,10992,20862,9899,11015,20914,11267
2566,13,ปทุมธานี,1389,ท้องถิ่นเทศบาลตำบลลำไทร,1241,1300,2541,1293,1353,2646,1078
2566,13,ปทุมธานี,1390,ท้องถิ่นเทศบาลตำบลระแหง,5198,5594,10792,5226,5623,10849,5933
2566,13,ปทุมธานี,1391,ท้องถิ่นเทศบาลตำบลหนองเสือ,1857,1959,3816,1864,1977,3841,1960
2566,13,ปทุมธานี,1392,ท้องถิ่นเทศบาลเมืองสนั่นรักษ์,15488,17377,32865,15540,17429,32969,18081
2566,13,ปทุมธานี,1393,ท้องถิ่นเทศบาลตำบลธัญบุรี,30064,33759,63823,30892,34280,65172,34767
2566,13,ปทุมธานี,1394,ท้องถิ่นเทศบาลเมืองคลองหลวง,33501,38272,71773,33678,38398,72076,63362
2566,13,ปทุมธานี,1395,ท้องถิ่นเทศบาลตำบลบางหลวง,3705,4158,7863,3713,4170,7883,4621
2566,13,ปทุมธานี,1396,ท้องถิ่นเทศบาลเมืองท่าโขลง,33182,38314,71496,34652,39691,74343,58369
2566,13,ปทุมธานี,1397,ท้องถิ่นเทศบาลเมืองคูคต,19860,22067,41927,20029,22220,42249,27887
2566,13,ปทุมธานี,1398,ท้องถิ่นเทศบาลนครรังสิต,39062,45482,84544,39319,45698,85017,57782
2566,13,ปทุมธานี,1399,ท้องถิ่นเทศบาลเมืองปทุมธานี,9410,10747,20157,10751,12128,22879,9674
2566,14,พระนครศรีอยุธยา,1401,อำเภอพระนครศรีอยุธยา,34356,37654,72010,34406,37686,72092,27120
2566,14,พระนครศรีอยุธยา,1402,อำเภอท่าเรือ,14706,16239,30945,14723,16252,30975,11844
2566,14,พระนครศรีอยุธยา,1403,อำเภอนครหลวง,10548,11518,22066,10580,11543,22123,12103
2566,14,พระนครศรีอยุธยา,1404,อำเภอบางไทร,15370,16190,31560,15399,16202,31601,11092
2566,14,พระนครศรีอยุธยา,1405,อำเภอบางบาล,6877,7414,14291,6879,7417,14296,5594
2566,14,พระนครศรีอยุธยา,1406,อำเภอบางปะอิน,18886,20682,39568,18925,20714,39639,18856
2566,14,พระนครศรีอยุธยา,1407,อำเภอบางปะหัน,17331,18523,35854,17418,18601,36019,12967
2566,14,พระนครศรีอยุธยา,1408,อำเภอผักไห่,10499,11285,21784,10507,11294,21801,7486
2566,14,พระนครศรีอยุธยา,1409,อำเภอภาชี,12503,13275,25778,12513,13284,25797,8706
2566,14,พระนครศรีอยุธยา,1410,อำเภอลาดบัวหลวง,14640,15023,29663,14670,15047,29717,10073
2566,14,พระนครศรีอยุธยา,1411,อำเภอวังน้อย,27973,29608,57581,28058,29687,57745,28006
2566,14,พระนครศรีอยุธยา,1412,อำเภอเสนา,14870,15758,30628,14887,15772,30659,10178
2566,14,พระนครศรีอยุธยา,1413,อำเภอบางซ้าย,6754,6934,13688,6778,6948,13726,4596
2566,14,พระนครศรีอยุธยา,1414,อำเภออุทัย,22489,24402,46891,22523,24436,46959,22839
2566,14,พระนครศรีอยุธยา,1415,อำเภอมหาราช,6352,7024,13376,6355,7026,13381,5261
2566,14,พระนครศรีอยุธยา,1416,อำเภอบ้านแพรก,3131,3616,6747,3137,3620,6757,2739
2566,14,พระนครศรีอยุธยา,1465,ท้องถิ่นเทศบาลเมืองบ้านกรด,6600,7717,14317,6612,7727,14339,10473
2566,14,พระนครศรีอยุธยา,1466,ท้องถิ่นเทศบาลตำบลสามเมือง,3607,3753,7360,3635,3784,7419,3001
2566,14,พระนครศรีอยุธยา,1467,ท้องถิ่นเทศบาลตำบลสามกอ,3222,3567,6789,3262,3601,6863,2988
2566,14,พระนครศรีอยุธยา,1468,ท้องถิ่นเทศบาลตำบลบางนมโค,3640,4105,7745,3647,4118,7765,4264
2566,14,พระนครศรีอยุธยา,1469,ท้องถิ่นเทศบาลตำบลบางกระสั้น,6300,7220,13520,6307,7228,13535,5980
2566,14,พระนครศรีอยุธยา,1470,ท้องถิ่นเทศบาลตำบลเชียงรากน้อย,4942,5268,10210,4983,5292,10275,4630
2566,14,พระนครศรีอยุธยา,1471,ท้องถิ่นเทศบาลตำบลคลองจิก,4531,5065,9596,4541,5070,9611,5933
2566,14,พระนครศรีอยุธยา,1472,ท้องถิ่นเทศบาลตำบลปราสาททอง,2446,2762,5208,2485,2782,5267,3496
2566,14,พระนครศรีอยุธยา,1473,ท้องถิ่นเทศบาลตำบลบ้านแพรก,932,991,1923,933,994,1927,886
2566,14,พระนครศรีอยุธยา,1474,ท้องถิ่นเทศบาลตำบลโรงช้าง,2942,3216,6158,2946,3219,6165,2553
2566,14,พระนครศรีอยุธยา,1475,ท้องถิ่นเทศบาลตำบลมหาราช,1562,1623,3185,1566,1626,3192,1482
2566,14,พระนครศรีอยุธยา,1476,ท้องถิ่นเทศบาลตำบลอุทัย,3361,3880,7241,3363,3884,7247,4615
2566,14,พระนครศรีอยุธยา,1477,ท้องถิ่นเทศบาลตำบลบางซ้าย,2531,2689,5220,2532,2692,5224,1932
2566,14,พระนครศรีอยุธยา,1478,ท้องถิ่นเทศบาลตำบลหัวเวียง,2737,2984,5721,2737,2984,5721,1851
2566,14,พระนครศรีอยุธยา,1479,ท้องถิ่นเทศบาลเมืองลำตาเสา,10720,11343,22063,10739,11359,22098,10180
2566,14,พระนครศรีอยุธยา,1480,ท้องถิ่นเทศบาลตำบลลาดบัวหลวง,1269,1328,2597,1272,1334,2606,1450
2566,14,พระนครศรีอยุธยา,1481,ท้องถิ่นเทศบาลตำบลภาชี,2429,2766,5195,2446,2789,5235,2613
2566,14,พระนครศรีอยุธยา,1482,ท้องถิ่นเทศบาลตำบลลาดชะโด,3567,3756,7323,3575,3756,7331,2827
2566,14,พระนครศรีอยุธยา,1483,ท้องถิ่นเทศบาลเมืองผักไห่,4432,4716,9148,4439,4726,9165,4435
2566,14,พระนครศรีอยุธยา,1484,ท้องถิ่นเทศบาลตำบลพระอินทราชา,4426,5025,9451,4443,5043,9486,6867
2566,14,พระนครศรีอยุธยา,1485,ท้องถิ่นเทศบาลเมืองบ้านสร้าง,5239,6076,11315,5248,6089,11337,7138
2566,14,พระนครศรีอยุธยา,1486,ท้องถิ่นเทศบาลตำบลบางปะอิน,3171,3253,6424,3179,3257,6436,2205
2566,14,พระนครศรีอยุธยา,1487,ท้องถิ่นเทศบาลตำบลบางปะหัน,2436,2737,5173,2439,2739,5178,2261
2566,14,พระนครศรีอยุธยา,1488,ท้องถิ่นเทศบาลตำบลมหาพราหมณ์,4032,4313,8345,4033,4316,8349,3386
2566,14,พระนครศรีอยุธยา,1489,ท้องถิ่นเทศบาลตำบลบางบาล,5104,5612,10716,5105,5616,10721,3823
2566,14,พระนครศรีอยุธยา,1490,ท้องถิ่นเทศบาลตำบลราชคราม,3003,3054,6057,3016,3067,6083,1878
2566,14,พระนครศรีอยุธยา,1491,ท้องถิ่นเทศบาลเมืองบางไทร,4909,5145,10054,4918,5153,10071,3969
2566,14,พระนครศรีอยุธยา,1492,ท้องถิ่นเทศบาลตำบลอรัญญิก,3683,3950,7633,3684,3952,7636,2873
2566,14,พระนครศรีอยุธยา,1493,ท้องถิ่นเทศบาลตำบลนครหลวง,3214,3529,6743,3217,3531,6748,3059
2566,14,พระนครศรีอยุธยา,1494,ท้องถิ่นเทศบาลตำบลท่าหลวง,3837,4274,8111,3844,4278,8122,4174
2566,14,พระนครศรีอยุธยา,1495,ท้องถิ่นเทศบาลเมืองอโยธยา,9073,10665,19738,9102,10693,19795,10914
2566,14,พระนครศรีอยุธยา,1496,ท้องถิ่นเทศบาลเมืองเจ้าเจ็ด,5019,5452,10471,5077,5511,10588,3309
2566,14,พระนครศรีอยุธยา,1497,ท้องถิ่นเทศบาลตำบลท่าเรือ,2920,3332,6252,2935,3347,6282,3251
2566,14,พระนครศรีอยุธยา,1498,ท้องถิ่นเทศบาลเมืองเสนา,1631,1830,3461,1651,1839,3490,1496
2566,14,พระนครศรีอยุธยา,1499,ท้องถิ่นเทศบาลนครพระนครศรีอยุธยา,22331,24692,47023,22586,24926,47512,20583
2566,15,อ่างทอง,1501,อำเภอเมืองอ่างทอง,20541,22786,43327,20564,22820,43384,17579
2566,15,อ่างทอง,1502,อำเภอไชโย,3384,3623,7007,3387,3625,7012,2492
2566,15,อ่างทอง,1503,อำเภอป่าโมก,8791,9701,18492,8804,9720,18524,6902
2566,15,อ่างทอง,1504,อำเภอโพธิ์ทอง,20593,22568,43161,20615,22591,43206,15277
2566,15,อ่างทอง,1505,อำเภอแสวงหา,14756,15469,30225,14766,15477,30243,10379
2566,15,อ่างทอง,1506,อำเภอวิเศษชัยชาญ,23982,26000,49982,24016,26026,50042,18783
2566,15,อ่างทอง,1507,อำเภอสามโก้,4007,4282,8289,4009,4287,8296,2933
2566,15,อ่างทอง,1590,ท้องถิ่นเทศบาลตำบลสามโก้,4952,5506,10458,4955,5508,10463,3674
2566,15,อ่างทอง,1591,ท้องถิ่นเทศบาลตำบลวิเศษไชยชาญ,2585,3098,5683,2600,3106,5706,3050
2566,15,อ่างทอง,1592,ท้องถิ่นเทศบาลตำบลบางจัก,3550,3882,7432,3553,3885,7438,2869
2566,15,อ่างทอง,1593,ท้องถิ่นเทศบาลตำบลแสวงหา,1510,1621,3131,1514,1625,3139,1286
2566,15,อ่างทอง,1594,ท้องถิ่นเทศบาลตำบลรำมะสัก,1944,2149,4093,1945,2151,4096,1520
2566,15,อ่างทอง,1595,ท้องถิ่นเทศบาลตำบลโพธิ์ทอง,1948,2188,4136,1950,2190,4140,1753
2566,15,อ่างทอง,1596,ท้องถิ่นเทศบาลตำบลไชโย,5949,6365,12314,5957,6369,12326,4289
2566,15,อ่างทอง,1597,ท้องถิ่นเทศบาลตำบลเกษไชโย,1333,1383,2716,1335,1385,2720,1032
2566,15,อ่างทอง,1598,ท้องถิ่นเทศบาลตำบลป่าโมก,4017,4426,8443,4040,4445,8485,3667
2566,15,อ่างทอง,1599,ท้องถิ่นเทศบาลเมืองอ่างทอง,5379,6031,11410,5422,6084,11506,6681
2566,16,ลพบุรี,1601,อำเภอเมืองลพบุรี,49423,50398,99821,49476,50429,99905,42598
2566,16,ลพบุรี,1602,อำเภอพัฒนานิคม,27023,27951,54974,27060,27981,55041,24489
2566,16,ลพบุรี,1603,อำเภอโคกสำโรง,37296,38073,75369,37330,38103,75433,29648
2566,16,ลพบุรี,1604,อำเภอชัยบาดาล,36094,36966,73060,36129,36981,73110,28992
2566,16,ลพบุรี,1605,อำเภอท่าวุ้ง,20783,22495,43278,20797,22515,43312,14469
2566,16,ลพบุรี,1606,อำเภอบ้านหมี่,32401,35037,67438,32423,35057,67480,23958
2566,16,ลพบุรี,1607,อำเภอท่าหลวง,12699,13059,25758,12717,13072,25789,8768
2566,16,ลพบุรี,1608,อำเภอสระโบสถ์,7066,6899,13965,7071,6904,13975,5431
2566,16,ลพบุรี,1609,อำเภอโคกเจริญ,12144,12121,24265,12148,12128,24276,8063
2566,16,ลพบุรี,1610,อำเภอลำสนธิ,13438,13702,27140,13452,13703,27155,9749
2566,16,ลพบุรี,1611,อำเภอหนองม่วง,13516,14008,27524,13546,14045,27591,10414
2566,16,ลพบุรี,1681,ท้องถิ่นเทศบาลตำบลกกโก,5072,5974,11046,5081,5975,11056,6008
2566,16,ลพบุรี,1682,ท้องถิ่นเทศบาลตำบลถนนใหญ่,6166,5086,11252,6176,5093,11269,4948
2566,16,ลพบุรี,1683,ท้องถิ่นเทศบาลเมืองเขาสามยอด,15167,12943,28110,15359,13079,28438,13023
2566,16,ลพบุรี,1684,ท้องถิ่นเทศบาลตำบลท่าศาลา,6710,7628,14338,6729,7649,14378,7275
2566,16,ลพบุรี,1685,ท้องถิ่นเทศบาลตำบลดีลัง,3898,4168,8066,3905,4171,8076,3925
2566,16,ลพบุรี,1686,ท้องถิ่นเทศบาลตำบลเขาพระงาม,14642,8822,23464,14648,8829,23477,12013
2566,16,ลพบุรี,1688,ท้องถิ่นเทศบาลตำบลสระโบสถ์,3382,3673,7055,3384,3674,7058,3215
2566,16,ลพบุรี,1689,ท้องถิ่นเทศบาลตำบลบ้านท่าหลวง,1853,1883,3736,1858,1886,3744,2163
2566,16,ลพบุรี,1690,ท้องถิ่นเทศบาลตำบลท่าวุ้ง,985,1066,2051,986,1067,2053,895
2566,16,ลพบุรี,1691,ท้องถิ่นเทศบาลตำบลท่าโขลง,1020,1184,2204,1028,1197,2225,1042
2566,16,ลพบุรี,1692,ท้องถิ่นเทศบาลตำบลลำนารายณ์,7261,7876,15137,7381,7952,15333,8757
2566,16,ลพบุรี,1693,ท้องถิ่นเทศบาลตำบลหนองม่วง,2336,2504,4840,2342,2506,4848,2172
2566,16,ลพบุรี,1694,ท้องถิ่นเทศบาลตำบลพัฒนานิคม,1379,1529,2908,1448,1618,3066,1475
2566,16,ลพบุรี,1695,ท้องถิ่นเทศบาลตำบลแก่งเสือเต้น,1344,1399,2743,1345,1400,2745,1128
2566,16,ลพบุรี,1696,ท้องถิ่นเทศบาลตำบลโคกตูม,14902,15323,30225,14918,15331,30249,12237
2566,16,ลพบุรี,1697,ท้องถิ่นเทศบาลตำบลโคกสำโรง,2587,2835,5422,2594,2838,5432,2433
2566,16,ลพบุรี,1698,ท้องถิ่นเทศบาลเมืองบ้านหมี่,1405,1574,2979,1433,1592,3025,1344
2566,16,ลพบุรี,1699,ท้องถิ่นเทศบาลเมืองลพบุรี,9699,10401,20100,9736,10422,20158,12795
2566,17,สิงห์บุรี,1701,อำเภอเมืองสิงห์บุรี,16882,19375,36257,16915,19401,36316,14015
2566,17,สิงห์บุรี,1702,อำเภอบางระจัน,9183,9846,19029,9191,9853,19044,7319
2566,17,สิงห์บุรี,1703,อำเภอค่ายบางระจัน,12306,13192,25498,12318,13207,25525,9209
2566,17,สิงห์บุรี,1704,อำเภอพรหมบุรี,7661,8484,16145,7672,8500,16172,6098
2566,17,สิงห์บุรี,1705,อำเภอท่าช้าง,2516,2852,5368,2521,2854,5375,1905
2566,17,สิงห์บุรี,1706,อำเภออินทร์บุรี,22878,24902,47780,22898,24926,47824,18088
2566,17,สิงห์บุรี,1793,ท้องถิ่นเทศบาลตำบลอินทร์บุรี,2036,2247,4283,2040,2250,4290,2263
2566,17,สิงห์บุรี,1794,ท้องถิ่นเทศบาลตำบลถอนสมอ,4077,4440,8517,4083,4444,8527,3512
2566,17,สิงห์บุรี,1795,ท้องถิ่นเทศบาลตำบลพรหมบุรี,1502,1585,3087,1506,1587,3093,1327
2566,17,สิงห์บุรี,1796,ท้องถิ่นเทศบาลตำบลบางน้ำเชี่ยว,1573,1713,3286,1585,1721,3306,1419
2566,17,สิงห์บุรี,1797,ท้องถิ่นเทศบาลตำบลโพสังโฆ,910,1029,1939,911,1030,1941,864
2566,17,สิงห์บุรี,1798,ท้องถิ่นเทศบาลเมืองบางระจัน,6320,7160,13480,6335,7168,13503,5797
2566,17,สิงห์บุรี,1799,ท้องถิ่นเทศบาลเมืองสิงห์บุรี,7645,8820,16465,7677,8846,16523,9375
2566,18,ชัยนาท,1801,อำเภอเมืองชัยนาท,10980,11741,22721,10995,11748,22743,8995
2566,18,ชัยนาท,1802,อำเภอมโนรมย์,11182,12220,23402,11199,12238,23437,9194
2566,18,ชัยนาท,1803,อำเภอวัดสิงห์,10548,11263,21811,10553,11267,21820,9530
2566,18,ชัยนาท,1804,อำเภอสรรพยา,14569,15597,30166,14571,15602,30173,12022
2566,18,ชัยนาท,1805,อำเภอสรรคบุรี,28690,31218,59908,28718,31240,59958,22674
2566,18,ชัยนาท,1806,อำเภอหันคา,19563,20847,40410,19585,20867,40452,15067
2566,18,ชัยนาท,1807,อำเภอหนองมะโมง,6213,6437,12650,6217,6441,12658,5260
2566,18,ชัยนาท,1808,อำเภอเนินขาม,5266,5472,10738,5268,5472,10740,4107
2566,18,ชัยนาท,1880,ท้องถิ่นเทศบาลตำบลบางหลวง,2438,2726,5164,2438,2727,5165,2657
2566,18,ชัยนาท,1881,ท้องถิ่นเทศบาลตำบลนางลือ,3484,3881,7365,3487,3888,7375,2636
2566,18,ชัยนาท,1882,ท้องถิ่นเทศบาลตำบลเสือโฮก,3610,3811,7421,3614,3812,7426,2517
2566,18,ชัยนาท,1883,ท้องถิ่นเทศบาลตำบลหาดท่าเสา,2410,2572,4982,2411,2573,4984,1865
2566,18,ชัยนาท,1884,ท้องถิ่นเทศบาลตำบลชัยนาท,3522,4299,7821,3524,4302,7826,2759
2566,18,ชัยนาท,1885,ท้องถิ่นเทศบาลตำบลบ้านกล้วย,3297,3720,7017,3307,3723,7030,3724
2566,18,ชัยนาท,1887,ท้องถิ่นเทศบาลตำบลหนองแซง,3720,3886,7606,3723,3890,7613,2872
2566,18,ชัยนาท,1889,ท้องถิ่นเทศบาลตำบลวังตะเคียน,3251,3391,6642,3252,3392,6644,2543
2566,18,ชัยนาท,1890,ท้องถิ่นเทศบาลตำบลเนินขาม,2835,3095,5930,2835,3095,5930,2773
2566,18,ชัยนาท,1891,ท้องถิ่นเทศบาลตำบลหันคา,1882,2095,3977,1884,2098,3982,2474
2566,18,ชัยนาท,1892,ท้องถิ่นเทศบาลตำบลสามง่ามท่าโบสถ์,614,664,1278,615,664,1279,488
2566,18,ชัยนาท,1893,ท้องถิ่นเทศบาลตำบลแพรกศรีราชา,1120,1289,2409,1125,1299,2424,1394
2566,18,ชัยนาท,1894,ท้องถิ่นเทศบาลตำบลสรรพยา,1431,1523,2954,1431,1523,2954,1386
2566,18,ชัยนาท,1895,ท้องถิ่นเทศบาลตำบลโพธิ์พิทักษ์,701,795,1496,701,796,1497,583
2566,18,ชัยนาท,1896,ท้องถิ่นเทศบาลตำบลหางน้ำสาคร,2889,3147,6036,2903,3152,6055,3239
2566,18,ชัยนาท,1897,ท้องถิ่นเทศบาลตำบลคุ้งสำเภา,855,936,1791,860,939,1799,1005
2566,18,ชัยนาท,1898,ท้องถิ่นเทศบาลตำบลวัดสิงห์,1429,1605,3034,1433,1607,3040,1974
2566,18,ชัยนาท,1899,ท้องถิ่นเทศบาลเมืองชัยนาท,5081,6045,11126,5126,6090,11216,7611
2566,19,สระบุรี,1901,อำเภอเมืองสระบุรี,25551,22443,47994,25600,22497,48097,21167
2566,19,สระบุรี,1902,อำเภอแก่งคอย,34700,35703,70403,34814,35777,70591,32876
2566,19,สระบุรี,1903,อำเภอหนองแค,33088,35115,68203,33150,35199,68349,35680
2566,19,สระบุรี,1904,อำเภอวิหารแดง,16231,16890,33121,16262,16928,33190,12756
2566,19,สระบุรี,1905,อำเภอหนองแซง,6177,6897,13074,6184,6904,13088,4719
2566,19,สระบุรี,1906,อำเภอบ้านหมอ,15185,16176,31361,15203,16189,31392,12912
2566,19,สระบุรี,1907,อำเภอดอนพุด,945,1002,1947,945,1002,1947,679
2566,19,สระบุรี,1908,อำเภอหนองโดน,5540,5848,11388,5547,5853,11400,4704
2566,19,สระบุรี,1909,อำเภอพระพุทธบาท,12073,12838,24911,12087,12849,24936,10576
2566,19,สระบุรี,1910,อำเภอเสาไห้,10654,11646,22300,10684,11672,22356,8846
2566,19,สระบุรี,1911,อำเภอมวกเหล็ก,24689,25003,49692,24771,25044,49815,23082
2566,19,สระบุรี,1912,อำเภอวังม่วง,5651,5932,11583,5656,5937,11593,4782
2566,19,สระบุรี,1913,อำเภอเฉลิมพระเกียรติ,14783,15597,30380,14812,15625,30437,13477
2566,19,สระบุรี,1974,ท้องถิ่นเทศบาลตำบลพุกร่าง,3319,3503,6822,3319,3507,6826,2549
2566,19,สระบุรี,1975,ท้องถิ่นเทศบาลตำบลคำพราน,2077,2162,4239,2080,2162,4242,2203
2566,19,สระบุรี,1976,ท้องถิ่นเทศบาลตำบลไผ่ต่ำ,2026,2095,4121,2032,2106,4138,2259
2566,19,สระบุรี,1977,ท้องถิ่นเทศบาลตำบลตะกุด,2368,2508,4876,2374,2513,4887,2382
2566,19,สระบุรี,1978,ท้องถิ่นเทศบาลตำบลกุดนกเปล้า,3008,3186,6194,3009,3188,6197,2754
2566,19,สระบุรี,1979,ท้องถิ่นเทศบาลตำบลหน้าพระลาน,3754,3748,7502,3773,3772,7545,3380
2566,19,สระบุรี,1980,ท้องถิ่นเทศบาลตำบลวังม่วง,2075,2205,4280,2088,2214,4302,2689
2566,19,สระบุรี,1981,ท้องถิ่นเทศบาลตำบลมวกเหล็ก,3115,3374,6489,3144,3401,6545,4509
2566,19,สระบุรี,1982,ท้องถิ่นเทศบาลตำบลเสาไห้,1444,1561,3005,1450,1567,3017,1562
2566,19,สระบุรี,1983,ท้องถิ่นเทศบาลตำบลสวนดอกไม้,3734,4161,7895,3736,4162,7898,4333
2566,19,สระบุรี,1984,ท้องถิ่นเทศบาลตำบลบ้านยาง,562,644,1206,564,645,1209,411
2566,19,สระบุรี,1985,ท้องถิ่นเทศบาลตำบลหนองโดน,1112,1225,2337,1113,1225,2338,1054
2566,19,สระบุรี,1986,ท้องถิ่นเทศบาลตำบลดอนพุด,2254,2330,4584,2255,2332,4587,1890
2566,19,สระบุรี,1987,ท้องถิ่นเทศบาลตำบลบ้านหมอ,1210,1304,2514,1213,1311,2524,1349
2566,19,สระบุรี,1988,ท้องถิ่นเทศบาลตำบลท่าลาน,3623,3886,7509,3629,3891,7520,4055
2566,19,สระบุรี,1989,ท้องถิ่นเทศบาลตำบลหนองแซง,1339,1495,2834,1344,1496,2840,1055
2566,19,สระบุรี,1990,ท้องถิ่นเทศบาลตำบลหนองหมู,818,858,1676,819,858,1677,511
2566,19,สระบุรี,1991,ท้องถิ่นเทศบาลตำบลวิหารแดง,1825,2018,3843,1835,2026,3861,1955
2566,19,สระบุรี,1992,ท้องถิ่นเทศบาลตำบลหินกอง,4430,4917,9347,4448,4934,9382,5758
2566,19,สระบุรี,1993,ท้องถิ่นเทศบาลตำบลคชสิทธิ์,616,678,1294,622,684,1306,687
2566,19,สระบุรี,1994,ท้องถิ่นเทศบาลเมืองทับกวาง,10007,10085,20092,10100,10144,20244,10291
2566,19,สระบุรี,1995,ท้องถิ่นเทศบาลตำบลป๊อกแป๊ก,326,387,713,328,388,716,442
2566,19,สระบุรี,1996,ท้องถิ่นเทศบาลเมืองพระพุทธบาท,12798,14838,27636,12985,15038,28023,13708
2566,19,สระบุรี,1997,ท้องถิ่นเทศบาลตำบลหนองแค,5829,6172,12001,5903,6244,12147,6531
2566,19,สระบุรี,1998,ท้องถิ่นเทศบาลเมืองแก่งคอย,5037,5462,10499,5057,5472,10529,6280
2566,19,สระบุรี,1999,ท้องถิ่นเทศบาลเมืองสระบุรี,27971,28827,56798,28162,28973,57135,29150
2566,20,ชลบุรี,2001,อำเภอเมืองชลบุรี,21830,23348,45178,21871,23382,45253,29030
2566,20,ชลบุรี,2002,อำเภอบ้านบึง,41816,43318,85134,42219,43638,85857,49371
2566,20,ชลบุรี,2003,อำเภอหนองใหญ่,7397,7476,14873,7605,7636,15241,7094
2566,20,ชลบุรี,2004,อำเภอบางละมุง,14473,16468,30941,14730,16642,31372,20161
2566,20,ชลบุรี,2005,อำเภอพานทอง,24944,25897,50841,24973,25931,50904,42604
2566,20,ชลบุรี,2006,อำเภอพนัสนิคม,49475,52489,101964,49781,52778,102559,39767
2566,20,ชลบุรี,2007,อำเภอศรีราชา,28946,29345,58291,29093,29436,58529,50955
2566,20,ชลบุรี,2008,อำเภอเกาะสีชัง,0,0,0,0,0,0,0
2566,20,ชลบุรี,2009,อำเภอสัตหีบ,26628,26295,52923,26987,26614,53601,30543
2566,20,ชลบุรี,2010,อำเภอบ่อทอง,18895,18705,37600,19039,18813,37852,14099
2566,20,ชลบุรี,2011,อำเภอเกาะจันทร์,13467,12742,26209,13912,13093,27005,9269
2566,20,ชลบุรี,2060,ท้องถิ่นเทศบาลตำบลเกล็ดแก้ว,7098,5766,12864,7274,5785,13059,6793
2566,20,ชลบุรี,2061,ท้องถิ่นเทศบาลตำบลเขตรอุดมศักดิ์,35073,22114,57187,35177,22159,57336,28201
2566,20,ชลบุรี,2063,ท้องถิ่นเทศบาลตำบลหมอนนาง,6511,6955,13466,6553,6975,13528,4787
2566,20,ชลบุรี,2064,ท้องถิ่นเทศบาลตำบลตะเคียนเตี้ย,12869,13998,26867,12931,14027,26958,14083
2566,20,ชลบุรี,2065,ท้องถิ่นเทศบาลตำบลเสม็ด,10439,12617,23056,10485,12637,23122,17745
2566,20,ชลบุรี,2066,ท้องถิ่นเทศบาลเมืองดอนหัวฬ่อ,6935,7084,14019,6948,7089,14037,16312
2566,20,ชลบุรี,2067,ท้องถิ่นเทศบาลตำบลห้วยกะปิ,8076,9291,17367,8096,9299,17395,12013
2566,20,ชลบุรี,2068,ท้องถิ่นเทศบาลตำบลนาป่า,20804,21952,42756,20835,21978,42813,27688
2566,20,ชลบุรี,2069,ท้องถิ่นเทศบาลตำบลหนองไม้แดง,6847,6510,13357,6857,6514,13371,11456
2566,20,ชลบุรี,2070,ท้องถิ่นเทศบาลตำบลธาตุทอง,3798,3965,7763,3850,4016,7866,2867
2566,20,ชลบุรี,2071,ท้องถิ่นเทศบาลตำบลโป่ง,5523,6154,11677,5649,6173,11822,7259
2566,20,ชลบุรี,2072,ท้องถิ่นเทศบาลเมืองหนองปรือ,39460,50090,89550,40931,50343,91274,52874
2566,20,ชลบุรี,2073,ท้องถิ่นเทศบาลตำบลท่าบุญมี,3193,3427,6620,3209,3440,6649,4264
2566,20,ชลบุรี,2074,ท้องถิ่นเทศบาลตำบลเกาะจันทร์,4092,1845,5937,4097,1847,5944,2086
2566,20,ชลบุรี,2075,ท้องถิ่นเทศบาลตำบลบ่อทอง,1753,1871,3624,2015,2102,4117,2183
2566,20,ชลบุรี,2076,ท้องถิ่นเทศบาลเมืองสัตหีบ,9996,11313,21309,10055,11353,21408,12251
2566,20,ชลบุรี,2077,ท้องถิ่นเทศบาลตำบลบางเสร่,5189,6367,11556,5371,6398,11769,9726
2566,20,ชลบุรี,2078,ท้องถิ่นเทศบาลตำบลนาจอมเทียน,3525,4066,7591,3716,4114,7830,16864
2566,20,ชลบุรี,2079,ท้องถิ่นเทศบาลตำบลเกาะสีชัง,2240,2305,4545,2246,2309,4555,2286
2566,20,ชลบุรี,2080,ท้องถิ่นเทศบาลนครเจ้าพระยาสุรศักดิ์,76192,80810,157002,76538,81008,157546,109857
2566,20,ชลบุรี,2081,ท้องถิ่นเทศบาลตำบลบางพระ,6443,7118,13561,6480,7132,13612,8270
2566,20,ชลบุรี,2082,ท้องถิ่นเทศบาลตำบลหนองตำลึง,11384,11781,23165,11398,11794,23192,18102
2566,20,ชลบุรี,2083,ท้องถิ่นเทศบาลตำบลพานทอง,2995,3199,6194,3160,3357,6517,3874
2566,20,ชลบุรี,2084,ท้องถิ่นเทศบาลตำบลห้วยใหญ่,14631,16668,31299,14863,16728,31591,19475
2566,20,ชลบุรี,2085,ท้องถิ่นเทศบาลตำบลบางละมุง,6210,6885,13095,6275,6973,13248,9300
2566,20,ชลบุรี,2086,ท้องถิ่นเทศบาลตำบลหนองใหญ่,4161,4007,8168,4451,4244,8695,3547
2566,20,ชลบุรี,2087,ท้องถิ่นเทศบาลตำบลหัวกุญแจ,1625,1853,3478,1655,1883,3538,2167
2566,20,ชลบุรี,2088,ท้องถิ่นเทศบาลตำบลหนองไผ่แก้ว,1089,1170,2259,1090,1175,2265,1622
2566,20,ชลบุรี,2089,ท้องถิ่นเทศบาลเมืองอ่างศิลา,17122,20019,37141,17165,20052,37217,22786
2566,20,ชลบุรี,2090,ท้องถิ่นเทศบาลนครบ้านสวน,33178,33991,67169,34234,34897,69131,46509
2566,20,ชลบุรี,2091,ท้องถิ่นเทศบาลตำบลบางทราย,6217,4953,11170,6247,4967,11214,7486
2566,20,ชลบุรี,2092,ท้องถิ่นเทศบาลตำบลคลองตำหรุ,2191,2489,4680,2208,2499,4707,7238
2566,20,ชลบุรี,2093,ท้องถิ่นเทศบาลนครแหลมฉบัง,45042,46708,91750,45594,47167,92761,85442
2566,20,ชลบุรี,2094,ท้องถิ่นเทศบาลเมืองแสนสุข,21294,24507,45801,21629,24741,46370,39794
2566,20,ชลบุรี,2095,ท้องถิ่นเทศบาลเมืองบ้านบึง,8511,9871,18382,9237,10526,19763,10768
2566,20,ชลบุรี,2096,ท้องถิ่นเมืองพัทยา,49316,61126,110442,53142,63721,116863,178119
2566,20,ชลบุรี,2097,ท้องถิ่นเทศบาลเมืองศรีราชา,9931,12563,22494,10707,13241,23948,8977
2566,20,ชลบุรี,2098,ท้องถิ่นเทศบาลเมืองพนัสนิคม,4453,5289,9742,4471,5293,9764,5058
2566,20,ชลบุรี,2099,ท้องถิ่นเทศบาลเมืองชลบุรี,10865,12121,22986,10937,12161,23098,12498
2566,21,ระยอง,2101,อำเภอเมืองระยอง,50434,52622,103056,50810,52777,103587,69059
2566,21,ระยอง,2102,อำเภอบ้านฉาง,5740,5229,10969,5765,5244,11009,5216
2566,21,ระยอง,2103,อำเภอแกลง,32389,35019,67408,32485,35082,67567,32813
2566,21,ระยอง,2104,อำเภอวังจันทร์,11032,11151,22183,11083,11191,22274,11609
2566,21,ระยอง,2105,อำเภอบ้านค่าย,33563,35357,68920,33672,35428,69100,38340
2566,21,ระยอง,2106,อำเภอปลวกแดง,40273,39364,79637,40354,39450,79804,111183
2566,21,ระยอง,2107,อำเภอเขาชะเมา,11675,11868,23543,11707,11902,23609,11474
2566,21,ระยอง,2108,อำเภอนิคมพัฒนา,12217,12286,24503,12256,12328,24584,21165
2566,21,ระยอง,2177,ท้องถิ่นเทศบาลตำบลพลา,4176,4303,8479,4330,4343,8673,5811
2566,21,ระยอง,2178,ท้องถิ่นเทศบาลตำบลเนินฆ้อ,2192,2323,4515,2203,2331,4534,2042
2566,21,ระยอง,2179,ท้องถิ่นเทศบาลตำบลทับมา,12789,13025,25814,12830,13051,25881,18205
2566,21,ระยอง,2180,ท้องถิ่นเทศบาลตำบลบ้านนา,4173,4365,8538,4183,4383,8566,3571
2566,21,ระยอง,2181,ท้องถิ่นเทศบาลตำบลมาบข่าพัฒนา,5667,5679,11346,5677,5691,11368,8333
2566,21,ระยอง,2182,ท้องถิ่นเทศบาลตำบลบ้านฉาง,8003,8427,16430,8122,8469,16591,9945
2566,21,ระยอง,2183,ท้องถิ่นเทศบาลเมืองมะขามคู่,7405,7469,14874,7416,7477,14893,13669
2566,21,ระยอง,2184,ท้องถิ่นเทศบาลเมืองนิคมพัฒนา,5656,5623,11279,5659,5630,11289,8922
2566,21,ระยอง,2185,ท้องถิ่นเทศบาลตำบลบ้านปลวกแดง,2362,2695,5057,2585,2886,5471,4557
2566,21,ระยอง,2186,ท้องถิ่นเทศบาลตำบลจอมพลเจ้าพระยา,200,188,388,200,188,388,617
2566,21,ระยอง,2187,ท้องถิ่นเทศบาลตำบลบ้านค่าย,1554,1711,3265,1636,1790,3426,2146
2566,21,ระยอง,2188,ท้องถิ่นเทศบาลตำบลชุมแสง,1761,1823,3584,1812,1871,3683,2435
2566,21,ระยอง,2189,ท้องถิ่นเทศบาลตำบลสุนทรภู่,6933,7841,14774,7164,7901,15065,10420
2566,21,ระยอง,2190,ท้องถิ่นเทศบาลตำบลปากน้ำประแส,2234,2383,4617,2253,2402,4655,2096
2566,21,ระยอง,2191,ท้องถิ่นเทศบาลตำบลทุ่งควายกิน,3089,3420,6509,3105,3429,6534,4162
2566,21,ระยอง,2192,ท้องถิ่นเทศบาลตำบลกองดิน,2347,2369,4716,2352,2379,4731,1898
2566,21,ระยอง,2193,ท้องถิ่นเทศบาลตำบลสำนักท้อน,5533,5727,11260,5563,5747,11310,6289
2566,21,ระยอง,2194,ท้องถิ่นเทศบาลเมืองบ้านฉาง,15151,16191,31342,15407,16309,31716,21726
2566,21,ระยอง,2195,ท้องถิ่นเทศบาลตำบลบ้านเพ,8378,9408,17786,8562,9455,18017,12480
2566,21,ระยอง,2196,ท้องถิ่นเทศบาลตำบลแกลงกะเฉด,3394,3692,7086,3426,3706,7132,3489
2566,21,ระยอง,2197,ท้องถิ่นเทศบาลนครมาบตาพุด,38672,38718,77390,38903,38952,77855,66445
2566,21,ระยอง,2198,ท้องถิ่นเทศบาลตำบลเมืองแกลง,8042,9162,17204,8654,9685,18339,11988
2566,21,ระยอง,2199,ท้องถิ่นเทศบาลนครระยอง,26543,30441,56984,27877,31661,59538,38340
2566,22,จันทบุรี,2201,อำเภอเมืองจันทบุรี,22632,25186,47818,22710,25235,47945,23853
2566,22,จันทบุรี,2202,อำเภอขลุง,12373,12905,25278,12395,12923,25318,10614
2566,22,จันทบุรี,2203,อำเภอท่าใหม่,23172,24218,47390,23253,24283,47536,18890
2566,22,จันทบุรี,2204,อำเภอโป่งน้ำร้อน,10939,10409,21348,11017,10535,21552,9020
2566,22,จันทบุรี,2205,อำเภอมะขาม,15159,15690,30849,15259,15806,31065,14149
2566,22,จันทบุรี,2206,อำเภอแหลมสิงห์,6771,7056,13827,6818,7109,13927,5476
2566,22,จันทบุรี,2207,อำเภอสอยดาว,18623,18372,36995,18713,18436,37149,15417
2566,22,จันทบุรี,2208,อำเภอแก่งหางแมว,21358,21232,42590,21476,21368,42844,22327
2566,22,จันทบุรี,2209,อำเภอนายายอาม,14733,15814,30547,14894,15975,30869,12500
2566,22,จันทบุรี,2210,อำเภอเขาคิชฌกูฏ,6275,6489,12764,6297,6510,12807,5756
2566,22,จันทบุรี,2272,ท้องถิ่นเทศบาลตำบลเขาบายศรี,3047,3209,6256,3074,3226,6300,2622
2566,22,จันทบุรี,2273,ท้องถิ่นเทศบาลตำบลคลองใหญ่,2638,2666,5304,2673,2701,5374,2158
2566,22,จันทบุรี,2274,ท้องถิ่นเทศบาลตำบลหนองตาคง,5178,4894,10072,5213,4942,10155,4131
2566,22,จันทบุรี,2275,ท้องถิ่นเทศบาลตำบลตกพรม,1947,2128,4075,1978,2148,4126,1693
2566,22,จันทบุรี,2276,ท้องถิ่นเทศบาลตำบลเกวียนหัก,2140,2484,4624,2142,2486,4628,2324
2566,22,จันทบุรี,2277,ท้องถิ่นเทศบาลตำบลบ่อ,3471,3612,7083,3473,3619,7092,2830
2566,22,จันทบุรี,2278,ท้องถิ่นเทศบาลตำบลชากไทย,2103,2238,4341,2123,2258,4381,1948
2566,22,จันทบุรี,2279,ท้องถิ่นเทศบาลตำบลตะเคียนทอง,2380,2340,4720,2385,2345,4730,1886
2566,22,จันทบุรี,2280,ท้องถิ่นเทศบาลเมืองเกาะขวาง,8313,9270,17583,8375,9306,17681,8753
2566,22,จันทบุรี,2281,ท้องถิ่นเทศบาลตำบลบ่อเวฬุ,2253,2089,4342,2275,2108,4383,2679
2566,22,จันทบุรี,2282,ท้องถิ่นเทศบาลตำบลพลวง,3456,3671,7127,3579,3785,7364,4312
2566,22,จันทบุรี,2283,ท้องถิ่นเทศบาลตำบลทับช้าง,8133,8087,16220,8153,8094,16247,6268
2566,22,จันทบุรี,2284,ท้องถิ่นเทศบาลตำบลนายายอาม,1617,1810,3427,1622,1819,3441,2026
2566,22,จันทบุรี,2285,ท้องถิ่นเทศบาลตำบลสอยดาว,5410,5611,11021,5514,5724,11238,6546
2566,22,จันทบุรี,2286,ท้องถิ่นเทศบาลตำบลพลิ้ว,3216,3716,6932,3224,3720,6944,3206
2566,22,จันทบุรี,2287,ท้องถิ่นเทศบาลตำบลปากน้ำแหลมสิงห์,4123,4412,8535,4134,4423,8557,3516
2566,22,จันทบุรี,2288,ท้องถิ่นเทศบาลตำบลมะขาม,774,891,1665,778,894,1672,1038
2566,22,จันทบุรี,2289,ท้องถิ่นเทศบาลตำบลโป่งน้ำร้อน,4993,4076,9069,5182,4253,9435,4427
2566,22,จันทบุรี,2290,ท้องถิ่นเทศบาลตำบลหนองคล้า,1754,1941,3695,1765,1956,3721,2225
2566,22,จันทบุรี,2291,ท้องถิ่นเทศบาลตำบลเนินสูง,1469,1566,3035,1473,1572,3045,1754
2566,22,จันทบุรี,2292,ท้องถิ่นเทศบาลตำบลหนองบัว,1010,1175,2185,1011,1175,2186,988
2566,22,จันทบุรี,2293,ท้องถิ่นเทศบาลตำบลพลับพลานารายณ์,4851,5385,10236,4860,5404,10264,6615
2566,22,จันทบุรี,2294,ท้องถิ่นเทศบาลตำบลบางกะจะ,2453,2676,5129,2461,2678,5139,2277
2566,22,จันทบุรี,2295,ท้องถิ่นเทศบาลเมืองท่าช้าง,6424,7643,14067,6458,7661,14119,11209
2566,22,จันทบุรี,2296,ท้องถิ่นเทศบาลเมืองจันทนิมิต,5367,6103,11470,5469,6216,11685,7959
2566,22,จันทบุรี,2297,ท้องถิ่นเทศบาลเมืองขลุง,4780,5450,10230,4805,5472,10277,4329
2566,22,จันทบุรี,2298,ท้องถิ่นเทศบาลเมืองท่าใหม่,4606,5290,9896,4644,5327,9971,4753
2566,22,จันทบุรี,2299,ท้องถิ่นเทศบาลเมืองจันทบุรี,9588,10648,20236,10159,11110,21269,14943
2566,23,ตราด,2301,อำเภอเมืองตราด,34760,37288,72048,36087,38544,74631,37054
2566,23,ตราด,2302,อำเภอคลองใหญ่,5900,5719,11619,7302,7171,14473,5609
2566,23,ตราด,2303,อำเภอเขาสมิง,19638,19976,39614,19793,20103,39896,18515
2566,23,ตราด,2304,อำเภอบ่อไร่,9395,8899,18294,9521,9038,18559,7834
2566,23,ตราด,2305,อำเภอแหลมงอบ,7155,6963,14118,7252,7063,14315,5995
2566,23,ตราด,2306,อำเภอเกาะกูด,1371,1272,2643,1423,1314,2737,2151
2566,23,ตราด,2307,อำเภอเกาะช้าง,3959,4066,8025,4229,4298,8527,6293
2566,23,ตราด,2389,ท้องถิ่นเทศบาลตำบลตะกาง,1238,1321,2559,1262,1345,2607,1396
2566,23,ตราด,2390,ท้องถิ่นเทศบาลตำบลหนองบอน,3698,3589,7287,3723,3626,7349,3994
2566,23,ตราด,2391,ท้องถิ่นเทศบาลตำบลแหลมงอบ,845,855,1700,856,866,1722,753
2566,23,ตราด,2392,ท้องถิ่นเทศบาลตำบลน้ำเชี่ยว,1512,1624,3136,1519,1634,3153,1339
2566,23,ตราด,2393,ท้องถิ่นเทศบาลตำบลบ่อพลอย,4183,4215,8398,4339,4375,8714,5793
2566,23,ตราด,2394,ท้องถิ่นเทศบาลตำบลแสนตุ้ง,1496,1582,3078,1534,1618,3152,2423
2566,23,ตราด,2395,ท้องถิ่นเทศบาลตำบลเขาสมิง,742,708,1450,745,711,1456,618
2566,23,ตราด,2396,ท้องถิ่นเทศบาลตำบลหาดเล็ก,2488,2368,4856,2691,2561,5252,2020
2566,23,ตราด,2397,ท้องถิ่นเทศบาลตำบลคลองใหญ่,2355,2360,4715,2567,2611,5178,2452
2566,23,ตราด,2398,ท้องถิ่นเทศบาลตำบลท่าพริกเนินทราย,3038,3346,6384,3127,3442,6569,3178
2566,23,ตราด,2399,ท้องถิ่นเทศบาลเมืองตราด,3558,4008,7566,4187,4575,8762,5560
2566,24,ฉะเชิงเทรา,2401,อำเภอเมืองฉะเชิงเทรา,60873,64446,125319,61106,64650,125756,55361
2566,24,ฉะเชิงเทรา,2402,อำเภอบางคล้า,14647,15689,30336,14684,15730,30414,13211
2566,24,ฉะเชิงเทรา,2403,อำเภอบางน้ำเปรี้ยว,36407,37017,73424,36533,37121,73654,23519
2566,24,ฉะเชิงเทรา,2404,อำเภอบางปะกง,28555,29699,58254,28936,30006,58942,29168
2566,24,ฉะเชิงเทรา,2405,อำเภอบ้านโพธิ์,22374,24281,46655,22422,24330,46752,22233
2566,24,ฉะเชิงเทรา,2406,อำเภอพนมสารคาม,34758,36755,71513,34898,36891,71789,31648
2566,24,ฉะเชิงเทรา,2407,อำเภอราชสาส์น,6174,6398,12572,6179,6412,12591,5043
2566,24,ฉะเชิงเทรา,2408,อำเภอสนามชัยเขต,35449,35406,70855,35534,35487,71021,24032
2566,24,ฉะเชิงเทรา,2409,อำเภอแปลงยาว,11712,11480,23192,11751,11522,23273,13139
2566,24,ฉะเชิงเทรา,2410,อำเภอท่าตะเกียบ,23512,23290,46802,23559,23332,46891,17898
2566,24,ฉะเชิงเทรา,2411,อำเภอคลองเขื่อน,6105,6365,12470,6113,6376,12489,4700
2566,24,ฉะเชิงเทรา,2474,ท้องถิ่นเทศบาลตำบลบางวัวคณารักษ์,5470,5944,11414,5486,5956,11442,9542
2566,24,ฉะเชิงเทรา,2475,ท้องถิ่นเทศบาลตำบลพิมพา,1752,1893,3645,1759,1898,3657,4028
2566,24,ฉะเชิงเทรา,2476,ท้องถิ่นเทศบาลตำบลวังเย็น,4804,4915,9719,4814,4926,9740,3800
2566,24,ฉะเชิงเทรา,2477,ท้องถิ่นเทศบาลตำบลดอนเกาะกา,4399,4269,8668,4416,4282,8698,2480
2566,24,ฉะเชิงเทรา,2478,ท้องถิ่นเทศบาลตำบลหัวสำโรง,3368,3524,6892,3373,3535,6908,4170
2566,24,ฉะเชิงเทรา,2479,ท้องถิ่นเทศบาลตำบลแปลงยาว,3046,3196,6242,3052,3200,6252,3760
2566,24,ฉะเชิงเทรา,2480,ท้องถิ่นเทศบาลตำบลทุ่งสะเดา,2979,2564,5543,3082,2670,5752,4716
2566,24,ฉะเชิงเทรา,2481,ท้องถิ่นเทศบาลตำบลสนามชัยเขต,1962,2190,4152,2008,2244,4252,3045
2566,24,ฉะเชิงเทรา,2482,ท้องถิ่นเทศบาลตำบลพนมสารคาม,2845,3311,6156,2853,3321,6174,4302
2566,24,ฉะเชิงเทรา,2483,ท้องถิ่นเทศบาลตำบลเขาหินซ้อน,1693,1774,3467,1695,1776,3471,2701
2566,24,ฉะเชิงเทรา,2484,ท้องถิ่นเทศบาลตำบลเกาะขนุน,982,1095,2077,985,1098,2083,1112
2566,24,ฉะเชิงเทรา,2485,ท้องถิ่นเทศบาลตำบลบ้านโพธิ์,1346,1399,2745,1403,1446,2849,1440
2566,24,ฉะเชิงเทรา,2486,ท้องถิ่นเทศบาลตำบลเทพราช,1993,2110,4103,1997,2116,4113,1306
2566,24,ฉะเชิงเทรา,2487,ท้องถิ่นเทศบาลตำบลบางวัว,1203,1348,2551,1208,1353,2561,2032
2566,24,ฉะเชิงเทรา,2488,ท้องถิ่นเทศบาลตำบลบางปะกง,2798,3083,5881,2809,3100,5909,2951
2566,24,ฉะเชิงเทรา,2489,ท้องถิ่นเทศบาลตำบลหอมศีล,619,627,1246,619,628,1247,324
2566,24,ฉะเชิงเทรา,2490,ท้องถิ่นเทศบาลตำบลท่าสะอ้าน,1783,1901,3684,1788,1901,3689,2717
2566,24,ฉะเชิงเทรา,2491,ท้องถิ่นเทศบาลตำบลท่าข้าม,3570,3805,7375,3578,3819,7397,9375
2566,24,ฉะเชิงเทรา,2492,ท้องถิ่นเทศบาลตำบลศาลาแดง,704,751,1455,706,754,1460,559
2566,24,ฉะเชิงเทรา,2493,ท้องถิ่นเทศบาลตำบลบางน้ำเปรี้ยว,1088,1150,2238,1098,1160,2258,1233
2566,24,ฉะเชิงเทรา,2494,ท้องถิ่นเทศบาลตำบลบางขนาก,1051,1015,2066,1061,1025,2086,809
2566,24,ฉะเชิงเทรา,2495,ท้องถิ่นเทศบาลตำบลดอนฉิมพลี,750,766,1516,761,770,1531,738
2566,24,ฉะเชิงเทรา,2496,ท้องถิ่นเทศบาลตำบลปากน้ำ,2509,2735,5244,2574,2809,5383,2750
2566,24,ฉะเชิงเทรา,2497,ท้องถิ่นเทศบาลตำบลนครเนื่องเขต,624,735,1359,628,739,1367,500
2566,24,ฉะเชิงเทรา,2498,ท้องถิ่นเทศบาลตำบลบางคล้า,4434,5227,9661,4476,5268,9744,5017
2566,24,ฉะเชิงเทรา,2499,ท้องถิ่นเทศบาลเมืองฉะเชิงเทรา,16999,18997,35996,17509,19439,36948,22809
2566,25,ปราจีนบุรี,2501,อำเภอเมืองปราจีนบุรี,45258,42636,87894,45394,42731,88125,37364
2566,25,ปราจีนบุรี,2502,อำเภอกบินทร์บุรี,67230,69582,136812,67345,69657,137002,56056
2566,25,ปราจีนบุรี,2503,อำเภอนาดี,22020,22291,44311,22047,22310,44357,18868
2566,25,ปราจีนบุรี,2506,อำเภอบ้านสร้าง,13335,13920,27255,13357,13950,27307,9744
2566,25,ปราจีนบุรี,2507,อำเภอประจันตคาม,24261,25555,49816,24281,25577,49858,18142
2566,25,ปราจีนบุรี,2508,อำเภอศรีมหาโพธิ,38334,40436,78770,38400,40478,78878,59005
2566,25,ปราจีนบุรี,2509,อำเภอศรีมโหสถ,6635,6826,13461,6642,6834,13476,6890
2566,25,ปราจีนบุรี,2587,ท้องถิ่นเทศบาลตำบลโคกมะกอก,1058,1157,2215,1061,1159,2220,869
2566,25,ปราจีนบุรี,2588,ท้องถิ่นเทศบาลตำบลโคกปีบ,2696,2967,5663,2712,2976,5688,2390
2566,25,ปราจีนบุรี,2589,ท้องถิ่นเทศบาลตำบลศรีมหาโพธิ,1725,1836,3561,1727,1838,3565,2490
2566,25,ปราจีนบุรี,2590,ท้องถิ่นเทศบาลตำบลกรอกสมบูรณ์,1749,1796,3545,1749,1796,3545,1330
2566,25,ปราจีนบุรี,2591,ท้องถิ่นเทศบาลตำบลประจันตคาม,2047,2273,4320,2049,2274,4323,2411
2566,25,ปราจีนบุรี,2592,ท้องถิ่นเทศบาลตำบลบ้านสร้าง,1570,1610,3180,1580,1619,3199,1703
2566,25,ปราจีนบุรี,2593,ท้องถิ่นเทศบาลตำบลนาดี,3874,4009,7883,3883,4026,7909,3452
2566,25,ปราจีนบุรี,2594,ท้องถิ่นเทศบาลตำบลสระบัว,852,903,1755,855,908,1763,655
2566,25,ปราจีนบุรี,2595,ท้องถิ่นเทศบาลตำบลเมืองเก่า,3008,3186,6194,3234,3341,6575,4628
2566,25,ปราจีนบุรี,2596,ท้องถิ่นเทศบาลตำบลบ้านนาปรือ,1101,1114,2215,1103,1115,2218,818
2566,25,ปราจีนบุรี,2598,ท้องถิ่นเทศบาลตำบลกบินทร์,1644,1905,3549,1656,1911,3567,2211
2566,25,ปราจีนบุรี,2599,ท้องถิ่นเทศบาลเมืองปราจีนบุรี,7378,8549,15927,7415,8573,15988,9146
2566,26,นครนายก,2601,อำเภอเมืองนครนายก,42576,42582,85158,42633,42612,85245,37108
2566,26,นครนายก,2602,อำเภอปากพลี,10798,11505,22303,10806,11512,22318,9046
2566,26,นครนายก,2603,อำเภอบ้านนา,31921,32103,64024,32014,32176,64190,25310
2566,26,นครนายก,2604,อำเภอองครักษ์,30641,31597,62238,30954,31869,62823,23585
2566,26,นครนายก,2695,ท้องถิ่นเทศบาลตำบลองครักษ์,1176,1279,2455,1226,1339,2565,1384
2566,26,นครนายก,2696,ท้องถิ่นเทศบาลตำบลบ้านนา,2155,2448,4603,2174,2457,4631,2577
2566,26,นครนายก,2697,ท้องถิ่นเทศบาลตำบลเกาะหวาย,810,904,1714,815,905,1720,764
2566,26,นครนายก,2698,ท้องถิ่นเทศบาลตำบลท่าช้าง,511,529,1040,511,529,1040,337
2566,26,นครนายก,2699,ท้องถิ่นเทศบาลเมืองนครนายก,7217,7975,15192,7442,8143,15585,8808
2566,27,สระแก้ว,2701,อำเภอเมืองสระแก้ว,43666,43047,86713,43785,43164,86949,31059
2566,27,สระแก้ว,2702,อำเภอคลองหาด,19518,19481,38999,19550,19527,39077,14231
2566,27,สระแก้ว,2703,อำเภอตาพระยา,27455,27114,54569,27622,27382,55004,17121
2566,27,สระแก้ว,2704,อำเภอวังน้ำเย็น,20184,20213,40397,20263,20271,40534,15547
2566,27,สระแก้ว,2705,อำเภอวัฒนานคร,38375,37909,76284,38534,38073,76607,27991
2566,27,สระแก้ว,2706,อำเภออรัญประเทศ,36856,37714,74570,37260,38472,75732,38693
2566,27,สระแก้ว,2707,อำเภอเขาฉกรรจ์,25445,25478,50923,25518,25526,51044,16973
2566,27,สระแก้ว,2708,อำเภอโคกสูง,13443,13619,27062,13540,13787,27327,8792
2566,27,สระแก้ว,2709,อำเภอวังสมบูรณ์,12673,12456,25129,12697,12501,25198,10785
2566,27,สระแก้ว,2791,ท้องถิ่นเทศบาลตำบลวังสมบูรณ์,5225,5355,10580,5236,5372,10608,5270
2566,27,สระแก้ว,2792,ท้องถิ่นเทศบาลตำบลเขาฉกรรจ์,2311,2396,4707,2360,2442,4802,2436
2566,27,สระแก้ว,2793,ท้องถิ่นเทศบาลตำบลวัฒนานคร,2546,3003,5549,2551,3011,5562,3130
2566,27,สระแก้ว,2794,ท้องถิ่นเทศบาลเมืองวังน้ำเย็น,9913,10410,20323,9984,10465,20449,10238
2566,27,สระแก้ว,2795,ท้องถิ่นเทศบาลตำบลตาพระยา,1196,1246,2442,1215,1258,2473,1190
2566,27,สระแก้ว,2796,ท้องถิ่นเทศบาลตำบลศาลาลำดวน,1270,1326,2596,1276,1333,2609,1243
2566,27,สระแก้ว,2797,ท้องถิ่นเทศบาลตำบลท่าเกษม,2012,1878,3890,2020,1883,3903,1709
2566,27,สระแก้ว,2798,ท้องถิ่นเทศบาลเมืองอรัญญประเทศ,8164,7037,15201,8914,7799,16713,11674
2566,27,สระแก้ว,2799,ท้องถิ่นเทศบาลเมืองสระแก้ว,8599,9442,18041,8744,9567,18311,12089
2566,30,นครราชสีมา,3001,อำเภอเมืองนครราชสีมา,114738,127266,242004,115114,127399,242513,121276
2566,30,นครราชสีมา,3002,อำเภอครบุรี,39600,40697,80297,39664,40713,80377,31602
2566,30,นครราชสีมา,3003,อำเภอเสิงสาง,28158,28591,56749,28246,28646,56892,17925
2566,30,นครราชสีมา,3004,อำเภอคง,36348,37387,73735,36397,37412,73809,22351
2566,30,นครราชสีมา,3005,อำเภอบ้านเหลื่อม,8470,8641,17111,8480,8645,17125,5336
2566,30,นครราชสีมา,3006,อำเภอจักราช,33512,33933,67445,33542,33946,67488,19958
2566,30,นครราชสีมา,3007,อำเภอโชคชัย,24459,26090,50549,24492,26100,50592,20149
2566,30,นครราชสีมา,3008,อำเภอด่านขุนทด,53933,55454,109387,53967,55474,109441,36210
2566,30,นครราชสีมา,3009,อำเภอโนนไทย,26502,27710,54212,26524,27720,54244,17627
2566,30,นครราชสีมา,3010,อำเภอโนนสูง,41289,43002,84291,41338,43016,84354,26280
2566,30,นครราชสีมา,3011,อำเภอขามสะแกแสง,16504,16652,33156,16534,16655,33189,10317
2566,30,นครราชสีมา,3012,อำเภอบัวใหญ่,33474,33481,66955,33508,33503,67011,19966
2566,30,นครราชสีมา,3013,อำเภอประทาย,34934,35597,70531,34963,35614,70577,20405
2566,30,นครราชสีมา,3014,อำเภอปักธงชัย,44900,47287,92187,44935,47302,92237,33709
2566,30,นครราชสีมา,3015,อำเภอพิมาย,58380,60623,119003,58487,60660,119147,40770
2566,30,นครราชสีมา,3016,อำเภอห้วยแถลง,35036,34907,69943,35051,34922,69973,20467
2566,30,นครราชสีมา,3017,อำเภอชุมพวง,36465,36963,73428,36500,36982,73482,20987
2566,30,นครราชสีมา,3018,อำเภอสูงเนิน,35606,37387,72993,35638,37406,73044,31336
2566,30,นครราชสีมา,3019,อำเภอขามทะเลสอ,12734,13303,26037,12745,13308,26053,9054
2566,30,นครราชสีมา,3020,อำเภอสีคิ้ว,43036,43753,86789,43078,43786,86864,33628
2566,30,นครราชสีมา,3021,อำเภอปากช่อง,62352,63892,126244,62655,64113,126768,72496
2566,30,นครราชสีมา,3022,อำเภอหนองบุญมาก,29894,30568,60462,29945,30582,60527,19356
2566,30,นครราชสีมา,3023,อำเภอแก้งสนามนาง,17879,18344,36223,17888,18350,36238,11079
2566,30,นครราชสีมา,3024,อำเภอโนนแดง,10121,10487,20608,10126,10494,20620,5922
2566,30,นครราชสีมา,3025,อำเภอวังน้ำเขียว,21785,22069,43854,21835,22110,43945,20564
2566,30,นครราชสีมา,3026,อำเภอเทพารักษ์,12726,12591,25317,12736,12598,25334,8906
2566,30,นครราชสีมา,3027,อำเภอเมืองยาง,9807,9671,19478,9812,9678,19490,5707
2566,30,นครราชสีมา,3028,อำเภอพระทองคำ,18144,18416,36560,18167,18425,36592,12675
2566,30,นครราชสีมา,3029,อำเภอลำทะเมนชัย,13819,14041,27860,13830,14047,27877,7816
2566,30,นครราชสีมา,3030,อำเภอบัวลาย,10558,10744,21302,10572,10752,21324,6667
2566,30,นครราชสีมา,3031,อำเภอสีดา,9847,9956,19803,9856,9962,19818,6238
2566,30,นครราชสีมา,3032,อำเภอเฉลิมพระเกียรติ,15152,15929,31081,15169,15935,31104,9823
2566,30,นครราชสีมา,3037,ท้องถิ่นเทศบาลตำบลเมืองยาง,3983,4055,8038,3985,4058,8043,2416
2566,30,นครราชสีมา,3038,ท้องถิ่นเทศบาลตำบลหนองน้ำใส,6637,6663,13300,6644,6667,13311,5289
2566,30,นครราชสีมา,3039,ท้องถิ่นเทศบาลตำบลด่านคล้า,4173,4345,8518,4181,4346,8527,2694
2566,30,นครราชสีมา,3040,ท้องถิ่นเทศบาลตำบลใหม่,6367,6459,12826,6385,6465,12850,3696
2566,30,นครราชสีมา,3041,ท้องถิ่นเทศบาลตำบลหนองบัวตะเกียด,4289,4499,8788,4291,4501,8792,2813
2566,30,นครราชสีมา,3042,ท้องถิ่นเทศบาลตำบลบัลลังก์,3839,3897,7736,3844,3899,7743,2543
2566,30,นครราชสีมา,3043,ท้องถิ่นเทศบาลตำบลหนองไข่น้ำ,3091,3086,6177,3096,3086,6182,1950
2566,30,นครราชสีมา,3044,ท้องถิ่นเทศบาลตำบลท่าเยี่ยม,5614,5765,11379,5620,5765,11385,5753
2566,30,นครราชสีมา,3045,ท้องถิ่นเทศบาลตำบลสีมามงคล,4521,4596,9117,4533,4600,9133,4535
2566,30,นครราชสีมา,3046,ท้องถิ่นเทศบาลตำบลลำนางแก้ว,2345,2384,4729,2346,2385,4731,1457
2566,30,นครราชสีมา,3047,ท้องถิ่นเทศบาลตำบลดอนหวาย,1747,1907,3654,1748,1908,3656,1351
2566,30,นครราชสีมา,3048,ท้องถิ่นเทศบาลตำบลหมูสี,6544,6722,13266,6591,6749,13340,12070
2566,30,นครราชสีมา,3049,ท้องถิ่นเทศบาลตำบลโพธิ์กลาง,14843,14256,29099,14863,14268,29131,13939
2566,30,นครราชสีมา,3050,ท้องถิ่นเทศบาลตำบลหัวทะเล,13208,14601,27809,13246,14625,27871,14473
2566,30,นครราชสีมา,3051,ท้องถิ่นเทศบาลตำบลวังไทร,5598,5838,11436,5613,5843,11456,5762
2566,30,นครราชสีมา,3052,ท้องถิ่นเทศบาลตำบลปรุใหญ่,4638,5130,9768,4649,5131,9780,5381
2566,30,นครราชสีมา,3053,ท้องถิ่นเทศบาลตำบลหนองไผ่ล้อม,9387,4109,13496,9390,4116,13506,11305
2566,30,นครราชสีมา,3054,ท้องถิ่นเทศบาลตำบลท่าช้าง,2425,2600,5025,2428,2600,5028,2172
2566,30,นครราชสีมา,3055,ท้องถิ่นเทศบาลตำบลสีดา,1779,1842,3621,1782,1849,3631,1545
2566,30,นครราชสีมา,3056,ท้องถิ่นเทศบาลตำบลหนองบัวลาย,1157,1211,2368,1160,1213,2373,888
2566,30,นครราชสีมา,3057,ท้องถิ่นเทศบาลตำบลหนองบัววง,2254,2314,4568,2257,2315,4572,1921
2566,30,นครราชสีมา,3058,ท้องถิ่นเทศบาลตำบลพระทองคำ,1933,2066,3999,1939,2068,4007,1683
2566,30,นครราชสีมา,3059,ท้องถิ่นเทศบาลตำบลศาลเจ้าพ่อ,892,1003,1895,895,1005,1900,970
2566,30,นครราชสีมา,3060,ท้องถิ่นเทศบาลตำบลโนนแดง,2081,2185,4266,2083,2189,4272,1640
2566,30,นครราชสีมา,3061,ท้องถิ่นเทศบาลตำบลกลางดง,2455,2531,4986,2461,2537,4998,2779
2566,30,นครราชสีมา,3062,ท้องถิ่นเทศบาลเมืองสีคิ้ว,7629,8551,16180,7648,8576,16224,9730
2566,30,นครราชสีมา,3063,ท้องถิ่นเทศบาลตำบลลาดบัวขาว,1925,2124,4049,1926,2125,4051,2283
2566,30,นครราชสีมา,3064,ท้องถิ่นเทศบาลตำบลคลองไผ่,1923,1635,3558,1934,1645,3579,1767
2566,30,นครราชสีมา,3065,ท้องถิ่นเทศบาลตำบลขามทะเลสอ,2103,2232,4335,2110,2238,4348,2334
2566,30,นครราชสีมา,3066,ท้องถิ่นเทศบาลตำบลสูงเนิน,4478,5051,9529,4549,5118,9667,6423
2566,30,นครราชสีมา,3067,ท้องถิ่นเทศบาลตำบลกุดจิก,1258,1425,2683,1259,1425,2684,1461
2566,30,นครราชสีมา,3068,ท้องถิ่นเทศบาลตำบลชุมพวง,4214,4455,8669,4217,4457,8674,3910
2566,30,นครราชสีมา,3069,ท้องถิ่นเทศบาลตำบลหินดาด,1368,1379,2747,1371,1380,2751,810
2566,30,นครราชสีมา,3070,ท้องถิ่นเทศบาลตำบลห้วยแถลง,1439,1614,3053,1441,1617,3058,1692
2566,30,นครราชสีมา,3071,ท้องถิ่นเทศบาลตำบลพิมาย,3497,4039,7536,3503,4040,7543,2915
2566,30,นครราชสีมา,3072,ท้องถิ่นเทศบาลเมืองเมืองปัก,6205,7109,13314,6224,7129,13353,7171
2566,30,นครราชสีมา,3073,ท้องถิ่นเทศบาลตำบลตะขบ,2546,2653,5199,2546,2655,5201,1976
2566,30,นครราชสีมา,3074,ท้องถิ่นเทศบาลตำบลประทาย,2900,3073,5973,2904,3074,5978,3187
2566,30,นครราชสีมา,3075,ท้องถิ่นเทศบาลตำบลหนองหัวฟาน,2234,2232,4466,2239,2235,4474,1491
2566,30,นครราชสีมา,3076,ท้องถิ่นเทศบาลตำบลขามสะแกแสง,2388,2622,5010,2392,2622,5014,1967
2566,30,นครราชสีมา,3077,ท้องถิ่นเทศบาลตำบลมะค่า,937,944,1881,937,944,1881,610
2566,30,นครราชสีมา,3078,ท้องถิ่นเทศบาลตำบลตลาดแค,1528,1690,3218,1531,1693,3224,1363
2566,30,นครราชสีมา,3079,ท้องถิ่นเทศบาลตำบลโนนไทย,1393,1611,3004,1400,1614,3014,1405
2566,30,นครราชสีมา,3080,ท้องถิ่นเทศบาลตำบลโคกสวาย,2523,2646,5169,2524,2646,5170,1852
2566,30,นครราชสีมา,3081,ท้องถิ่นเทศบาลตำบลหนองกราด,1937,2098,4035,1942,2100,4042,1391
2566,30,นครราชสีมา,3082,ท้องถิ่นเทศบาลตำบลด่านขุนทด,2778,3211,5989,2786,3217,6003,4064
2566,30,นครราชสีมา,3083,ท้องถิ่นเทศบาลตำบลด่านเกวียน,4804,5064,9868,4807,5066,9873,4542
2566,30,นครราชสีมา,3084,ท้องถิ่นเทศบาลตำบลโชคชัย,5736,6372,12108,5908,6555,12463,5652
2566,30,นครราชสีมา,3085,ท้องถิ่นเทศบาลตำบลจักราช,1833,2037,3870,1837,2041,3878,1683
2566,30,นครราชสีมา,3086,ท้องถิ่นเทศบาลตำบลบ้านเหลื่อม,1585,1802,3387,1586,1802,3388,1272
2566,30,นครราชสีมา,3087,ท้องถิ่นเทศบาลตำบลเมืองคง,1018,1124,2142,1025,1125,2150,995
2566,30,นครราชสีมา,3088,ท้องถิ่นเทศบาลตำบลเทพาลัย,1310,1378,2688,1313,1380,2693,896
2566,30,นครราชสีมา,3089,ท้องถิ่นเทศบาลตำบลเสิงสาง,3635,3882,7517,3647,3892,7539,3322
2566,30,นครราชสีมา,3090,ท้องถิ่นเทศบาลตำบลโนนสมบูรณ์,2842,2899,5741,2852,2902,5754,1857
2566,30,นครราชสีมา,3091,ท้องถิ่นเทศบาลตำบลไทรโยง-ไชยวาล,1788,1841,3629,1794,1842,3636,1189
2566,30,นครราชสีมา,3092,ท้องถิ่นเทศบาลตำบลแชะ,2642,3034,5676,2653,3036,5689,3076
2566,30,นครราชสีมา,3093,ท้องถิ่นเทศบาลตำบลจระเข้หิน,2850,3177,6027,2853,3178,6031,2486
2566,30,นครราชสีมา,3094,ท้องถิ่นเทศบาลตำบลจอหอ,8102,8726,16828,8129,8739,16868,10188
2566,30,นครราชสีมา,3095,ท้องถิ่นเทศบาลตำบลโคกกรวด,3223,3737,6960,3257,3764,7021,4770
2566,30,นครราชสีมา,3096,ท้องถิ่นเทศบาลตำบลโนนสูง,4515,4865,9380,4523,4868,9391,4121
2566,30,นครราชสีมา,3097,ท้องถิ่นเทศบาลเมืองบัวใหญ่,6264,6910,13174,6287,6918,13205,7321
2566,30,นครราชสีมา,3098,ท้องถิ่นเทศบาลเมืองปากช่อง,14954,16909,31863,15223,17158,32381,19196
2566,30,นครราชสีมา,3099,ท้องถิ่นเทศบาลนครนครราชสีมา,53290,61540,114830,53733,61901,115634,73012
2566,31,บุรีรัมย์,3101,อำเภอเมืองบุรีรัมย์,86599,88325,174924,86828,88400,175228,55723
2566,31,บุรีรัมย์,3102,อำเภอคูเมือง,29438,29437,58875,29501,29467,58968,16797
2566,31,บุรีรัมย์,3103,อำเภอกระสัง,49843,51092,100935,49950,51134,101084,27220
2566,31,บุรีรัมย์,3104,อำเภอนางรอง,45703,47198,92901,45750,47225,92975,27470
2566,31,บุรีรัมย์,3105,อำเภอหนองกี่,28757,28519,57276,28790,28529,57319,16002
2566,31,บุรีรัมย์,3106,อำเภอละหานทราย,9660,9720,19380,9693,9728,19421,6019
2566,31,บุรีรัมย์,3107,อำเภอประโคนชัย,62065,62854,124919,62204,62919,125123,38071
2566,31,บุรีรัมย์,3108,อำเภอบ้านกรวด,20306,20561,40867,20409,20591,41000,11765
2566,31,บุรีรัมย์,3109,อำเภอพุทไธสง,20137,21171,41308,20150,21179,41329,12666
2566,31,บุรีรัมย์,3110,อำเภอลำปลายมาศ,56689,57016,113705,56758,57040,113798,32152
2566,31,บุรีรัมย์,3111,อำเภอสตึก,48936,49283,98219,48994,49299,98293,28108
2566,31,บุรีรัมย์,3112,อำเภอปะคำ,19121,19051,38172,19152,19062,38214,12136
2566,31,บุรีรัมย์,3113,อำเภอนาโพธิ์,13840,14265,28105,13855,14275,28130,8204
2566,31,บุรีรัมย์,3114,อำเภอหนองหงส์,17769,17564,35333,17779,17569,35348,9666
2566,31,บุรีรัมย์,3115,อำเภอพลับพลาชัย,14054,13709,27763,14101,13715,27816,7480
2566,31,บุรีรัมย์,3116,อำเภอห้วยราช,16095,16351,32446,16125,16355,32480,8562
2566,31,บุรีรัมย์,3117,อำเภอโนนสุวรรณ,10905,10977,21882,10914,10980,21894,6624
2566,31,บุรีรัมย์,3118,อำเภอชำนิ,17546,17666,35212,17576,17676,35252,9465
2566,31,บุรีรัมย์,3119,อำเภอบ้านใหม่ไชยพจน์,10738,11081,21819,10754,11089,21843,6282
2566,31,บุรีรัมย์,3120,อำเภอโนนดินแดง,9372,9265,18637,9404,9280,18684,5911
2566,31,บุรีรัมย์,3121,อำเภอบ้านด่าน,9188,9499,18687,9205,9503,18708,4766
2566,31,บุรีรัมย์,3122,อำเภอแคนดง,13246,13464,26710,13271,13473,26744,7577
2566,31,บุรีรัมย์,3123,อำเภอเฉลิมพระเกียรติ,5981,6063,12044,5991,6071,12062,3653
2566,31,บุรีรัมย์,3162,ท้องถิ่นเทศบาลตำบลจันดุม,5169,5289,10458,5180,5295,10475,3036
2566,31,บุรีรัมย์,3163,ท้องถิ่นเทศบาลตำบลห้วยหิน,4826,4894,9720,4829,4894,9723,2776
2566,31,บุรีรัมย์,3164,ท้องถิ่นเทศบาลตำบลสำโรงใหม่,6291,6301,12592,6305,6306,12611,3868
2566,31,บุรีรัมย์,3165,ท้องถิ่นเทศบาลตำบลจันทบเพชร,3885,3942,7827,3907,3947,7854,2476
2566,31,บุรีรัมย์,3166,ท้องถิ่นเทศบาลตำบลหนองแวง,8450,8361,16811,8458,8366,16824,4367
2566,31,บุรีรัมย์,3167,ท้องถิ่นเทศบาลตำบลหนองไม้งาม,5050,5026,10076,5071,5026,10097,2988
2566,31,บุรีรัมย์,3168,ท้องถิ่นเทศบาลตำบลบ้านกรวดปัญญาวัฒน์,4659,4674,9333,4690,4676,9366,2795
2566,31,บุรีรัมย์,3169,ท้องถิ่นเทศบาลตำบลบ้านด่าน,5852,6070,11922,5876,6071,11947,3438
2566,31,บุรีรัมย์,3170,ท้องถิ่นเทศบาลตำบลถาวร,3773,3839,7612,3780,3841,7621,2256
2566,31,บุรีรัมย์,3171,ท้องถิ่นเทศบาลตำบลยายแย้มวัฒนา,4330,4283,8613,4343,4288,8631,2411
2566,31,บุรีรัมย์,3172,ท้องถิ่นเทศบาลตำบลอิสาณ,10399,11550,21949,10466,11560,22026,13422
2566,31,บุรีรัมย์,3174,ท้องถิ่นเทศบาลตำบลศาลเจ้าพ่อขุนศรี,1659,1704,3363,1661,1705,3366,1354
2566,31,บุรีรัมย์,3175,ท้องถิ่นเทศบาลตำบลตาจง,8373,8237,16610,8391,8248,16639,4475
2566,31,บุรีรัมย์,3176,ท้องถิ่นเทศบาลตำบลพนมรุ้ง,5619,6054,11673,5628,6057,11685,4017
2566,31,บุรีรัมย์,3177,ท้องถิ่นเทศบาลตำบลแคนดง,2667,2751,5418,2673,2752,5425,2021
2566,31,บุรีรัมย์,3178,ท้องถิ่นเทศบาลตำบลโนนดินแดง,4541,4715,9256,4572,4722,9294,3701
2566,31,บุรีรัมย์,3179,ท้องถิ่นเทศบาลตำบลบ้านใหม่ไชยพจน์,2068,2174,4242,2082,2177,4259,1462
2566,31,บุรีรัมย์,3180,ท้องถิ่นเทศบาลตำบลโนนสุวรรณ,1578,1652,3230,1581,1653,3234,1092
2566,31,บุรีรัมย์,3181,ท้องถิ่นเทศบาลตำบลห้วยราช,2458,2552,5010,2465,2554,5019,1470
2566,31,บุรีรัมย์,3182,ท้องถิ่นเทศบาลตำบลพลับพลาชัย,3354,3289,6643,3363,3290,6653,2047
2566,31,บุรีรัมย์,3183,ท้องถิ่นเทศบาลตำบลหนองหงส์,2329,2367,4696,2333,2368,4701,1817
2566,31,บุรีรัมย์,3184,ท้องถิ่นเทศบาลตำบลนาโพธิ์,1703,1906,3609,1706,1907,3613,1706
2566,31,บุรีรัมย์,3185,ท้องถิ่นเทศบาลตำบลปะคำ,3514,3616,7130,3521,3620,7141,2916
2566,31,บุรีรัมย์,3186,ท้องถิ่นเทศบาลตำบลสตึก,5187,5590,10777,5216,5604,10820,5764
2566,31,บุรีรัมย์,3187,ท้องถิ่นเทศบาลเมืองลำปลายมาศ,6246,6843,13089,6259,6853,13112,6362
2566,31,บุรีรัมย์,3188,ท้องถิ่นเทศบาลตำบลทะเมนชัย,2102,2148,4250,2105,2149,4254,1283
2566,31,บุรีรัมย์,3189,ท้องถิ่นเทศบาลตำบลพุทไธสง,1968,2146,4114,1970,2147,4117,2301
2566,31,บุรีรัมย์,3190,ท้องถิ่นเทศบาลตำบลบ้านกรวด,1856,1969,3825,1876,1970,3846,2021
2566,31,บุรีรัมย์,3191,ท้องถิ่นเทศบาลตำบลตลาดนิคมปราสาท,2345,2449,4794,2366,2450,4816,1823
2566,31,บุรีรัมย์,3192,ท้องถิ่นเทศบาลเมืองประโคนชัย,4284,4822,9106,4294,4825,9119,4144
2566,31,บุรีรัมย์,3193,ท้องถิ่นเทศบาลตำบลละหานทราย,4108,4104,8212,4126,4110,8236,3581
2566,31,บุรีรัมย์,3194,ท้องถิ่นเทศบาลตำบลหนองกี่,4605,4982,9587,4611,4991,9602,4245
2566,31,บุรีรัมย์,3195,ท้องถิ่นเทศบาลตำบลกระสัง,1539,1736,3275,1553,1748,3301,1859
2566,31,บุรีรัมย์,3196,ท้องถิ่นเทศบาลตำบลหินเหล็กไฟ,2393,2526,4919,2396,2527,4923,1872
2566,31,บุรีรัมย์,3197,ท้องถิ่นเทศบาลตำบลคูเมือง,1789,1786,3575,1795,1789,3584,2070
2566,31,บุรีรัมย์,3198,ท้องถิ่นเทศบาลเมืองนางรอง,9468,10706,20174,9493,10726,20219,11685
2566,31,บุรีรัมย์,3199,ท้องถิ่นเทศบาลนครบุรีรัมย์,11075,12203,23278,11126,12238,23364,14620
2566,32,สุรินทร์,3201,อำเภอเมืองสุรินทร์,106957,109967,216924,107266,110045,217311,79616
2566,32,สุรินทร์,3202,อำเภอชุมพลบุรี,34031,33994,68025,34049,34009,68058,19398
2566,32,สุรินทร์,3203,อำเภอท่าตูม,45415,45266,90681,45447,45308,90755,24264
2566,32,สุรินทร์,3204,อำเภอจอมพระ,27056,27034,54090,27066,27046,54112,14436
2566,32,สุรินทร์,3205,อำเภอปราสาท,70828,72671,143499,70988,72717,143705,43659
2566,32,สุรินทร์,3206,อำเภอกาบเชิง,29998,29791,59789,30043,29811,59854,19243
2566,32,สุรินทร์,3207,อำเภอรัตนบุรี,43010,43272,86282,43046,43294,86340,23758
2566,32,สุรินทร์,3208,อำเภอสนม,19170,18965,38135,19185,18971,38156,11105
2566,32,สุรินทร์,3209,อำเภอศีขรภูมิ,64163,65029,129192,64203,65058,129261,33516
2566,32,สุรินทร์,3210,อำเภอสังขะ,63534,63241,126775,63611,63257,126868,35915
2566,32,สุรินทร์,3211,อำเภอลำดวน,13338,13335,26673,13352,13341,26693,7292
2566,32,สุรินทร์,3212,อำเภอสำโรงทาบ,25095,24929,50024,25101,24933,50034,12174
2566,32,สุรินทร์,3213,อำเภอบัวเชด,17777,17172,34949,17805,17181,34986,10145
2566,32,สุรินทร์,3214,อำเภอพนมดงรัก,18973,18678,37651,19032,18702,37734,12638
2566,32,สุรินทร์,3215,อำเภอศรีณรงค์,23399,23081,46480,23412,23089,46501,11997
2566,32,สุรินทร์,3216,อำเภอเขวาสินรินทร์,16733,17170,33903,16764,17183,33947,10349
2566,32,สุรินทร์,3217,อำเภอโนนนารายณ์,17251,17406,34657,17257,17408,34665,8946
2566,32,สุรินทร์,3286,ท้องถิ่นเทศบาลตำบลบัวเชด,3166,3303,6469,3168,3304,6472,2481
2566,32,สุรินทร์,3287,ท้องถิ่นเทศบาลตำบลสำโรงทาบ,1136,1140,2276,1140,1141,2281,1300
2566,32,สุรินทร์,3288,ท้องถิ่นเทศบาลตำบลลำดวนสุรพินท์,2018,2243,4261,2024,2247,4271,1924
2566,32,สุรินทร์,3289,ท้องถิ่นเทศบาลตำบลสังขะ,1624,1889,3513,1628,1893,3521,2406
2566,32,สุรินทร์,3290,ท้องถิ่นเทศบาลตำบลศีขรภูมิ,2219,2388,4607,2222,2392,4614,2902
2566,32,สุรินทร์,3291,ท้องถิ่นเทศบาลตำบลสนม,2387,2545,4932,2392,2548,4940,1670
2566,32,สุรินทร์,3292,ท้องถิ่นเทศบาลตำบลรัตนบุรี,2501,2703,5204,2504,2706,5210,2769
2566,32,สุรินทร์,3293,ท้องถิ่นเทศบาลตำบลนิคมปราสาท,1328,1316,2644,1330,1317,2647,885
2566,32,สุรินทร์,3294,ท้องถิ่นเทศบาลตำบลกังแอน,2571,2959,5530,2593,2971,5564,3489
2566,32,สุรินทร์,3295,ท้องถิ่นเทศบาลตำบลจอมพระ,1907,2121,4028,1913,2122,4035,1987
2566,32,สุรินทร์,3296,ท้องถิ่นเทศบาลตำบลท่าตูม,1875,2006,3881,1878,2009,3887,1842
2566,32,สุรินทร์,3297,ท้องถิ่นเทศบาลตำบลชุมพลบุรี,1072,1171,2243,1073,1173,2246,1138
2566,32,สุรินทร์,3298,ท้องถิ่นเทศบาลตำบลเมืองที,947,920,1867,949,921,1870,576
2566,32,สุรินทร์,3299,ท้องถิ่นเทศบาลเมืองสุรินทร์,16952,20032,36984,17134,20170,37304,17448
2566,33,ศรีสะเกษ,3301,อำเภอเมืองศรีสะเกษ,42868,44506,87374,42899,44533,87432,28186
2566,33,ศรีสะเกษ,3302,อำเภอยางชุมน้อย,14757,14622,29379,14761,14626,29387,7811
2566,33,ศรีสะเกษ,3303,อำเภอกันทรารมย์,46288,46640,92928,46306,46653,92959,25236
2566,33,ศรีสะเกษ,3304,อำเภอกันทรลักษ์,91914,91686,183600,92104,91838,183942,52863
2566,33,ศรีสะเกษ,3305,อำเภอขุขันธ์,71941,72718,144659,72045,72796,144841,36385
2566,33,ศรีสะเกษ,3306,อำเภอไพรบึง,17984,18257,36241,17989,18258,36247,9355
2566,33,ศรีสะเกษ,3307,อำเภอปรางค์กู่,31284,31738,63022,31309,31754,63063,15591
2566,33,ศรีสะเกษ,3308,อำเภอขุนหาญ,34141,34589,68730,34204,34624,68828,18681
2566,33,ศรีสะเกษ,3309,อำเภอราษีไศล,37381,37744,75125,37401,37755,75156,20814
2566,33,ศรีสะเกษ,3310,อำเภออุทุมพรพิสัย,50300,50962,101262,50342,50990,101332,27284
2566,33,ศรีสะเกษ,3311,อำเภอบึงบูรพ์,2168,2178,4346,2169,2178,4347,1131
2566,33,ศรีสะเกษ,3312,อำเภอห้วยทับทัน,19414,19357,38771,19433,19365,38798,9257
2566,33,ศรีสะเกษ,3313,อำเภอโนนคูณ,19757,19539,39296,19769,19547,39316,12099
2566,33,ศรีสะเกษ,3314,อำเภอศรีรัตนะ,24054,24297,48351,24068,24303,48371,11797
2566,33,ศรีสะเกษ,3315,อำเภอน้ำเกลี้ยง,22420,21961,44381,22438,21971,44409,11635
2566,33,ศรีสะเกษ,3316,อำเภอวังหิน,20283,20054,40337,20306,20071,40377,9841
2566,33,ศรีสะเกษ,3317,อำเภอภูสิงห์,27625,27146,54771,27641,27164,54805,16420
2566,33,ศรีสะเกษ,3318,อำเภอเมืองจันทร์,8920,8734,17654,8926,8740,17666,4565
2566,33,ศรีสะเกษ,3319,อำเภอเบญจลักษ์,18129,17785,35914,18134,17787,35921,9664
2566,33,ศรีสะเกษ,3320,อำเภอพยุห์,15255,15575,30830,15264,15579,30843,8491
2566,33,ศรีสะเกษ,3321,อำเภอโพธิ์ศรีสุวรรณ,11792,11732,23524,11795,11741,23536,5859
2566,33,ศรีสะเกษ,3322,อำเภอศิลาลาด,9860,9759,19619,9864,9763,19627,5538
2566,33,ศรีสะเกษ,3381,ท้องถิ่นเทศบาลตำบลบุสูง,5188,5031,10219,5199,5035,10234,2847
2566,33,ศรีสะเกษ,3382,ท้องถิ่นเทศบาลตำบลกันทรอม,4586,4422,9008,4588,4423,9011,2342
2566,33,ศรีสะเกษ,3383,ท้องถิ่นเทศบาลตำบลกระหวัน,4329,4454,8783,4332,4457,8789,2276
2566,33,ศรีสะเกษ,3384,ท้องถิ่นเทศบาลตำบลน้ำคำ,5175,5357,10532,5177,5359,10536,3154
2566,33,ศรีสะเกษ,3385,ท้องถิ่นเทศบาลตำบลโพธิ์กระสังข์,4564,4573,9137,4566,4577,9143,2109
2566,33,ศรีสะเกษ,3386,ท้องถิ่นเทศบาลตำบลพยุห์,1932,1968,3900,1934,1969,3903,1504
2566,33,ศรีสะเกษ,3387,ท้องถิ่นเทศบาลตำบลศรีรัตนะ,2271,2352,4623,2273,2353,4626,1489
2566,33,ศรีสะเกษ,3388,ท้องถิ่นเทศบาลตำบลห้วยทับทัน,1672,1618,3290,1672,1618,3290,1094
2566,33,ศรีสะเกษ,3389,ท้องถิ่นเทศบาลตำบลบึงบูรพ์,2946,3076,6022,2948,3077,6025,1887
2566,33,ศรีสะเกษ,3390,ท้องถิ่นเทศบาลตำบลกำแพง,1222,1343,2565,1227,1348,2575,1346
2566,33,ศรีสะเกษ,3391,ท้องถิ่นเทศบาลตำบลเมืองคง,1860,1980,3840,1863,1980,3843,2146
2566,33,ศรีสะเกษ,3392,ท้องถิ่นเทศบาลตำบลขุนหาญ,5229,5391,10620,5251,5393,10644,3884
2566,33,ศรีสะเกษ,3393,ท้องถิ่นเทศบาลตำบลปรางค์กู่,1341,1403,2744,1344,1404,2748,1368
2566,33,ศรีสะเกษ,3394,ท้องถิ่นเทศบาลตำบลไพรบึง,5400,5390,10790,5403,5391,10794,3008
2566,33,ศรีสะเกษ,3395,ท้องถิ่นเทศบาลตำบลเมืองขุขันธ์,2002,2138,4140,2006,2139,4145,2194
2566,33,ศรีสะเกษ,3396,ท้องถิ่นเทศบาลเมืองกันทรลักษ์,8334,9087,17421,8378,9107,17485,7772
2566,33,ศรีสะเกษ,3397,ท้องถิ่นเทศบาลตำบลกันทรารมย์,2865,3073,5938,2871,3076,5947,3316
2566,33,ศรีสะเกษ,3398,ท้องถิ่นเทศบาลตำบลยางชุมน้อย,3061,3194,6255,3063,3198,6261,2499
2566,33,ศรีสะเกษ,3399,ท้องถิ่นเทศบาลเมืองศรีสะเกษ,18332,20637,38969,18428,20703,39131,21502
2566,34,อุบลราชธานี,3401,อำเภอเมืองอุบลราชธานี,47931,49753,97684,48070,49817,97887,37986
2566,34,อุบลราชธานี,3402,อำเภอศรีเมืองใหม่,33506,32975,66481,33643,33191,66834,19987
2566,34,อุบลราชธานี,3403,อำเภอโขงเจียม,17888,17279,35167,18240,17977,36217,10702
2566,34,อุบลราชธานี,3404,อำเภอเขื่องใน,50240,51300,101540,50278,51326,101604,28937
2566,34,อุบลราชธานี,3405,อำเภอเขมราฐ,15716,15506,31222,15898,15922,31820,9420
2566,34,อุบลราชธานี,3407,อำเภอเดชอุดม,66470,65637,132107,66522,65659,132181,55069
2566,34,อุบลราชธานี,3408,อำเภอนาจะหลวย,26219,25546,51765,26255,25579,51834,19147
2566,34,อุบลราชธานี,3409,อำเภอน้ำยืน,31078,30212,61290,31115,30260,61375,21295
2566,34,อุบลราชธานี,3410,อำเภอบุณฑริก,39273,38136,77409,39571,38523,78094,25017
2566,34,อุบลราชธานี,3411,อำเภอตระการพืชผล,56122,55715,111837,56181,55789,111970,30806
2566,34,อุบลราชธานี,3412,อำเภอกุดข้าวปุ้น,18390,18276,36666,18400,18294,36694,9842
2566,34,อุบลราชธานี,3414,อำเภอม่วงสามสิบ,40597,40556,81153,40631,40590,81221,23786
2566,34,อุบลราชธานี,3415,อำเภอวารินชำราบ,46166,47006,93172,46258,47068,93326,32325
2566,34,อุบลราชธานี,3419,อำเภอพิบูลมังสาหาร,52434,51708,104142,52529,51847,104376,35451
2566,34,อุบลราชธานี,3420,อำเภอตาลสุม,15141,14745,29886,15155,14758,29913,8843
2566,34,อุบลราชธานี,3421,อำเภอโพธิ์ไทร,22572,21787,44359,22814,22196,45010,12476
2566,34,อุบลราชธานี,3422,อำเภอสำโรง,27025,26956,53981,27038,26961,53999,15453
2566,34,อุบลราชธานี,3424,อำเภอดอนมดแดง,13687,13483,27170,13701,13500,27201,8313
2566,34,อุบลราชธานี,3425,อำเภอสิรินธร,22276,21306,43582,22523,21821,44344,15228
2566,34,อุบลราชธานี,3426,อำเภอทุ่งศรีอุดม,14769,14400,29169,14775,14408,29183,9438
2566,34,อุบลราชธานี,3429,อำเภอนาเยีย,10874,10231,21105,10883,10238,21121,7501
2566,34,อุบลราชธานี,3430,อำเภอนาตาล,19212,18930,38142,19452,19345,38797,11799
2566,34,อุบลราชธานี,3431,อำเภอเหล่าเสือโก้ก,14067,14002,28069,14081,14009,28090,8282
2566,34,อุบลราชธานี,3432,อำเภอสว่างวีระวงศ์,15691,15549,31240,15708,15569,31277,9640
2566,34,อุบลราชธานี,3433,อำเภอน้ำขุ่น,16787,16527,33314,16805,16533,33338,11338
2566,34,อุบลราชธานี,3463,ท้องถิ่นเทศบาลตำบลกุดชมภู,5900,5843,11743,5927,5880,11807,4575
2566,34,อุบลราชธานี,3464,ท้องถิ่นเทศบาลตำบลคำน้ำแซบ,4048,4182,8230,4070,4190,8260,3411
2566,34,อุบลราชธานี,3465,ท้องถิ่นเทศบาลตำบลหัวนา,6528,6615,13143,6551,6636,13187,3716
2566,34,อุบลราชธานี,3466,ท้องถิ่นเทศบาลตำบลโพนงาม,4483,4594,9077,4488,4594,9082,3367
2566,34,อุบลราชธานี,3467,ท้องถิ่นเทศบาลตำบลเมืองศรีไค,3453,4485,7938,3459,4487,7946,3519
2566,34,อุบลราชธานี,3468,ท้องถิ่นเทศบาลตำบลหนองผือ,4867,5009,9876,4873,5019,9892,3512
2566,34,อุบลราชธานี,3469,ท้องถิ่นเทศบาลตำบลขามป้อม,4732,4658,9390,4767,4728,9495,3324
2566,34,อุบลราชธานี,3470,ท้องถิ่นเทศบาลเมืองเทพวงศา,5941,5751,11692,6162,6219,12381,4305
2566,34,อุบลราชธานี,3471,ท้องถิ่นเทศบาลตำบลปทุม,4921,5561,10482,4954,5576,10530,4310
2566,34,อุบลราชธานี,3472,ท้องถิ่นเทศบาลตำบลคอแลน,6681,6463,13144,6747,6589,13336,4173
2566,34,อุบลราชธานี,3473,ท้องถิ่น ทต.นิคมสร้างตนเองลำโดมน้อย,3894,3866,7760,3932,3938,7870,3070
2566,34,อุบลราชธานี,3474,ท้องถิ่นเทศบาลตำบลกุดประทาย,6957,6749,13706,6960,6758,13718,5303
2566,34,อุบลราชธานี,3475,ท้องถิ่นเทศบาลตำบลขามใหญ่,19395,21675,41070,19561,21715,41276,22280
2566,34,อุบลราชธานี,3476,ท้องถิ่นเทศบาลตำบลแสนสุข,13273,11208,24481,13333,11225,24558,11776
2566,34,อุบลราชธานี,3477,ท้องถิ่นเทศบาลตำบลนาเยีย,3145,3222,6367,3147,3224,6371,1930
2566,34,อุบลราชธานี,3478,ท้องถิ่นเทศบาลตำบลช่องเม็ก,1802,1801,3603,1826,1941,3767,1963
2566,34,อุบลราชธานี,3479,ท้องถิ่นเทศบาลตำบลโพธิ์ไทร,1461,1529,2990,1466,1531,2997,1215
2566,34,อุบลราชธานี,3480,ท้องถิ่นเทศบาลตำบลตาลสุม,1580,1601,3181,1580,1601,3181,1141
2566,34,อุบลราชธานี,3481,ท้องถิ่นเทศบาลตำบลอ่างศิลา,1457,1586,3043,1458,1588,3046,1047
2566,34,อุบลราชธานี,3482,ท้องถิ่นเทศบาลตำบลห้วยขะยุง,1505,1571,3076,1509,1571,3080,1004
2566,34,อุบลราชธานี,3483,ท้องถิ่นเทศบาลตำบลม่วงสามสิบ,1413,1568,2981,1419,1570,2989,1625
2566,34,อุบลราชธานี,3484,ท้องถิ่นเทศบาลตำบลกุดข้าวปุ้น,2079,2051,4130,2081,2053,4134,1538
2566,34,อุบลราชธานี,3485,ท้องถิ่นเทศบาลตำบลตระการพืชผล,4280,4540,8820,4296,4552,8848,4485
2566,34,อุบลราชธานี,3486,ท้องถิ่นเทศบาลตำบลบุณฑริก,2117,2243,4360,2120,2248,4368,2167
2566,34,อุบลราชธานี,3487,ท้องถิ่นเทศบาลตำบลน้ำยืน,4319,4417,8736,4328,4428,8756,3482
2566,34,อุบลราชธานี,3488,ท้องถิ่นเทศบาลตำบลนาจะหลวย,3422,3482,6904,3433,3487,6920,2720
2566,34,อุบลราชธานี,3489,ท้องถิ่นเทศบาลเมืองเดชอุดม,6132,6733,12865,6145,6744,12889,6922
2566,34,อุบลราชธานี,3490,ท้องถิ่นเทศบาลตำบลบัวงาม,3283,3303,6586,3285,3304,6589,1927
2566,34,อุบลราชธานี,3491,ท้องถิ่นเทศบาลตำบลนาส่วง,1509,1612,3121,1509,1614,3123,1035
2566,34,อุบลราชธานี,3492,ท้องถิ่นเทศบาลตำบลเขมราฐ,2716,2947,5663,2754,3053,5807,2610
2566,34,อุบลราชธานี,3493,ท้องถิ่นเทศบาลตำบลเขื่องใน,2140,2295,4435,2142,2297,4439,2168
2566,34,อุบลราชธานี,3494,ท้องถิ่นเทศบาลตำบลบ้านด่านโขงเจียม,1365,1319,2684,1421,1459,2880,1363
2566,34,อุบลราชธานี,3495,ท้องถิ่นเทศบาลตำบลศรีเมืองใหม่,2029,2027,4056,2034,2035,4069,2055
2566,34,อุบลราชธานี,3496,ท้องถิ่นเทศบาลตำบลอุบล,2546,3008,5554,2572,3011,5583,3190
2566,34,อุบลราชธานี,3497,ท้องถิ่นเทศบาลเมืองพิบูลมังสาหาร,4839,5130,9969,4854,5147,10001,4664
2566,34,อุบลราชธานี,3498,ท้องถิ่นเทศบาลเมืองวารินชำราบ,11618,13162,24780,11656,13183,24839,11054
2566,34,อุบลราชธานี,3499,ท้องถิ่นเทศบาลนครอุบลราชธานี,31823,37351,69174,32196,37692,69888,32530
2566,35,ยโสธร,3501,อำเภอเมืองยโสธร,52901,53249,106150,52965,53278,106243,40264
2566,35,ยโสธร,3502,อำเภอทรายมูล,12132,12122,24254,12142,12128,24270,8330
2566,35,ยโสธร,3503,อำเภอกุดชุม,30669,30313,60982,30688,30328,61016,20753
2566,35,ยโสธร,3504,อำเภอคำเขื่อนแก้ว,30523,30608,61131,30547,30624,61171,19849
2566,35,ยโสธร,3505,อำเภอป่าติ้ว,15762,15937,31699,15777,15942,31719,10486
2566,35,ยโสธร,3506,อำเภอมหาชนะชัย,25452,25409,50861,25465,25424,50889,15085
2566,35,ยโสธร,3507,อำเภอค้อวัง,10192,10377,20569,10196,10384,20580,5688
2566,35,ยโสธร,3508,อำเภอเลิงนกทา,44413,44826,89239,44447,44855,89302,31116
2566,35,ยโสธร,3509,อำเภอไทยเจริญ,15076,15242,30318,15083,15251,30334,11276
2566,35,ยโสธร,3591,ท้องถิ่นเทศบาลตำบลสามแยก,1851,1945,3796,1857,1945,3802,2320
2566,35,ยโสธร,3592,ท้องถิ่นเทศบาลตำบลเลิงนกทา,1372,1461,2833,1375,1464,2839,1120
2566,35,ยโสธร,3593,ท้องถิ่นเทศบาลตำบลค้อวัง,2146,2280,4426,2148,2280,4428,1680
2566,35,ยโสธร,3594,ท้องถิ่นเทศบาลตำบลฟ้าหยาด,2264,2324,4588,2265,2326,4591,1899
2566,35,ยโสธร,3595,ท้องถิ่นเทศบาลตำบลป่าติ้ว,1465,1500,2965,1467,1501,2968,1292
2566,35,ยโสธร,3596,ท้องถิ่นเทศบาลตำบลคำเขื่อนแก้ว,1814,1891,3705,1815,1895,3710,1579
2566,35,ยโสธร,3597,ท้องถิ่นเทศบาลตำบลกุดชุมพัฒนา,2332,2438,4770,2336,2439,4775,2298
2566,35,ยโสธร,3598,ท้องถิ่นเทศบาลตำบลทรายมูล,2989,3205,6194,2992,3207,6199,2243
2566,35,ยโสธร,3599,ท้องถิ่นเทศบาลเมืองยโสธร,9616,10394,20010,9634,10408,20042,9406
2566,36,ชัยภูมิ,3601,อำเภอเมืองชัยภูมิ,66246,69667,135913,66377,69717,136094,57113
2566,36,ชัยภูมิ,3602,อำเภอบ้านเขว้า,20643,21181,41824,20652,21194,41846,15173
2566,36,ชัยภูมิ,3603,อำเภอคอนสวรรค์,23416,23976,47392,23442,23988,47430,18539
2566,36,ชัยภูมิ,3604,อำเภอเกษตรสมบูรณ์,42178,42658,84836,42238,42679,84917,25923
2566,36,ชัยภูมิ,3605,อำเภอหนองบัวแดง,46530,46335,92865,46639,46389,93028,30938
2566,36,ชัยภูมิ,3606,อำเภอจัตุรัส,32434,34683,67117,32473,34703,67176,25655
2566,36,ชัยภูมิ,3607,อำเภอบำเหน็จณรงค์,19924,20450,40374,19945,20463,40408,14096
2566,36,ชัยภูมิ,3608,อำเภอหนองบัวระเหว,16326,16243,32569,16346,16248,32594,11990
2566,36,ชัยภูมิ,3609,อำเภอเทพสถิต,32865,32334,65199,32924,32351,65275,24799
2566,36,ชัยภูมิ,3610,อำเภอภูเขียว,52819,54696,107515,52939,54731,107670,36345
2566,36,ชัยภูมิ,3611,อำเภอบ้านแท่น,20097,20458,40555,20117,20465,40582,12039
2566,36,ชัยภูมิ,3612,อำเภอแก้งคร้อ,36139,36326,72465,36170,36339,72509,26079
2566,36,ชัยภูมิ,3613,อำเภอคอนสาร,20000,20426,40426,20027,20436,40463,14448
2566,36,ชัยภูมิ,3614,อำเภอภักดีชุมพล,15337,15139,30476,15372,15166,30538,12665
2566,36,ชัยภูมิ,3615,อำเภอเนินสง่า,12751,13103,25854,12759,13111,25870,8870
2566,36,ชัยภูมิ,3616,อำเภอซับใหญ่,7886,7703,15589,7897,7709,15606,5958
2566,36,ชัยภูมิ,3653,สาขาตำบลวังชมภู หนองบัวแดง,0,0,0,0,0,0,0
2566,36,ชัยภูมิ,3676,ท้องถิ่นเทศบาลตำบลห้วยยาง,7655,7623,15278,7665,7630,15295,4744
2566,36,ชัยภูมิ,3677,ท้องถิ่นเทศบาลตำบลบ้านเดื่อ,7665,7774,15439,7670,7775,15445,4729
2566,36,ชัยภูมิ,3680,ท้องถิ่นเทศบาลตำบลคอนสาร,1926,2158,4084,1931,2160,4091,1495
2566,36,ชัยภูมิ,3681,ท้องถิ่นเทศบาลตำบลแก้งคร้อ,3826,4381,8207,3835,4385,8220,4754
2566,36,ชัยภูมิ,3682,ท้องถิ่นเทศบาลตำบลนาหนองทุ่ม,5129,5515,10644,5136,5515,10651,3389
2566,36,ชัยภูมิ,3683,ท้องถิ่นเทศบาลตำบลบ้านแท่น,1918,2006,3924,1921,2006,3927,1668
2566,36,ชัยภูมิ,3684,ท้องถิ่นเทศบาลตำบลภูเขียว,2729,3179,5908,2746,3186,5932,3082
2566,36,ชัยภูมิ,3685,ท้องถิ่นเทศบาลตำบลบ้านเพชรภูเขียว,2702,2764,5466,2707,2766,5473,1797
2566,36,ชัยภูมิ,3686,ท้องถิ่นเทศบาลตำบลเทพสถิต,1862,1893,3755,1867,1895,3762,2371
2566,36,ชัยภูมิ,3687,ท้องถิ่นเทศบาลตำบลหนองบัวระเหว,2857,2917,5774,2864,2920,5784,2744
2566,36,ชัยภูมิ,3688,ท้องถิ่นเทศบาลตำบลบำเหน็จณรงค์,3202,3485,6687,3208,3486,6694,3084
2566,36,ชัยภูมิ,3689,ท้องถิ่นเทศบาลตำบลบ้านเพชร,2278,2447,4725,2282,2451,4733,2269
2566,36,ชัยภูมิ,3690,ท้องถิ่นเทศบาลตำบลหนองบัวโคก,915,951,1866,917,952,1869,804
2566,36,ชัยภูมิ,3691,ท้องถิ่นเทศบาลตำบลจัตุรัส,1926,2127,4053,1930,2128,4058,2264
2566,36,ชัยภูมิ,3692,ท้องถิ่นเทศบาลตำบลหนองบัวแดง,4178,4403,8581,4190,4411,8601,4452
2566,36,ชัยภูมิ,3693,ท้องถิ่นเทศบาลตำบลบ้านเป้า,3653,3864,7517,3656,3866,7522,2414
2566,36,ชัยภูมิ,3694,ท้องถิ่นเทศบาลตำบลเกษตรสมบูรณ์,1358,1500,2858,1362,1504,2866,1348
2566,36,ชัยภูมิ,3695,ท้องถิ่นเทศบาลตำบลคอนสวรรค์,1918,2150,4068,1930,2150,4080,1929
2566,36,ชัยภูมิ,3696,ท้องถิ่นเทศบาลตำบลบ้านเขว้า,3705,4093,7798,3711,4094,7805,3502
2566,36,ชัยภูมิ,3697,ท้องถิ่นเทศบาลตำบลลาดใหญ่,2104,2389,4493,2107,2389,4496,1791
2566,36,ชัยภูมิ,3698,ท้องถิ่นเทศบาลตำบลบ้านค่ายหมื่นแผ้ว,2314,2444,4758,2322,2445,4767,1957
2566,36,ชัยภูมิ,3699,ท้องถิ่นเทศบาลเมืองชัยภูมิ,16690,18517,35207,16758,18543,35301,21763
2566,37,อำนาจเจริญ,3701,อำเภอเมืองอำนาจเจริญ,48458,48603,97061,48524,48649,97173,32684
2566,37,อำนาจเจริญ,3702,อำเภอชานุมาน,19358,19183,38541,19488,19396,38884,12235
2566,37,อำนาจเจริญ,3703,อำเภอปทุมราชวงศา,22924,22679,45603,22937,22684,45621,14088
2566,37,อำนาจเจริญ,3704,อำเภอพนา,9606,9460,19066,9608,9461,19069,6993
2566,37,อำนาจเจริญ,3705,อำเภอเสนางคนิคม,17291,17604,34895,17312,17621,34933,11362
2566,37,อำนาจเจริญ,3706,อำเภอหัวตะพาน,20861,20825,41686,20868,20849,41717,11368
2566,37,อำนาจเจริญ,3707,อำเภอลืออำนาจ,16828,17042,33870,16835,17051,33886,10165
2566,37,อำนาจเจริญ,3790,ท้องถิ่นเทศบาลตำบลนายม,2585,2646,5231,2589,2650,5239,1582
2566,37,อำนาจเจริญ,3791,ท้องถิ่นเทศบาลตำบลพระเหลา,2985,2981,5966,2989,2981,5970,2311
2566,37,อำนาจเจริญ,3792,ท้องถิ่นเทศบาลตำบลอำนาจ,998,1126,2124,998,1127,2125,1048
2566,37,อำนาจเจริญ,3793,ท้องถิ่นเทศบาลตำบลหัวตะพาน,3301,3451,6752,3304,3458,6762,2285
2566,37,อำนาจเจริญ,3794,ท้องถิ่นเทศบาลตำบลเสนางคนิคม,2678,2893,5571,2685,2899,5584,2008
2566,37,อำนาจเจริญ,3795,ท้องถิ่นเทศบาลตำบลพนา,1214,1391,2605,1216,1391,2607,1149
2566,37,อำนาจเจริญ,3796,ท้องถิ่นเทศบาลตำบลปทุมราชวงศา,1648,1728,3376,1648,1729,3377,1748
2566,37,อำนาจเจริญ,3797,ท้องถิ่นเทศบาลตำบลชานุมาน,1457,1564,3021,1497,1628,3125,1497
2566,37,อำนาจเจริญ,3798,ท้องถิ่นเทศบาลตำบลน้ำปลีก,1753,1900,3653,1761,1901,3662,1264
2566,37,อำนาจเจริญ,3799,ท้องถิ่นเทศบาลเมืองอำนาจเจริญ,11604,12729,24333,11647,12756,24403,13169
2566,38,บึงกาฬ,3801,อำเภอเมืองบึงกาฬ,29253,29162,58415,29338,29252,58590,19402
2566,38,บึงกาฬ,3802,อำเภอพรเจริญ,14445,14360,28805,14458,14362,28820,8538
2566,38,บึงกาฬ,3803,อำเภอโซ่พิสัย,32565,32162,64727,32593,32184,64777,19881
2566,38,บึงกาฬ,3804,อำเภอเซกา,36842,36453,73295,36928,36495,73423,24403
2566,38,บึงกาฬ,3805,อำเภอปากคาด,14012,14010,28022,14044,14034,28078,10076
2566,38,บึงกาฬ,3806,อำเภอบึงโขงหลง,14081,13899,27980,14130,13928,28058,9391
2566,38,บึงกาฬ,3807,อำเภอศรีวิไล,14324,14141,28465,14332,14149,28481,9770
2566,38,บึงกาฬ,3808,อำเภอบุ่งคล้า,6954,6950,13904,6980,7020,14000,4404
2566,38,บึงกาฬ,3887,ท้องถิ่นเทศบาลตำบลหอคำ,3608,3630,7238,3615,3633,7248,2435
2566,38,บึงกาฬ,3888,ท้องถิ่นเทศบาลตำบลโนนสว่าง,3375,3461,6836,3379,3463,6842,2470
2566,38,บึงกาฬ,3889,ท้องถิ่นเทศบาลตำบลวิศิษฐ์,0,0,0,0,0,0,0
2566,38,บึงกาฬ,3890,ท้องถิ่นเทศบาลตำบลศรีวิไล,5405,5487,10892,5412,5489,10901,4069
2566,38,บึงกาฬ,3891,ท้องถิ่นเทศบาลตำบลบึงโขงหลง,4757,4888,9645,4784,4893,9677,3648
2566,38,บึงกาฬ,3892,ท้องถิ่นเทศบาลตำบลปากคาด,3248,3229,6477,3255,3233,6488,2785
2566,38,บึงกาฬ,3893,ท้องถิ่นเทศบาลตำบลศรีพนา,3196,3267,6463,3209,3268,6477,2789
2566,38,บึงกาฬ,3894,ท้องถิ่นเทศบาลตำบลท่าสะอาด,3310,3471,6781,3314,3479,6793,2047
2566,38,บึงกาฬ,3895,ท้องถิ่นเทศบาลตำบลโซ่พิสัย,3215,3240,6455,3225,3244,6469,2685
2566,38,บึงกาฬ,3896,ท้องถิ่นเทศบาลตำบลพรเจริญ,4961,5204,10165,4970,5214,10184,3657
2566,38,บึงกาฬ,3897,ท้องถิ่นเทศบาลตำบลดอนหญ้านาง,2482,2530,5012,2484,2531,5015,1560
2566,38,บึงกาฬ,3898,ท้องถิ่นเทศบาลเมืองบึงกาฬ,9903,10151,20054,9958,10208,20166,11667
2566,39,หนองบัวลำภู,3901,อำเภอเมืองหนองบัวลำภู,50799,50974,101773,50898,51007,101905,32828
2566,39,หนองบัวลำภู,3902,อำเภอนากลาง,33481,33128,66609,33543,33141,66684,19372
2566,39,หนองบัวลำภู,3903,อำเภอโนนสัง,26576,27018,53594,26613,27028,53641,14231
2566,39,หนองบัวลำภู,3904,อำเภอศรีบุญเรือง,45324,44797,90121,45412,44812,90224,25999
2566,39,หนองบัวลำภู,3905,อำเภอสุวรรณคูหา,26952,26779,53731,26989,26794,53783,15630
2566,39,หนองบัวลำภู,3906,อำเภอนาวัง,15072,15067,30139,15105,15076,30181,8974
2566,39,หนองบัวลำภู,3986,ท้องถิ่นเทศบาลตำบลยางหล่อ,4588,4711,9299,4592,4716,9308,2662
2566,39,หนองบัวลำภู,3987,ท้องถิ่นเทศบาลตำบลนาเหล่า,3331,3534,6865,3342,3536,6878,2486
2566,39,หนองบัวลำภู,3988,ท้องถิ่นเทศบาลตำบลสุวรรณคูหา,3762,3938,7700,3781,3941,7722,2970
2566,39,หนองบัวลำภู,3989,ท้องถิ่นเทศบาลตำบลบ้านโคก,2944,3263,6207,2951,3265,6216,1942
2566,39,หนองบัวลำภู,3990,ท้องถิ่นเทศบาลตำบลโนนสูงเปลือย,2148,2371,4519,2158,2375,4533,2693
2566,39,หนองบัวลำภู,3991,ท้องถิ่นเทศบาลตำบลจอมทอง,2492,2430,4922,2496,2432,4928,1541
2566,39,หนองบัวลำภู,3992,ท้องถิ่นเทศบาลตำบลโนนสัง,4056,4222,8278,4073,4227,8300,2983
2566,39,หนองบัวลำภู,3993,ท้องถิ่นเทศบาลตำบลกุดดู่,1363,1374,2737,1367,1374,2741,766
2566,39,หนองบัวลำภู,3994,ท้องถิ่นเทศบาลตำบลนากลาง,9656,10081,19737,9682,10086,19768,6825
2566,39,หนองบัวลำภู,3995,ท้องถิ่นเทศบาลตำบลกุดดินจี่,2717,2846,5563,2726,2846,5572,1874
2566,39,หนองบัวลำภู,3996,ท้องถิ่นเทศบาลตำบลหัวนา,1783,1773,3556,1787,1773,3560,1082
2566,39,หนองบัวลำภู,3997,ท้องถิ่นเทศบาลตำบลนามะเฟือง,2005,2151,4156,2011,2152,4163,1121
2566,39,หนองบัวลำภู,3998,ท้องถิ่นเทศบาลตำบลนาคำไฮ,2422,2491,4913,2431,2493,4924,1461
2566,39,หนองบัวลำภู,3999,ท้องถิ่นเทศบาลเมืองหนองบัวลำภู,10411,11328,21739,10479,11362,21841,12510
2566,40,ขอนแก่น,4001,อำเภอเมืองขอนแก่น,47674,50856,98530,47840,50892,98732,42118
2566,40,ขอนแก่น,4002,อำเภอบ้านฝาง,24875,25163,50038,24920,25169,50089,18023
2566,40,ขอนแก่น,4003,อำเภอพระยืน,12090,12580,24670,12112,12582,24694,8098
2566,40,ขอนแก่น,4004,อำเภอหนองเรือ,40927,42060,82987,40960,42076,83036,23917
2566,40,ขอนแก่น,4005,อำเภอชุมแพ,41105,41539,82644,41219,41556,82775,26962
2566,40,ขอนแก่น,4006,อำเภอสีชมพู,36337,36900,73237,36405,36914,73319,23155
2566,40,ขอนแก่น,4007,อำเภอน้ำพอง,35681,36476,72157,35719,36505,72224,22772
2566,40,ขอนแก่น,4008,อำเภออุบลรัตน์,15364,15790,31154,15383,15797,31180,8604
2566,40,ขอนแก่น,4009,อำเภอกระนวน,33685,34324,68009,33750,34329,68079,20956
2566,40,ขอนแก่น,4010,อำเภอบ้านไผ่,35514,36390,71904,35570,36398,71968,24265
2566,40,ขอนแก่น,4011,อำเภอเปือยน้อย,7149,7040,14189,7152,7043,14195,4058
2566,40,ขอนแก่น,4012,อำเภอพล,37069,38002,75071,37101,38019,75120,24127
2566,40,ขอนแก่น,4013,อำเภอแวงใหญ่,11825,12109,23934,11832,12119,23951,6637
2566,40,ขอนแก่น,4014,อำเภอแวงน้อย,19131,19184,38315,19144,19191,38335,11765
2566,40,ขอนแก่น,4015,อำเภอหนองสองห้อง,35311,35792,71103,35349,35809,71158,21581
2566,40,ขอนแก่น,4016,อำเภอภูเวียง,33935,34457,68392,33978,34474,68452,21185
2566,40,ขอนแก่น,4017,อำเภอมัญจาคีรี,32619,33314,65933,32654,33323,65977,22529
2566,40,ขอนแก่น,4018,อำเภอชนบท,19236,20051,39287,19257,20057,39314,12064
2566,40,ขอนแก่น,4019,อำเภอเขาสวนกวาง,10625,10696,21321,10650,10698,21348,6599
2566,40,ขอนแก่น,4020,อำเภอภูผาม่าน,9775,9738,19513,9786,9742,19528,6023
2566,40,ขอนแก่น,4021,อำเภอซำสูง,8869,9154,18023,8874,9158,18032,5436
2566,40,ขอนแก่น,4022,อำเภอโคกโพธิ์ไชย,10402,10508,20910,10410,10517,20927,6863
2566,40,ขอนแก่น,4023,อำเภอหนองนาคำ,11699,11846,23545,11715,11850,23565,7004
2566,40,ขอนแก่น,4024,อำเภอบ้านแฮด,12851,13190,26041,12861,13197,26058,8600
2566,40,ขอนแก่น,4025,อำเภอโนนศิลา,10435,10528,20963,10439,10531,20970,6717
2566,40,ขอนแก่น,4029,อำเภอเวียงเก่า,9783,9962,19745,9789,9963,19752,5918
2566,40,ขอนแก่น,4054,ท้องถิ่นเทศบาลเมืองศิลา,26891,27678,54569,27021,27710,54731,31256
2566,40,ขอนแก่น,4055,ท้องถิ่นเทศบาลตำบลโคกสูง,4427,4350,8777,4451,4355,8806,2566
2566,40,ขอนแก่น,4056,ท้องถิ่นเทศบาลตำบลสะอาด,4911,4992,9903,4916,4995,9911,2775
2566,40,ขอนแก่น,4057,ท้องถิ่นเทศบาลเมืองบ้านทุ่ม,9228,9980,19208,9262,9992,19254,9396
2566,40,ขอนแก่น,4058,ท้องถิ่นเทศบาลตำบลโนนสมบูรณ์,2932,2947,5879,2937,2948,5885,1835
2566,40,ขอนแก่น,4060,ท้องถิ่นเทศบาลตำบลม่วงหวาน,4937,5175,10112,4946,5180,10126,3637
2566,40,ขอนแก่น,4061,ท้องถิ่นเทศบาลตำบลหนองตูม,3648,3972,7620,3656,3974,7630,2310
2566,40,ขอนแก่น,4062,ท้องถิ่นเทศบาลตำบลเมืองเก่า,14921,17381,32302,15121,17401,32522,18754
2566,40,ขอนแก่น,4063,ท้องถิ่นเทศบาลตำบลโนนท่อน,4806,4963,9769,4808,4967,9775,3306
2566,40,ขอนแก่น,4064,ท้องถิ่นเทศบาลตำบลบ้านค้อ,8480,8852,17332,8496,8856,17352,7405
2566,40,ขอนแก่น,4065,ท้องถิ่นเทศบาลตำบลกุดน้ำใส,4159,4324,8483,4170,4333,8503,2800
2566,40,ขอนแก่น,4067,ท้องถิ่นเทศบาลตำบลสาวะถี,8864,9089,17953,8889,9100,17989,6026
2566,40,ขอนแก่น,4068,ท้องถิ่นเทศบาลเมืองบ้านเป็ด,21958,25714,47672,22214,25754,47968,29797
2566,40,ขอนแก่น,4069,ท้องถิ่นเทศบาลตำบลโนนศิลา,2739,2785,5524,2740,2787,5527,1923
2566,40,ขอนแก่น,4070,ท้องถิ่นเทศบาลตำบลบ้านแฮด,3279,3317,6596,3282,3319,6601,2329
2566,40,ขอนแก่น,4071,ท้องถิ่นเทศบาลตำบลบ้านโคก,1934,2110,4044,1937,2111,4048,1555
2566,40,ขอนแก่น,4072,ท้องถิ่นเทศบาลตำบลซำสูง,2532,2659,5191,2535,2660,5195,2005
2566,40,ขอนแก่น,4073,ท้องถิ่นเทศบาลตำบลภูผาม่าน,1651,1760,3411,1653,1762,3415,1332
2566,40,ขอนแก่น,4074,ท้องถิ่นเทศบาลตำบลเขาสวนกวาง,5243,5381,10624,5262,5390,10652,3896
2566,40,ขอนแก่น,4075,ท้องถิ่นเทศบาลตำบลชนบท,3605,4069,7674,3610,4071,7681,3392
2566,40,ขอนแก่น,4076,ท้องถิ่นเทศบาลตำบลมัญจาคีรี,1623,1787,3410,1627,1789,3416,1987
2566,40,ขอนแก่น,4077,ท้องถิ่นเทศบาลตำบลภูเวียง,1305,1476,2781,1308,1477,2785,1774
2566,40,ขอนแก่น,4078,ท้องถิ่นเทศบาลตำบลหนองสองห้อง,2747,2905,5652,2756,2909,5665,2833
2566,40,ขอนแก่น,4079,ท้องถิ่นเทศบาลตำบลแวงน้อย,1429,1582,3011,1429,1583,3012,1358
2566,40,ขอนแก่น,4080,ท้องถิ่นเทศบาลตำบลแวงใหญ่,2436,2646,5082,2443,2647,5090,1853
2566,40,ขอนแก่น,4081,ท้องถิ่นเทศบาลตำบลเปือยน้อย,2823,2981,5804,2831,2982,5813,2051
2566,40,ขอนแก่น,4082,ท้องถิ่นเทศบาลเมืองกระนวน,4582,5083,9665,4616,5091,9707,4629
2566,40,ขอนแก่น,4083,ท้องถิ่นเทศบาลตำบลเขื่อนอุบลรัตน์,1902,2018,3920,1912,2019,3931,2131
2566,40,ขอนแก่น,4084,ท้องถิ่นเทศบาลตำบลวังชัย,2991,3262,6253,2998,3264,6262,3004
2566,40,ขอนแก่น,4085,ท้องถิ่นเทศบาลตำบลน้ำพอง,2266,2460,4726,2273,2463,4736,2475
2566,40,ขอนแก่น,4086,ท้องถิ่นเทศบาลตำบลสีชมพู,1602,1668,3270,1614,1669,3283,1594
2566,40,ขอนแก่น,4087,ท้องถิ่นเทศบาลตำบลโนนหัน,2138,2376,4514,2145,2378,4523,1567
2566,40,ขอนแก่น,4088,ท้องถิ่นเทศบาลตำบลโคกสูงสัมพันธ์,2039,2278,4317,2054,2279,4333,1355
2566,40,ขอนแก่น,4089,ท้องถิ่นเทศบาลตำบลหนองเรือ,2098,2082,4180,2107,2086,4193,2257
2566,40,ขอนแก่น,4090,ท้องถิ่นเทศบาลตำบลหนองแก,683,677,1360,684,678,1362,715
2566,40,ขอนแก่น,4091,ท้องถิ่นเทศบาลตำบลดอนโมง,1631,1711,3342,1638,1714,3352,1888
2566,40,ขอนแก่น,4092,ท้องถิ่นเทศบาลตำบลพระยืน,1552,1733,3285,1552,1736,3288,1553
2566,40,ขอนแก่น,4093,ท้องถิ่นเทศบาลตำบลบ้านโต้น,3052,3329,6381,3065,3329,6394,2117
2566,40,ขอนแก่น,4094,ท้องถิ่นเทศบาลตำบลบ้านฝาง,2182,2333,4515,2191,2341,4532,1937
2566,40,ขอนแก่น,4095,ท้องถิ่นเทศบาลตำบลท่าพระ,4067,4494,8561,4098,4498,8596,4223
2566,40,ขอนแก่น,4096,ท้องถิ่นเทศบาลเมืองชุมแพ,14648,15883,30531,14822,15929,30751,16275
2566,40,ขอนแก่น,4097,ท้องถิ่นเทศบาลเมืองบ้านไผ่,12506,13810,26316,12648,13886,26534,13106
2566,40,ขอนแก่น,4098,ท้องถิ่นเทศบาลเมืองเมืองพล,4773,5275,10048,4785,5283,10068,5483
2566,40,ขอนแก่น,4099,ท้องถิ่นเทศบาลนครขอนแก่น,47666,52705,100371,48290,53108,101398,68441
2566,41,อุดรธานี,4101,อำเภอเมืองอุดรธานี,90421,95509,185930,90952,95609,186561,76406
2566,41,อุดรธานี,4102,อำเภอกุดจับ,21700,21716,43416,21796,21743,43539,13705
2566,41,อุดรธานี,4103,อำเภอหนองวัวซอ,22333,22421,44754,22401,22436,44837,12239
2566,41,อุดรธานี,4104,อำเภอกุมภวาปี,36315,37122,73437,36400,37148,73548,22483
2566,41,อุดรธานี,4105,อำเภอโนนสะอาด,22331,22545,44876,22371,22564,44935,12407
2566,41,อุดรธานี,4106,อำเภอหนองหาน,44061,44342,88403,44162,44379,88541,28633
2566,41,อุดรธานี,4107,อำเภอทุ่งฝน,12524,12413,24937,12565,12422,24987,7520
2566,41,อุดรธานี,4108,อำเภอไชยวาน,12023,11732,23755,12041,11736,23777,6467
2566,41,อุดรธานี,4109,อำเภอศรีธาตุ,11737,11827,23564,11745,11831,23576,6854
2566,41,อุดรธานี,4110,อำเภอวังสามหมอ,15659,15425,31084,15670,15437,31107,9074
2566,41,อุดรธานี,4111,อำเภอบ้านดุง,55450,55812,111262,55588,55855,111443,33711
2566,41,อุดรธานี,4117,อำเภอบ้านผือ,50740,50824,101564,50800,50853,101653,32212
2566,41,อุดรธานี,4118,อำเภอน้ำโสม,20745,20369,41114,20792,20397,41189,13868
2566,41,อุดรธานี,4119,อำเภอเพ็ญ,48145,48254,96399,48235,48283,96518,30620
2566,41,อุดรธานี,4120,อำเภอสร้างคอม,10946,10940,21886,10965,10950,21915,6881
2566,41,อุดรธานี,4121,อำเภอหนองแสง,11511,11513,23024,11556,11520,23076,7094
2566,41,อุดรธานี,4122,อำเภอนายูง,14444,14120,28564,14459,14127,28586,10095
2566,41,อุดรธานี,4123,อำเภอพิบูลย์รักษ์,12189,12448,24637,12214,12457,24671,8858
2566,41,อุดรธานี,4124,อำเภอกู่แก้ว,11043,10951,21994,11062,10965,22027,7163
2566,41,อุดรธานี,4125,อำเภอประจักษ์ศิลปาคม,12624,12676,25300,12666,12688,25354,7603
2566,41,อุดรธานี,4158,ท้องถิ่นเทศบาลตำบลหนองหว้า,4080,4124,8204,4090,4126,8216,2087
2566,41,อุดรธานี,4159,ท้องถิ่นเทศบาลตำบลหัวนาคำ,5691,5554,11245,5692,5557,11249,3279
2566,41,อุดรธานี,4160,ท้องถิ่นเทศบาลตำบลผาสุก,7932,7731,15663,7944,7737,15681,4893
2566,41,อุดรธานี,4161,ท้องถิ่นเทศบาลตำบลโพนสูง,3764,3719,7483,3765,3719,7484,1975
2566,41,อุดรธานี,4162,ท้องถิ่นเทศบาลตำบลจำปี,4076,4025,8101,4079,4027,8106,2222
2566,41,อุดรธานี,4163,ท้องถิ่นเทศบาลตำบลสร้างคอม,3541,3700,7241,3551,3703,7254,2778
2566,41,อุดรธานี,4164,ท้องถิ่นเทศบาลตำบลบ้านธาตุ,8203,8564,16767,8238,8584,16822,5344
2566,41,อุดรธานี,4165,ท้องถิ่นเทศบาลตำบลเวียงคำ,5179,5280,10459,5188,5282,10470,3320
2566,41,อุดรธานี,4166,ท้องถิ่นเทศบาลตำบลลำพันชาด,2795,2782,5577,2798,2782,5580,2132
2566,41,อุดรธานี,4167,ท้องถิ่นเทศบาลตำบลหนองไผ่,4619,4767,9386,4635,4773,9408,2844
2566,41,อุดรธานี,4168,ท้องถิ่นเทศบาลตำบลหนองไผ่,4027,4755,8782,4048,4759,8807,2854
2566,41,อุดรธานี,4169,ท้องถิ่นเทศบาลตำบลปะโค,5491,5587,11078,5504,5589,11093,3530
2566,41,อุดรธานี,4170,ท้องถิ่นเทศบาลตำบลแสงสว่าง,1968,1980,3948,1980,1980,3960,998
2566,41,อุดรธานี,4171,ท้องถิ่นเทศบาลตำบลเพ็ญ,1311,1356,2667,1314,1357,2671,1642
2566,41,อุดรธานี,4172,ท้องถิ่นเทศบาลตำบลน้ำโสม,4219,4389,8608,4222,4390,8612,2638
2566,41,อุดรธานี,4173,ท้องถิ่นเทศบาลตำบลนางัว,4368,4485,8853,4389,4493,8882,3525
2566,41,อุดรธานี,4174,ท้องถิ่นเทศบาลตำบลบ้านผือ,3619,3886,7505,3631,3903,7534,4256
2566,41,อุดรธานี,4175,ท้องถิ่นเทศบาลเมืองบ้านดุง,7110,7734,14844,7178,7757,14935,6578
2566,41,อุดรธานี,4176,ท้องถิ่นเทศบาลตำบลวังสามหมอ,2870,3048,5918,2873,3050,5923,2913
2566,41,อุดรธานี,4177,ท้องถิ่นเทศบาลตำบลศรีธาตุ,2643,2731,5374,2646,2731,5377,1958
2566,41,อุดรธานี,4178,ท้องถิ่นเทศบาลตำบลไชยวาน,3971,4180,8151,3979,4182,8161,2496
2566,41,อุดรธานี,4179,ท้องถิ่นเทศบาลตำบลทุ่งฝน,3360,3671,7031,3375,3675,7050,2285
2566,41,อุดรธานี,4180,ท้องถิ่นเทศบาลตำบลหนองหาน,1902,2136,4038,1914,2142,4056,1917
2566,41,อุดรธานี,4181,ท้องถิ่นเทศบาลตำบลหนองเม็ก,4024,4044,8068,4041,4047,8088,2336
2566,41,อุดรธานี,4182,ท้องถิ่นเทศบาลตำบลบ้านเชียง,2789,2834,5623,2811,2838,5649,2034
2566,41,อุดรธานี,4183,ท้องถิ่นเทศบาลตำบลโนนสะอาด,2105,2225,4330,2112,2226,4338,1782
2566,41,อุดรธานี,4184,ท้องถิ่นเทศบาลตำบลห้วยเกิ้ง,2485,2610,5095,2496,2610,5106,1733
2566,41,อุดรธานี,4185,ท้องถิ่นเทศบาลตำบลพันดอน,2537,2798,5335,2551,2813,5364,2731
2566,41,อุดรธานี,4186,ท้องถิ่นเทศบาลตำบลกุมภวาปี,3707,4064,7771,3743,4081,7824,4576
2566,41,อุดรธานี,4187,ท้องถิ่นเทศบาลตำบลภูผาแดง,3745,3974,7719,3772,3979,7751,2391
2566,41,อุดรธานี,4188,ท้องถิ่นเทศบาลตำบลหนองวัวซอ,4576,4818,9394,4607,4822,9429,3005
2566,41,อุดรธานี,4189,ท้องถิ่นเทศบาลตำบลสร้างก่อ,1931,1937,3868,1931,1937,3868,1111
2566,41,อุดรธานี,4190,ท้องถิ่นเทศบาลตำบลตาลเลียน,1819,1841,3660,1822,1844,3666,906
2566,41,อุดรธานี,4191,ท้องถิ่นเทศบาลตำบลเชียงเพ็ง,1952,2019,3971,1953,2019,3972,1214
2566,41,อุดรธานี,4192,ท้องถิ่นเทศบาลตำบลกุดจับ,4796,5153,9949,4826,5157,9983,4059
2566,41,อุดรธานี,4193,ท้องถิ่นเทศบาลตำบลหนองบัว,15277,17495,32772,15704,17554,33258,16765
2566,41,อุดรธานี,4194,ท้องถิ่นเทศบาลเมืองหนองสำโรง,14282,15626,29908,14482,15680,30162,16001
2566,41,อุดรธานี,4195,ท้องถิ่นเทศบาลตำบลบ้านจั่น,3190,3836,7026,3243,3845,7088,3648
2566,41,อุดรธานี,4196,ท้องถิ่นเทศบาลเมืองโนนสูง-น้ำคำ,4426,3887,8313,4453,3894,8347,3643
2566,41,อุดรธานี,4197,ท้องถิ่นเทศบาลตำบลนิคมสงเคราะห์,1759,1909,3668,1775,1911,3686,1362
2566,41,อุดรธานี,4198,ท้องถิ่นเทศบาลตำบลนาข่า,3069,3306,6375,3077,3309,6386,2711
2566,41,อุดรธานี,4199,ท้องถิ่นเทศบาลนครอุดรธานี,52288,58598,110886,54810,60582,115392,62693
2566,42,เลย,4201,อำเภอเมืองเลย,29693,29266,58959,29791,29364,59155,24811
2566,42,เลย,4202,อำเภอนาด้วง,4903,4825,9728,4938,4861,9799,3797
2566,42,เลย,4203,อำเภอเชียงคาน,18746,18571,37317,19004,19126,38130,14726
2566,42,เลย,4204,อำเภอปากชม,16919,16283,33202,17110,16556,33666,11684
2566,42,เลย,4205,อำเภอด่านซ้าย,24318,23734,48052,24384,23814,48198,16761
2566,42,เลย,4206,อำเภอนาแห้ว,4816,4799,9615,4843,4833,9676,3224
2566,42,เลย,4207,อำเภอภูเรือ,9967,9575,19542,10050,9702,19752,7617
2566,42,เลย,4208,อำเภอท่าลี่,12504,12222,24726,12916,12948,25864,10335
2566,42,เลย,4209,อำเภอวังสะพุง,49393,50060,99453,49455,50110,99565,35501
2566,42,เลย,4210,อำเภอภูกระดึง,13710,13555,27265,13725,13566,27291,9128
2566,42,เลย,4211,อำเภอภูหลวง,12571,12339,24910,12583,12350,24933,8069
2566,42,เลย,4212,อำเภอผาขาว,15371,15404,30775,15386,15414,30800,8698
2566,42,เลย,4213,อำเภอเอราวัณ,16881,16969,33850,16914,16989,33903,11825
2566,42,เลย,4214,อำเภอหนองหิน,10355,10181,20536,10377,10205,20582,6328
2566,42,เลย,4279,ท้องถิ่นเทศบาลตำบลโนนปอแดง,5506,5522,11028,5521,5525,11046,3566
2566,42,เลย,4280,ท้องถิ่นเทศบาลตำบลนาดอกคำ,4959,4832,9791,4985,4867,9852,3054
2566,42,เลย,4281,ท้องถิ่นเทศบาลตำบลธาตุ,4731,4816,9547,4755,4867,9622,3515
2566,42,เลย,4282,ท้องถิ่นเทศบาลตำบลนาดินดำ,5355,5269,10624,5366,5292,10658,3807
2566,42,เลย,4283,ท้องถิ่นเทศบาลตำบลนาโป่ง,5118,5190,10308,5123,5198,10321,3627
2566,42,เลย,4284,ท้องถิ่นเทศบาลตำบลนาอาน,6418,6691,13109,6440,6704,13144,6378
2566,42,เลย,4285,ท้องถิ่นเทศบาลตำบลเขาแก้ว,3860,3837,7697,3867,3850,7717,2231
2566,42,เลย,4286,ท้องถิ่นเทศบาลตำบลหนองหิน,2106,2237,4343,2112,2238,4350,2123
2566,42,เลย,4287,ท้องถิ่นเทศบาลตำบลภูกระดึง,3451,3553,7004,3457,3553,7010,2805
2566,42,เลย,4288,ท้องถิ่นเทศบาลเมืองวังสะพุง,5020,5486,10506,5030,5495,10525,4668
2566,42,เลย,4289,ท้องถิ่นเทศบาลตำบลท่าลี่,850,936,1786,853,945,1798,830
2566,42,เลย,4290,ท้องถิ่นเทศบาลตำบลภูเรือ,1351,1380,2731,1367,1390,2757,1613
2566,42,เลย,4291,ท้องถิ่นเทศบาลตำบลนาแห้ว,1020,965,1985,1027,988,2015,933
2566,42,เลย,4292,ท้องถิ่นเทศบาลตำบลด่านซ้าย,1609,1683,3292,1611,1684,3295,2012
2566,42,เลย,4293,ท้องถิ่นเทศบาลตำบลปากชม,1623,1698,3321,1646,1745,3391,1613
2566,42,เลย,4294,ท้องถิ่นเทศบาลตำบลเชียงกลม,2549,2578,5127,2562,2603,5165,1676
2566,42,เลย,4295,ท้องถิ่นเทศบาลตำบลเชียงคาน,2363,2550,4913,2387,2580,4967,2883
2566,42,เลย,4296,ท้องถิ่นเทศบาลตำบลนาด้วง,3221,3262,6483,3234,3272,6506,2433
2566,42,เลย,4297,ท้องถิ่นเทศบาลตำบลน้ำสวย,1769,1799,3568,1771,1803,3574,1258
2566,42,เลย,4298,ท้องถิ่นเทศบาลตำบลนาอ้อ,2941,3074,6015,2948,3078,6026,2385
2566,42,เลย,4299,ท้องถิ่นเทศบาลเมืองเลย,9948,10021,19969,10000,10089,20089,11575
2566,43,หนองคาย,4301,อำเภอเมืองหนองคาย,36940,37551,74491,37173,37823,74996,25660
2566,43,หนองคาย,4302,อำเภอท่าบ่อ,29929,30849,60778,30046,31013,61059,19402
2566,43,หนองคาย,4305,อำเภอโพนพิสัย,47150,47613,94763,47332,47876,95208,32967
2566,43,หนองคาย,4307,อำเภอศรีเชียงใหม่,11368,11681,23049,11488,11827,23315,7677
2566,43,หนองคาย,4308,อำเภอสังคม,11245,10934,22179,11275,10980,22255,7538
2566,43,หนองคาย,4314,อำเภอสระใคร,13335,13209,26544,13357,13238,26595,8864
2566,43,หนองคาย,4315,อำเภอเฝ้าไร่,19854,19873,39727,19886,19884,39770,11741
2566,43,หนองคาย,4316,อำเภอรัตนวาปี,18872,18841,37713,18885,18861,37746,13450
2566,43,หนองคาย,4317,อำเภอโพธิ์ตาก,7544,7543,15087,7567,7597,15164,5311
2566,43,หนองคาย,4378,ท้องถิ่นเทศบาลตำบลเฝ้าไร่,5434,5502,10936,5442,5504,10946,4158
2566,43,หนองคาย,4381,ท้องถิ่นเทศบาลตำบลโพธิ์ชัย,3891,4145,8036,3914,4166,8080,4021
2566,43,หนองคาย,4382,ท้องถิ่นเทศบาลตำบลหาดคำ,4555,4648,9203,4673,4852,9525,3119
2566,43,หนองคาย,4388,ท้องถิ่นเทศบาลตำบลสังคม,1588,1657,3245,1593,1662,3255,1506
2566,43,หนองคาย,4389,ท้องถิ่นเทศบาลตำบลศรีเชียงใหม่,2997,3140,6137,3037,3182,6219,2923
2566,43,หนองคาย,4391,ท้องถิ่นเทศบาลตำบลโพนพิสัย,1265,1250,2515,1272,1263,2535,1245
2566,43,หนองคาย,4395,ท้องถิ่นเทศบาลตำบลโพนสา,1710,1928,3638,1719,1947,3666,1177
2566,43,หนองคาย,4396,ท้องถิ่นเทศบาลเมืองท่าบ่อ,8174,8610,16784,8264,8704,16968,7568
2566,43,หนองคาย,4397,ท้องถิ่นเทศบาลตำบลหนองสองห้อง,2542,2592,5134,2581,2603,5184,2152
2566,43,หนองคาย,4398,ท้องถิ่นเทศบาลตำบลเวียงคุก,2751,3018,5769,2763,3030,5793,1945
2566,43,หนองคาย,4399,ท้องถิ่นเทศบาลเมืองหนองคาย,21039,22306,43345,22291,23451,45742,25157
2566,44,มหาสารคาม,4401,อำเภอเมืองมหาสารคาม,49855,52259,102114,49945,52279,102224,37810
2566,44,มหาสารคาม,4402,อำเภอแกดำ,12178,12130,24308,12184,12132,24316,6726
2566,44,มหาสารคาม,4403,อำเภอโกสุมพิสัย,53440,55183,108623,53505,55210,108715,32565
2566,44,มหาสารคาม,4404,อำเภอกันทรวิชัย,27007,28134,55141,27034,28143,55177,16984
2566,44,มหาสารคาม,4405,อำเภอเชียงยืน,27183,28123,55306,27221,28134,55355,18674
2566,44,มหาสารคาม,4406,อำเภอบรบือ,50160,50517,100677,50198,50540,100738,35201
2566,44,มหาสารคาม,4407,อำเภอนาเชือก,28302,28570,56872,28323,28583,56906,17932
2566,44,มหาสารคาม,4408,อำเภอพยัคฆภูมิพิสัย,39234,39856,79090,39248,39870,79118,22808
2566,44,มหาสารคาม,4409,อำเภอวาปีปทุม,52966,53715,106681,53003,53736,106739,31333
2566,44,มหาสารคาม,4410,อำเภอนาดูน,16169,16306,32475,16182,16322,32504,8921
2566,44,มหาสารคาม,4411,อำเภอยางสีสุราช,17222,17431,34653,17229,17441,34670,10124
2566,44,มหาสารคาม,4412,อำเภอกุดรัง,18494,18341,36835,18513,18349,36862,10971
2566,44,มหาสารคาม,4413,อำเภอชื่นชม,11972,12431,24403,11981,12441,24422,7190
2566,44,มหาสารคาม,4487,ท้องถิ่นเทศบาลตำบลขามเรียง,5517,7154,12671,5538,7159,12697,5912
2566,44,มหาสารคาม,4488,ท้องถิ่นเทศบาลตำบลท่าขอนยาง,4276,4600,8876,4287,4605,8892,6898
2566,44,มหาสารคาม,4489,ท้องถิ่นเทศบาลตำบลนาดูน,2374,2342,4716,2376,2343,4719,1897
2566,44,มหาสารคาม,4490,ท้องถิ่นเทศบาลตำบลวาปีปทุม,2154,2401,4555,2160,2405,4565,2443
2566,44,มหาสารคาม,4491,ท้องถิ่นเทศบาลตำบลพยัคฆภูมิพิสัย,3746,4183,7929,3759,4190,7949,4377
2566,44,มหาสารคาม,4492,ท้องถิ่นเทศบาลตำบลนาเชือก,1780,1921,3701,1783,1921,3704,2190
2566,44,มหาสารคาม,4493,ท้องถิ่นเทศบาลตำบลบรบือ,2449,2935,5384,2456,2937,5393,2387
2566,44,มหาสารคาม,4494,ท้องถิ่นเทศบาลตำบลเชียงยืน,2195,2337,4532,2199,2340,4539,2452
2566,44,มหาสารคาม,4495,ท้องถิ่นเทศบาลตำบลกันทรวิชัย,1538,1750,3288,1545,1750,3295,1529
2566,44,มหาสารคาม,4496,ท้องถิ่นเทศบาลตำบลโกสุมพิสัย,4220,4669,8889,4238,4672,8910,4429
2566,44,มหาสารคาม,4497,ท้องถิ่นเทศบาลตำบลแกดำ,2629,2641,5270,2631,2641,5272,1708
2566,44,มหาสารคาม,4498,ท้องถิ่นเทศบาลตำบลแวงน่าง,2744,2910,5654,2752,2910,5662,2309
2566,44,มหาสารคาม,4499,ท้องถิ่นเทศบาลเมืองมหาสารคาม,19724,24708,44432,19805,24767,44572,21964
2566,45,ร้อยเอ็ด,4501,อำเภอเมืองร้อยเอ็ด,54228,56586,110814,54406,56630,111036,43444
2566,45,ร้อยเอ็ด,4502,อำเภอเกษตรวิสัย,36475,36557,73032,36497,36568,73065,21742
2566,45,ร้อยเอ็ด,4503,อำเภอปทุมรัตต์,23251,23821,47072,23264,23826,47090,13339
2566,45,ร้อยเอ็ด,4504,อำเภอจตุรพักตรพิมาน,25009,25494,50503,25033,25508,50541,14265
2566,45,ร้อยเอ็ด,4505,อำเภอธวัชบุรี,18592,18610,37202,18611,18619,37230,11745
2566,45,ร้อยเอ็ด,4506,อำเภอพนมไพร,29593,29798,59391,29616,29814,59430,18428
2566,45,ร้อยเอ็ด,4507,อำเภอโพนทอง,47859,48377,96236,47917,48400,96317,29840
2566,45,ร้อยเอ็ด,4508,อำเภอโพธิ์ชัย,13399,13611,27010,13405,13615,27020,7924
2566,45,ร้อยเอ็ด,4509,อำเภอหนองพอก,29930,29855,59785,29961,29870,59831,17142
2566,45,ร้อยเอ็ด,4510,อำเภอเสลภูมิ,44277,44957,89234,44308,44981,89289,25800
2566,45,ร้อยเอ็ด,4511,อำเภอสุวรรณภูมิ,51666,52596,104262,51712,52619,104331,30889
2566,45,ร้อยเอ็ด,4512,อำเภอเมืองสรวง,6755,6764,13519,6763,6771,13534,3896
2566,45,ร้อยเอ็ด,4513,อำเภอโพนทราย,11037,11097,22134,11045,11101,22146,5327
2566,45,ร้อยเอ็ด,4514,อำเภออาจสามารถ,34389,34582,68971,34422,34599,69021,19598
2566,45,ร้อยเอ็ด,4515,อำเภอเมยวดี,11326,11601,22927,11331,11610,22941,7160
2566,45,ร้อยเอ็ด,4516,อำเภอศรีสมเด็จ,18242,17316,35558,18264,17329,35593,11459
2566,45,ร้อยเอ็ด,4517,อำเภอจังหาร,18745,19490,38235,18767,19500,38267,12552
2566,45,ร้อยเอ็ด,4518,อำเภอเชียงขวัญ,13236,13761,26997,13257,13770,27027,8499
2566,45,ร้อยเอ็ด,4519,อำเภอหนองฮี,11951,12078,24029,11959,12087,24046,6716
2566,45,ร้อยเอ็ด,4520,อำเภอทุ่งเขาหลวง,11312,11582,22894,11329,11586,22915,6672
2566,45,ร้อยเอ็ด,4565,ท้องถิ่นเทศบาลตำบลนิเวศน์,3357,3427,6784,3368,3431,6799,3206
2566,45,ร้อยเอ็ด,4566,ท้องถิ่นเทศบาลตำบลมะอึ,2583,2745,5328,2592,2746,5338,2198
2566,45,ร้อยเอ็ด,4569,ท้องถิ่นเทศบาลตำบลโพธิ์ชัย,3293,3316,6609,3294,3318,6612,1793
2566,45,ร้อยเอ็ด,4570,ท้องถิ่นเทศบาลตำบลดินดำ,3307,3433,6740,3310,3435,6745,2049
2566,45,ร้อยเอ็ด,4571,ท้องถิ่นเทศบาลตำบลเมืองไพร,3142,3049,6191,3146,3049,6195,1646
2566,45,ร้อยเอ็ด,4572,ท้องถิ่นเทศบาลตำบลขวาว,4277,4477,8754,4280,4479,8759,2249
2566,45,ร้อยเอ็ด,4573,ท้องถิ่นเทศบาลตำบลดงแดง,4210,4433,8643,4211,4438,8649,2492
2566,45,ร้อยเอ็ด,4574,ท้องถิ่นเทศบาลตำบลโคกล่าม,3591,3689,7280,3594,3694,7288,2144
2566,45,ร้อยเอ็ด,4575,ท้องถิ่นเทศบาลตำบลหัวช้าง,3963,4202,8165,3971,4206,8177,2803
2566,45,ร้อยเอ็ด,4576,ท้องถิ่นเทศบาลตำบลอุ่มเม้า,3556,3680,7236,3563,3684,7247,2101
2566,45,ร้อยเอ็ด,4577,ท้องถิ่นเทศบาลตำบลปอภาร,3439,3775,7214,3448,3776,7224,2522
2566,45,ร้อยเอ็ด,4578,ท้องถิ่นเทศบาลตำบลเมืองบัว,4073,4260,8333,4084,4264,8348,2885
2566,45,ร้อยเอ็ด,4579,ท้องถิ่นเทศบาลตำบลคำพอุง,4632,4560,9192,4646,4561,9207,2735
2566,45,ร้อยเอ็ด,4580,ท้องถิ่นเทศบาลตำบลอัคคะคำ,4090,4096,8186,4092,4097,8189,2186
2566,45,ร้อยเอ็ด,4581,ท้องถิ่นเทศบาลตำบลโนนตาล,2638,2641,5279,2639,2642,5281,1525
2566,45,ร้อยเอ็ด,4583,ท้องถิ่นเทศบาลตำบลอาจสามารถ,1908,2035,3943,1910,2038,3948,1842
2566,45,ร้อยเอ็ด,4584,ท้องถิ่นเทศบาลตำบลโพนทราย,2764,2826,5590,2765,2827,5592,2113
2566,45,ร้อยเอ็ด,4585,ท้องถิ่นเทศบาลตำบลเมืองสรวง,4643,4800,9443,4658,4801,9459,2982
2566,45,ร้อยเอ็ด,4586,ท้องถิ่นเทศบาลตำบลสุวรรณภูมิ,4161,4653,8814,4166,4658,8824,4319
2566,45,ร้อยเอ็ด,4587,ท้องถิ่นเทศบาลตำบลเสลภูมิ,6187,6654,12841,6203,6663,12866,5219
2566,45,ร้อยเอ็ด,4588,ท้องถิ่นเทศบาลตำบลหนองพอก,3069,3251,6320,3080,3252,6332,2774
2566,45,ร้อยเอ็ด,4589,ท้องถิ่นเทศบาลตำบลเชียงใหม่,4002,4163,8165,4005,4164,8169,2569
2566,45,ร้อยเอ็ด,4590,ท้องถิ่นเทศบาลตำบลชัยวารี,2557,2682,5239,2561,2682,5243,1725
2566,45,ร้อยเอ็ด,4591,ท้องถิ่นเทศบาลตำบลโพนทอง,5456,5730,11186,5477,5735,11212,5301
2566,45,ร้อยเอ็ด,4592,ท้องถิ่นเทศบาลตำบลพนมไพร,1951,2082,4033,1956,2085,4041,1833
2566,45,ร้อยเอ็ด,4593,ท้องถิ่นเทศบาลตำบลบ้านนิเวศน์,1175,1305,2480,1177,1305,2482,1203
2566,45,ร้อยเอ็ด,4594,ท้องถิ่นเทศบาลตำบลธงธานี,3661,3934,7595,3680,3936,7616,2609
2566,45,ร้อยเอ็ด,4595,ท้องถิ่นเทศบาลตำบลจตุรพักตรพิมาน,1749,1991,3740,1756,1996,3752,1640
2566,45,ร้อยเอ็ด,4596,ท้องถิ่นเทศบาลตำบลปทุมรัตต์,3055,3257,6312,3061,3259,6320,2192
2566,45,ร้อยเอ็ด,4597,ท้องถิ่นเทศบาลตำบลเกษตรวิสัย,5151,5510,10661,5154,5517,10671,4980
2566,45,ร้อยเอ็ด,4598,ท้องถิ่นเทศบาลตำบลกู่กาสิงห์,2217,2317,4534,2218,2318,4536,1656
2566,45,ร้อยเอ็ด,4599,ท้องถิ่นเทศบาลเมืองร้อยเอ็ด,15275,17602,32877,15388,17657,33045,16898
2566,46,กาฬสินธุ์,4601,อำเภอเมืองกาฬสินธุ์,39562,41054,80616,39666,41083,80749,27152
2566,46,กาฬสินธุ์,4602,อำเภอนามน,14512,14773,29285,14530,14776,29306,9776
2566,46,กาฬสินธุ์,4603,อำเภอกมลาไสย,22033,23024,45057,22053,23030,45083,12874
2566,46,กาฬสินธุ์,4604,อำเภอร่องคำ,5090,5254,10344,5095,5254,10349,3399
2566,46,กาฬสินธุ์,4605,อำเภอกุฉินารายณ์,30805,30757,61562,30842,30783,61625,22079
2566,46,กาฬสินธุ์,4606,อำเภอเขาวง,10338,10471,20809,10348,10478,20826,9025
2566,46,กาฬสินธุ์,4607,อำเภอยางตลาด,39618,41311,80929,39665,41326,80991,25016
2566,46,กาฬสินธุ์,4608,อำเภอห้วยเม็ก,20014,19898,39912,20041,19904,39945,12702
2566,46,กาฬสินธุ์,4609,อำเภอสหัสขันธ์,18600,18624,37224,18632,18635,37267,11677
2566,46,กาฬสินธุ์,4610,อำเภอคำม่วง,13383,13375,26758,13390,13376,26766,7663
2566,46,กาฬสินธุ์,4611,อำเภอท่าคันโท,14272,14338,28610,14292,14343,28635,8407
2566,46,กาฬสินธุ์,4612,อำเภอหนองกุงศรี,25456,25593,51049,25482,25605,51087,15912
2566,46,กาฬสินธุ์,4613,อำเภอสมเด็จ,27097,27698,54795,27152,27713,54865,18830
2566,46,กาฬสินธุ์,4614,อำเภอห้วยผึ้ง,6910,7092,14002,6924,7094,14018,4132
2566,46,กาฬสินธุ์,4615,อำเภอสามชัย,12816,12434,25250,12823,12443,25266,7981
2566,46,กาฬสินธุ์,4616,อำเภอนาคู,12717,12716,25433,12721,12720,25441,8563
2566,46,กาฬสินธุ์,4617,อำเภอดอนจาน,12871,13100,25971,12888,13105,25993,8432
2566,46,กาฬสินธุ์,4618,อำเภอฆ้องชัย,13053,13343,26396,13061,13349,26410,7868
2566,46,กาฬสินธุ์,4651,สาขาตำบลคำใหญ่ อำเภอห้วยเม็ก,0,0,0,0,0,0,0
2566,46,กาฬสินธุ์,4665,ท้องถิ่นเทศบาลตำบลจุมจัง,4758,4786,9544,4759,4786,9545,2590
2566,46,กาฬสินธุ์,4666,ท้องถิ่นเทศบาลตำบลนาทัน,7179,7012,14191,7179,7013,14192,3810
2566,46,กาฬสินธุ์,4667,ท้องถิ่นเทศบาลตำบลอิตื้อ,4204,4365,8569,4206,4369,8575,2580
2566,46,กาฬสินธุ์,4668,ท้องถิ่นเทศบาลตำบลภูสิงห์,0,0,0,0,0,0,0
2566,46,กาฬสินธุ์,4669,ท้องถิ่นเทศบาลตำบลหัวนาคำ,6052,6375,12427,6056,6378,12434,3862
2566,46,กาฬสินธุ์,4670,ท้องถิ่นเทศบาลตำบลบัวบาน,6232,6571,12803,6240,6574,12814,4581
2566,46,กาฬสินธุ์,4671,ท้องถิ่นเทศบาลตำบลนาขาม,6442,6557,12999,6445,6559,13004,3519
2566,46,กาฬสินธุ์,4672,ท้องถิ่นเทศบาลตำบลลำคลอง,2042,2203,4245,2045,2204,4249,1376
2566,46,กาฬสินธุ์,4673,ท้องถิ่นเทศบาลตำบลคำบง,5203,5160,10363,5207,5163,10370,3105
2566,46,กาฬสินธุ์,4674,ท้องถิ่นเทศบาลตำบลสระพังทอง,1367,1366,2733,1368,1367,2735,1029
2566,46,กาฬสินธุ์,4675,ท้องถิ่นเทศบาลตำบลห้วยโพธิ์,5706,5914,11620,5724,5916,11640,3502
2566,46,กาฬสินธุ์,4676,ท้องถิ่นเทศบาลตำบลนาคู,2465,2693,5158,2469,2696,5165,1971
2566,46,กาฬสินธุ์,4677,ท้องถิ่นเทศบาลตำบลห้วยผึ้ง,2766,2884,5650,2773,2887,5660,2328
2566,46,กาฬสินธุ์,4678,ท้องถิ่นเทศบาลตำบลสมเด็จ,3175,3435,6610,3186,3441,6627,3431
2566,46,กาฬสินธุ์,4679,ท้องถิ่นเทศบาลตำบลหนองหิน,2622,2681,5303,2625,2682,5307,1682
2566,46,กาฬสินธุ์,4680,ท้องถิ่นเทศบาลตำบลหนองกุงศรี,4307,4469,8776,4315,4472,8787,3518
2566,46,กาฬสินธุ์,4681,ท้องถิ่นเทศบาลตำบลท่าคันโท,4454,4594,9048,4460,4597,9057,3048
2566,46,กาฬสินธุ์,4682,ท้องถิ่นเทศบาลตำบลโพน,1855,1887,3742,1855,1887,3742,1135
2566,46,กาฬสินธุ์,4683,ท้องถิ่นเทศบาลตำบลคำม่วง,1917,1959,3876,1921,1960,3881,1777
2566,46,กาฬสินธุ์,4684,ท้องถิ่นเทศบาลตำบลโนนบุรี,2411,2658,5069,2421,2658,5079,2109
2566,46,กาฬสินธุ์,4685,ท้องถิ่นเทศบาลตำบลห้วยเม็ก,2720,2867,5587,2726,2869,5595,2310
2566,46,กาฬสินธุ์,4686,ท้องถิ่นเทศบาลตำบลคำใหญ่,2412,2490,4902,2416,2492,4908,1675
2566,46,กาฬสินธุ์,4687,ท้องถิ่นเทศบาลตำบลยางตลาด,3844,4359,8203,3855,4364,8219,3911
2566,46,กาฬสินธุ์,4688,ท้องถิ่นเทศบาลตำบลโคกศรี,1523,1625,3148,1525,1625,3150,1303
2566,46,กาฬสินธุ์,4689,ท้องถิ่นเทศบาลตำบลกุดสิม,4790,5074,9864,4804,5083,9887,4607
2566,46,กาฬสินธุ์,4690,ท้องถิ่นเทศบาลเมืองกุฉินารายณ์,5438,5699,11137,5448,5704,11152,5082
2566,46,กาฬสินธุ์,4691,ท้องถิ่นเทศบาลตำบลกุดหว้า,2477,2686,5163,2481,2687,5168,2109
2566,46,กาฬสินธุ์,4692,ท้องถิ่นเทศบาลตำบลร่องคำ,2907,3067,5974,2910,3069,5979,2297
2566,46,กาฬสินธุ์,4693,ท้องถิ่นเทศบาลตำบลหนองแปน,3189,3515,6704,3194,3515,6709,2261
2566,46,กาฬสินธุ์,4694,ท้องถิ่นเทศบาลตำบลธัญญา,3096,3188,6284,3103,3191,6294,1750
2566,46,กาฬสินธุ์,4695,ท้องถิ่นเทศบาลตำบลกมลาไสย,4506,5062,9568,4527,5065,9592,3775
2566,46,กาฬสินธุ์,4696,ท้องถิ่นเทศบาลตำบลนามน,3391,3466,6857,3393,3467,6860,2443
2566,46,กาฬสินธุ์,4697,ท้องถิ่นเทศบาลตำบลหนองสอ,3490,3768,7258,3500,3770,7270,2382
2566,46,กาฬสินธุ์,4698,ท้องถิ่นเทศบาลตำบลนาจารย์,4198,4202,8400,4206,4208,8414,2587
2566,46,กาฬสินธุ์,4699,ท้องถิ่นเทศบาลเมืองกาฬสินธุ์,14877,16398,31275,14958,16425,31383,16493
2566,47,สกลนคร,4701,อำเภอเมืองสกลนคร,56489,58178,114667,56562,58200,114762,44266
2566,47,สกลนคร,4702,อำเภอกุสุมาลย์,21821,21943,43764,21843,21952,43795,14518
2566,47,สกลนคร,4703,อำเภอกุดบาก,13901,13649,27550,13905,13651,27556,9493
2566,47,สกลนคร,4704,อำเภอพรรณานิคม,38419,39001,77420,38464,39035,77499,27931
2566,47,สกลนคร,4705,อำเภอพังโคน,22600,23202,45802,22658,23233,45891,18191
2566,47,สกลนคร,4706,อำเภอวาริชภูมิ,17600,18196,35796,17624,18206,35830,12781
2566,47,สกลนคร,4707,อำเภอนิคมน้ำอูน,7397,7414,14811,7402,7418,14820,4728
2566,47,สกลนคร,4708,อำเภอวานรนิวาส,59949,60599,120548,60020,60636,120656,36056
2566,47,สกลนคร,4709,อำเภอคำตากล้า,16365,16502,32867,16382,16513,32895,12033
2566,47,สกลนคร,4710,อำเภอบ้านม่วง,33750,33341,67091,33803,33359,67162,20825
2566,47,สกลนคร,4711,อำเภออากาศอำนวย,27164,26878,54042,27179,26896,54075,20040
2566,47,สกลนคร,4712,อำเภอสว่างแดนดิน,63213,64210,127423,63277,64249,127526,38587
2566,47,สกลนคร,4713,อำเภอส่องดาว,15024,14589,29613,15036,14598,29634,7913
2566,47,สกลนคร,4714,อำเภอเต่างอย,12125,12038,24163,12135,12043,24178,9107
2566,47,สกลนคร,4715,อำเภอโคกศรีสุพรรณ,10781,10930,21711,10790,10933,21723,7928
2566,47,สกลนคร,4716,อำเภอเจริญศิลป์,19289,19089,38378,19306,19095,38401,11055
2566,47,สกลนคร,4717,อำเภอโพนนาแก้ว,18473,18460,36933,18485,18470,36955,14382
2566,47,สกลนคร,4718,อำเภอภูพาน,18039,17713,35752,18062,17722,35784,10826
2566,47,สกลนคร,4751,สาขาตำบลกุดเรือคำ อำเภอวานรนิวาส,0,0,0,0,0,0,0
2566,47,สกลนคร,4779,ท้องถิ่นเทศบาลตำบลคำบ่อ,6769,6961,13730,6775,6964,13739,4259
2566,47,สกลนคร,4780,ท้องถิ่นเทศบาลตำบลตองโขบ,6215,6421,12636,6224,6423,12647,5964
2566,47,สกลนคร,4781,ท้องถิ่นเทศบาลตำบลบงใต้,5092,5017,10109,5096,5018,10114,3114
2566,47,สกลนคร,4782,ท้องถิ่นเทศบาลตำบลสามัคคีพัฒนา,4463,4546,9009,4465,4546,9011,2506
2566,47,สกลนคร,4783,ท้องถิ่นเทศบาลตำบลเชียงเครือ,7957,8203,16160,7962,8206,16168,6339
2566,47,สกลนคร,4784,ท้องถิ่นเทศบาลตำบลเจริญศิลป์,3306,3436,6742,3306,3437,6743,2389
2566,47,สกลนคร,4785,ท้องถิ่นเทศบาลตำบลส่องดาว,2461,2426,4887,2462,2427,4889,1675
2566,47,สกลนคร,4786,ท้องถิ่นเทศบาลตำบลสว่างแดนดิน,3813,4199,8012,3823,4217,8040,5004
2566,47,สกลนคร,4787,ท้องถิ่นเทศบาลตำบลดอนเขือง,2016,2081,4097,2017,2082,4099,1318
2566,47,สกลนคร,4788,ท้องถิ่นเทศบาลตำบลอากาศอำนวย,4311,4518,8829,4314,4521,8835,3124
2566,47,สกลนคร,4789,ท้องถิ่นเทศบาลตำบลบ้านม่วง,1688,1841,3529,1694,1844,3538,1538
2566,47,สกลนคร,4790,ท้องถิ่นเทศบาลตำบลคำตากล้า,3511,3622,7133,3522,3626,7148,2388
2566,47,สกลนคร,4791,ท้องถิ่นเทศบาลตำบลวานรนิวาส,2659,2934,5593,2663,2936,5599,2404
2566,47,สกลนคร,4792,ท้องถิ่นเทศบาลตำบลวาริชภูมิ,1321,1371,2692,1322,1371,2693,1405
2566,47,สกลนคร,4793,ท้องถิ่นเทศบาลตำบลพังโคน,3077,3230,6307,3100,3240,6340,4122
2566,47,สกลนคร,4794,ท้องถิ่นเทศบาลตำบลพรรณานิคม,1117,1246,2363,1119,1247,2366,1489
2566,47,สกลนคร,4795,ท้องถิ่นเทศบาลตำบลกุดบาก,2472,2600,5072,2474,2602,5076,1956
2566,47,สกลนคร,4796,ท้องถิ่นเทศบาลตำบลกุสุมาลย์,1950,2071,4021,1958,2072,4030,1771
2566,47,สกลนคร,4797,ท้องถิ่นเทศบาลตำบลท่าแร่,3092,3373,6465,3103,3378,6481,2353
2566,47,สกลนคร,4798,ท้องถิ่นเทศบาลตำบลดงมะไฟ,2751,3073,5824,2753,3076,5829,2330
2566,47,สกลนคร,4799,ท้องถิ่นเทศบาลนครสกลนคร,24060,25824,49884,24186,25944,50130,29867
2566,48,นครพนม,4801,อำเภอเมืองนครพนม,58523,58086,116609,58675,58256,116931,37743
2566,48,นครพนม,4802,อำเภอปลาปาก,25395,25047,50442,25424,25068,50492,16864
2566,48,นครพนม,4803,อำเภอท่าอุเทน,27459,27056,54515,27531,27156,54687,16406
2566,48,นครพนม,4804,อำเภอบ้านแพง,13322,13144,26466,13356,13204,26560,8586
2566,48,นครพนม,4805,อำเภอธาตุพนม,35368,35990,71358,35492,36098,71590,22739
2566,48,นครพนม,4806,อำเภอเรณูนคร,20669,20691,41360,20705,20707,41412,13462
2566,48,นครพนม,4807,อำเภอนาแก,35756,36243,71999,35810,36269,72079,22402
2566,48,นครพนม,4808,อำเภอศรีสงคราม,32046,32413,64459,32085,32461,64546,20005
2566,48,นครพนม,4809,อำเภอนาหว้า,19928,19898,39826,19947,19911,39858,13833
2566,48,นครพนม,4810,อำเภอโพนสวรรค์,26357,26345,52702,26376,26357,52733,17583
2566,48,นครพนม,4811,อำเภอนาทม,11869,11830,23699,11888,11838,23726,7882
2566,48,นครพนม,4812,อำเภอวังยาง,7911,7763,15674,7917,7765,15682,4943
2566,48,นครพนม,4890,ท้องถิ่นเทศบาลตำบลปลาปาก,1855,1980,3835,1857,1982,3839,1643
2566,48,นครพนม,4891,ท้องถิ่นเทศบาลตำบลโพนสวรรค์,2629,2673,5302,2634,2674,5308,1918
2566,48,นครพนม,4892,ท้องถิ่นเทศบาลตำบลนาหว้า,5927,6137,12064,5953,6141,12094,4404
2566,48,นครพนม,4893,ท้องถิ่นเทศบาลตำบลศรีสงคราม,2399,2517,4916,2406,2528,4934,2650
2566,48,นครพนม,4894,ท้องถิ่นเทศบาลตำบลนาแก,1963,2221,4184,1968,2221,4189,2385
2566,48,นครพนม,4895,ท้องถิ่นเทศบาลตำบลเรณูนคร,2048,2304,4352,2057,2312,4369,1735
2566,48,นครพนม,4896,ท้องถิ่นเทศบาลตำบลธาตุพนม,4705,5035,9740,4718,5045,9763,4206
2566,48,นครพนม,4897,ท้องถิ่นเทศบาลตำบลบ้านแพง,4248,4358,8606,4271,4408,8679,3771
2566,48,นครพนม,4898,ท้องถิ่นเทศบาลตำบลท่าอุเทน,2284,2390,4674,2304,2439,4743,2027
2566,48,นครพนม,4899,ท้องถิ่นเทศบาลเมืองนครพนม,12039,13717,25756,12183,13887,26070,15730
2566,49,มุกดาหาร,4901,อำเภอเมืองมุกดาหาร,40268,39668,79936,40427,39850,80277,28083
2566,49,มุกดาหาร,4902,อำเภอนิคมคำสร้อย,16946,17116,34062,16979,17125,34104,10485
2566,49,มุกดาหาร,4903,อำเภอดอนตาล,19452,19170,38622,19540,19315,38855,12229
2566,49,มุกดาหาร,4904,อำเภอดงหลวง,19811,19383,39194,19823,19394,39217,12676
2566,49,มุกดาหาร,4905,อำเภอคำชะอี,22051,22100,44151,22081,22114,44195,15040
2566,49,มุกดาหาร,4906,อำเภอหว้านใหญ่,9950,9899,19849,10038,10118,20156,6680
2566,49,มุกดาหาร,4907,อำเภอหนองสูง,10286,10344,20630,10294,10350,20644,7686
2566,49,มุกดาหาร,4989,ท้องถิ่นเทศบาลตำบลร่มเกล้า,1693,1611,3304,1696,1612,3308,1102
2566,49,มุกดาหาร,4993,ท้องถิ่นเทศบาลตำบลบ้านแก้ง,1521,1519,3040,1552,1558,3110,1021
2566,49,มุกดาหาร,4994,ท้องถิ่นเทศบาลตำบลคำอาฮวน,6531,6434,12965,6554,6444,12998,4999
2566,49,มุกดาหาร,4995,ท้องถิ่นเทศบาลตำบลดงเย็น,5484,5292,10776,5491,5304,10795,3172
2566,49,มุกดาหาร,4996,ท้องถิ่นเทศบาลตำบลคำชะอี,1140,1146,2286,1142,1148,2290,1149
2566,49,มุกดาหาร,4997,ท้องถิ่นเทศบาลตำบลดอนตาล,1127,1294,2421,1152,1320,2472,997
2566,49,มุกดาหาร,4998,ท้องถิ่นเทศบาลตำบลนิคมคำสร้อย,2984,3121,6105,2994,3123,6117,2427
2566,49,มุกดาหาร,4999,ท้องถิ่นเทศบาลเมืองมุกดาหาร,14866,16075,30941,15908,17149,33057,16778
2566,50,เชียงใหม่,5001,อำเภอเมืองเชียงใหม่,6726,7700,14426,6943,7856,14799,11931
2566,50,เชียงใหม่,5002,อำเภอจอมทอง,27701,28762,56463,27888,28926,56814,20985
2566,50,เชียงใหม่,5003,อำเภอแม่แจ่ม,29094,28258,57352,29490,28556,58046,19089
2566,50,เชียงใหม่,5004,อำเภอเชียงดาว,10915,11493,22408,13666,14242,27908,12009
2566,50,เชียงใหม่,5005,อำเภอดอยสะเก็ด,22094,24662,46756,22601,25013,47614,24497
2566,50,เชียงใหม่,5006,อำเภอแม่แตง,24754,25409,50163,29570,30072,59642,25630
2566,50,เชียงใหม่,5007,อำเภอแม่ริม,37501,40248,77749,41073,43440,84513,40111
2566,50,เชียงใหม่,5008,อำเภอสะเมิง,9158,8854,18012,9306,8992,18298,6319
2566,50,เชียงใหม่,5009,อำเภอฝาง,40420,42255,82675,55875,56871,112746,42476
2566,50,เชียงใหม่,5010,อำเภอแม่อาย,28343,28874,57217,34054,34203,68257,26837
2566,50,เชียงใหม่,5011,อำเภอพร้าว,17662,18134,35796,17951,18418,36369,16032
2566,50,เชียงใหม่,5012,อำเภอสันป่าตอง,27276,31143,58419,27509,31343,58852,26593
2566,50,เชียงใหม่,5013,อำเภอสันกำแพง,20246,23118,43364,20551,23300,43851,24263
2566,50,เชียงใหม่,5014,อำเภอสันทราย,9557,10911,20468,10274,11626,21900,11299
2566,50,เชียงใหม่,5015,อำเภอหางดง,35886,41322,77208,36916,41906,78822,47234
2566,50,เชียงใหม่,5016,อำเภอฮอด,12426,12679,25105,12477,12726,25203,9918
2566,50,เชียงใหม่,5017,อำเภอดอยเต่า,11179,11332,22511,11194,11351,22545,8929
2566,50,เชียงใหม่,5018,อำเภออมก๋อย,31159,30723,61882,31294,30860,62154,23834
2566,50,เชียงใหม่,5019,อำเภอสารภี,22402,25902,48304,22935,26354,49289,25437
2566,50,เชียงใหม่,5020,อำเภอเวียงแหง,10339,9727,20066,27495,26866,54361,10005
2566,50,เชียงใหม่,5021,อำเภอไชยปราการ,11876,11861,23737,17632,17683,35315,12102
2566,50,เชียงใหม่,5022,อำเภอแม่วาง,13397,13645,27042,13638,13860,27498,10244
2566,50,เชียงใหม่,5023,อำเภอแม่ออน,10114,10442,20556,10278,10578,20856,9927
2566,50,เชียงใหม่,5024,อำเภอดอยหล่อ,11620,12507,24127,11860,12740,24600,11904
2566,50,เชียงใหม่,5025,อำเภอกัลยาณิวัฒนา,6654,6306,12960,6676,6318,12994,4631
2566,50,เชียงใหม่,5040,ท้องถิ่นเทศบาลตำบลบวกค้าง,4083,4569,8652,4153,4625,8778,4256
2566,50,เชียงใหม่,5041,ท้องถิ่นเทศบาลตำบลบ่อหลวง,5961,5968,11929,5989,5998,11987,3963
2566,50,เชียงใหม่,5042,ท้องถิ่นเทศบาลตำบลป่าไผ่,7129,8007,15136,7315,8207,15522,7112
2566,50,เชียงใหม่,5043,ท้องถิ่นเทศบาลตำบลสันนาเม็ง,6008,7265,13273,6249,7432,13681,8778
2566,50,เชียงใหม่,5044,ท้องถิ่นเทศบาลตำบลสันพระเนตร,2832,3381,6213,2897,3429,6326,3560
2566,50,เชียงใหม่,5046,ท้องถิ่นเทศบาลตำบลสันปูเลย,8204,9676,17880,8407,9799,18206,10316
2566,50,เชียงใหม่,5049,ท้องถิ่นเทศบาลตำบลเชิงดอย,3677,4059,7736,3803,4156,7959,3942
2566,50,เชียงใหม่,5050,ท้องถิ่นเทศบาลตำบลเมืองนะ,11753,11588,23341,18841,19513,38354,9910
2566,50,เชียงใหม่,5054,ท้องถิ่นเทศบาลตำบลทุ่งข้าวพวง,3275,3240,6515,5567,5481,11048,3172
2566,50,เชียงใหม่,5055,ท้องถิ่นเทศบาลตำบลปิงโค้ง,6572,5676,12248,7610,6685,14295,4716
2566,50,เชียงใหม่,5056,ท้องถิ่นเทศบาลตำบลพระธาตุปู่ก่ำ,980,1033,2013,1157,1205,2362,1175
2566,50,เชียงใหม่,5057,ท้องถิ่นเทศบาลเมืองแม่เหียะ,8709,10857,19566,8960,11006,19966,14167
2566,50,เชียงใหม่,5058,ท้องถิ่นเทศบาลตำบลสารภี,2858,3324,6182,3137,3585,6722,2843
2566,50,เชียงใหม่,5059,ท้องถิ่นเทศบาลตำบลฟ้าฮ่าม,3137,3787,6924,3246,3870,7116,9743
2566,50,เชียงใหม่,5060,ท้องถิ่นเทศบาลตำบลหนองจ๊อม,7660,9302,16962,7966,9537,17503,9684
2566,50,เชียงใหม่,5061,ท้องถิ่นเทศบาลตำบลหนองหอย,3462,4288,7750,3557,4345,7902,5723
2566,50,เชียงใหม่,5062,ท้องถิ่นเทศบาลตำบลแม่แฝก,4126,4759,8885,4175,4812,8987,4046
2566,50,เชียงใหม่,5063,ท้องถิ่นเทศบาลตำบลท่าศาลา,3204,3808,7012,3353,3888,7241,5588
2566,50,เชียงใหม่,5064,ท้องถิ่นเทศบาลตำบลหนองผึ้ง,7311,8657,15968,7489,8782,16271,9257
2566,50,เชียงใหม่,5065,ท้องถิ่นเทศบาลตำบลเจดีย์แม่ครัว,3908,4342,8250,3995,4423,8418,4279
2566,50,เชียงใหม่,5066,ท้องถิ่นเทศบาลตำบลแม่ปั๋ง,2916,3016,5932,2958,3058,6016,2693
2566,50,เชียงใหม่,5067,ท้องถิ่นเทศบาลตำบลชมภู,3708,4021,7729,3772,4099,7871,3410
2566,50,เชียงใหม่,5068,ท้องถิ่นเทศบาลตำบลป่าแดด,8016,9606,17622,8208,9760,17968,11500
2566,50,เชียงใหม่,5069,ท้องถิ่นเทศบาลเมืองสุเทพ,8111,8453,16564,8342,8636,16978,11700
2566,50,เชียงใหม่,5070,ท้องถิ่นเทศบาลตำบลหนองป่าครั่ง,3205,3730,6935,3424,3899,7323,6369
2566,50,เชียงใหม่,5071,ท้องถิ่นเทศบาลตำบลแม่วาง,2084,2350,4434,2119,2381,4500,2304
2566,50,เชียงใหม่,5072,ท้องถิ่นเทศบาลตำบลไชยปราการ,6935,7692,14627,7334,8080,15414,6722
2566,50,เชียงใหม่,5073,ท้องถิ่นเทศบาลตำบลยางเนิ้ง,4907,5927,10834,4959,5961,10920,6045
2566,50,เชียงใหม่,5074,ท้องถิ่นเทศบาลตำบลอมก๋อย,540,505,1045,546,507,1053,853
2566,50,เชียงใหม่,5075,ท้องถิ่นเทศบาลตำบลท่าเดื่อ-มืดกา,2005,2156,4161,2019,2166,4185,1910
2566,50,เชียงใหม่,5076,ท้องถิ่นเทศบาลตำบลท่าข้าม,2664,2912,5576,2679,2922,5601,3612
2566,50,เชียงใหม่,5077,ท้องถิ่นเทศบาลตำบลหางดง,2623,3321,5944,3050,3683,6733,4006
2566,50,เชียงใหม่,5078,ท้องถิ่นเทศบาลตำบลหนองตองพัฒนา,3763,4388,8151,3784,4401,8185,3638
2566,50,เชียงใหม่,5079,ท้องถิ่นเทศบาลตำบลสันทรายหลวง,12805,15730,28535,13243,16003,29246,16995
2566,50,เชียงใหม่,5080,ท้องถิ่นเทศบาลเมืองแม่โจ้,9862,12143,22005,10718,12859,23577,15227
2566,50,เชียงใหม่,5081,ท้องถิ่นเทศบาลตำบลสันกำแพง,7941,9376,17317,8095,9448,17543,9447
2566,50,เชียงใหม่,5082,ท้องถิ่นเทศบาลเมืองต้นเปา,9024,10985,20009,9212,11154,20366,14070
2566,50,เชียงใหม่,5083,ท้องถิ่นเทศบาลตำบลสันป่าตอง,1940,2323,4263,1951,2331,4282,2839
2566,50,เชียงใหม่,5084,ท้องถิ่นเทศบาลตำบลบ้านกลาง,4780,5437,10217,4816,5467,10283,5593
2566,50,เชียงใหม่,5085,ท้องถิ่นเทศบาลตำบลเวียงพร้าว,2037,2426,4463,2071,2464,4535,2896
2566,50,เชียงใหม่,5086,ท้องถิ่นเทศบาลตำบลแม่อาย,4253,4703,8956,4986,5449,10435,4533
2566,50,เชียงใหม่,5087,ท้องถิ่นเทศบาลตำบลเวียงฝาง,2707,3107,5814,4052,4383,8435,4023
2566,50,เชียงใหม่,5088,ท้องถิ่นเทศบาลตำบลบ้านแม่ข่า,869,919,1788,890,939,1829,899
2566,50,เชียงใหม่,5089,ท้องถิ่นเทศบาลตำบลสะเมิงใต้,2485,2532,5017,2639,2674,5313,2763
2566,50,เชียงใหม่,5090,ท้องถิ่นเทศบาลตำบลแม่ริม,4202,4850,9052,4275,4890,9165,5956
2566,50,เชียงใหม่,5091,ท้องถิ่นเทศบาลตำบลสันมหาพน,3646,4190,7836,3824,4377,8201,5213
2566,50,เชียงใหม่,5092,ท้องถิ่นเทศบาลเมืองเมืองแกนพัฒนา,5636,6266,11902,5715,6339,12054,5857
2566,50,เชียงใหม่,5093,ท้องถิ่นเทศบาลตำบลดอยสะเก็ด,1778,2063,3841,1881,2153,4034,2188
2566,50,เชียงใหม่,5094,ท้องถิ่นเทศบาลตำบลเมืองงาย,1663,1940,3603,1745,2004,3749,2040
2566,50,เชียงใหม่,5095,ท้องถิ่นเทศบาลตำบลเชียงดาว,1734,1989,3723,1755,2010,3765,2395
2566,50,เชียงใหม่,5096,ท้องถิ่นเทศบาลตำบลแม่แจ่ม,1247,1282,2529,1261,1298,2559,1664
2566,50,เชียงใหม่,5097,ท้องถิ่นเทศบาลตำบลจอมทอง,4133,4825,8958,4157,4840,8997,4631
2566,50,เชียงใหม่,5098,ท้องถิ่นเทศบาลตำบลช้างเผือก,3921,4547,8468,4107,4664,8771,9255
2566,50,เชียงใหม่,5099,ท้องถิ่นเทศบาลนครเชียงใหม่,51219,58721,109940,54067,61232,115299,92150
2566,51,ลำพูน,5101,อำเภอเมืองลำพูน,27869,31319,59188,28302,31686,59988,29656
2566,51,ลำพูน,5102,อำเภอแม่ทา,11977,12433,24410,12016,12458,24474,10950
2566,51,ลำพูน,5103,อำเภอบ้านโฮ่ง,12239,12957,25196,12293,12997,25290,10571
2566,51,ลำพูน,5104,อำเภอลี้,30423,30134,60557,30504,30246,60750,21917
2566,51,ลำพูน,5105,อำเภอทุ่งหัวช้าง,8782,8759,17541,8782,8760,17542,6638
2566,51,ลำพูน,5106,อำเภอป่าซาง,13324,14272,27596,13526,14483,28009,13141
2566,51,ลำพูน,5107,อำเภอบ้านธิ,3676,4123,7799,3764,4194,7958,3488
2566,51,ลำพูน,5108,อำเภอเวียงหนองล่อง,0,0,0,0,0,0,0
2566,51,ลำพูน,5176,ท้องถิ่นเทศบาลตำบลศรีเตี้ย,2551,2770,5321,2559,2782,5341,2286
2566,51,ลำพูน,5177,ท้องถิ่นเทศบาลตำบลทาสบชัย,2384,2496,4880,2415,2524,4939,2351
2566,51,ลำพูน,5178,ท้องถิ่นเทศบาลตำบลหนองล่อง,2595,2804,5399,2605,2811,5416,2603
2566,51,ลำพูน,5179,ท้องถิ่นเทศบาลตำบลหนองยวง,1680,1841,3521,1703,1855,3558,1821
2566,51,ลำพูน,5180,ท้องถิ่นเทศบาลตำบลมะกอก,2387,2717,5104,2399,2720,5119,2434
2566,51,ลำพูน,5181,ท้องถิ่นเทศบาลตำบลมะเขือแจ้,7690,8471,16161,7774,8558,16332,9316
2566,51,ลำพูน,5182,ท้องถิ่นเทศบาลตำบลเวียงยอง,3279,3852,7131,3328,3890,7218,4008
2566,51,ลำพูน,5183,ท้องถิ่นเทศบาลตำบลบ้านกลาง,5449,6339,11788,5499,6382,11881,11617
2566,51,ลำพูน,5184,ท้องถิ่นเทศบาลตำบลเหมืองง่า,7277,8824,16101,7327,8862,16189,8762
2566,51,ลำพูน,5185,ท้องถิ่นเทศบาลตำบลแม่แรง,3266,3600,6866,3279,3606,6885,2761
2566,51,ลำพูน,5186,ท้องถิ่นเทศบาลตำบลบ้านธิ,4320,4819,9139,4445,4938,9383,4539
2566,51,ลำพูน,5187,ท้องถิ่นเทศบาลตำบลวังผาง,3506,3914,7420,3518,3921,7439,3312
2566,51,ลำพูน,5188,ท้องถิ่นเทศบาลตำบลม่วงน้อย,1887,2209,4096,1894,2210,4104,2017
2566,51,ลำพูน,5189,ท้องถิ่นเทศบาลตำบลป่าซาง,3704,4435,8139,3728,4452,8180,4284
2566,51,ลำพูน,5190,ท้องถิ่นเทศบาลตำบลทุ่งหัวช้าง,1256,1259,2515,1257,1262,2519,1296
2566,51,ลำพูน,5191,ท้องถิ่นเทศบาลตำบลวังดิน,2035,2166,4201,2042,2181,4223,2816
2566,51,ลำพูน,5192,ท้องถิ่นเทศบาลตำบลแม่ตืน,1563,1733,3296,1596,1767,3363,1370
2566,51,ลำพูน,5193,ท้องถิ่นเทศบาลตำบลบ้านโฮ่ง,3368,3997,7365,3389,4012,7401,3690
2566,51,ลำพูน,5194,ท้องถิ่นเทศบาลตำบลทาสบเส้า,2492,2674,5166,2522,2701,5223,2588
2566,51,ลำพูน,5195,ท้องถิ่นเทศบาลตำบลทากาศ,1356,1515,2871,1363,1519,2882,1418
2566,51,ลำพูน,5196,ท้องถิ่นเทศบาลตำบลอุโมงค์,5835,6732,12567,5921,6801,12722,6196
2566,51,ลำพูน,5197,ท้องถิ่นเทศบาลตำบลริมปิง,3091,3571,6662,3110,3591,6701,2997
2566,51,ลำพูน,5198,ท้องถิ่นเทศบาลตำบลบ้านแป้น,2873,3335,6208,2898,3357,6255,2979
2566,51,ลำพูน,5199,ท้องถิ่นเทศบาลเมืองลำพูน,5026,6070,11096,5064,6092,11156,7272
2566,52,ลำปาง,5201,อำเภอเมืองลำปาง,43605,45652,89257,43718,45743,89461,39757
2566,52,ลำปาง,5202,อำเภอแม่เมาะ,11894,11803,23697,11923,11832,23755,9358
2566,52,ลำปาง,5203,อำเภอเกาะคา,16998,18269,35267,17025,18292,35317,13592
2566,52,ลำปาง,5204,อำเภอเสริมงาม,10886,10870,21756,10908,10889,21797,7823
2566,52,ลำปาง,5205,อำเภองาว,23634,23804,47438,23800,23990,47790,18500
2566,52,ลำปาง,5206,อำเภอแจ้ห่ม,16661,17218,33879,16740,17281,34021,13377
2566,52,ลำปาง,5207,อำเภอวังเหนือ,17733,17519,35252,18183,18017,36200,13633
2566,52,ลำปาง,5208,อำเภอเถิน,16061,16556,32617,16078,16589,32667,11690
2566,52,ลำปาง,5209,อำเภอแม่พริก,4463,4608,9071,4463,4616,9079,3279
2566,52,ลำปาง,5210,อำเภอแม่ทะ,13434,13820,27254,13446,13829,27275,10962
2566,52,ลำปาง,5211,อำเภอสบปราบ,10176,10544,20720,10183,10557,20740,6753
2566,52,ลำปาง,5212,อำเภอห้างฉัตร,22584,23664,46248,22657,23710,46367,19883
2566,52,ลำปาง,5213,อำเภอเมืองปาน,15989,16061,32050,16002,16083,32085,12495
2566,52,ลำปาง,5275,ท้องถิ่นเทศบาลตำบลน้ำโจ้,4573,4801,9374,4581,4805,9386,3563
2566,52,ลำปาง,5276,ท้องถิ่นเทศบาลตำบลแม่ทะ,3126,3210,6336,3132,3213,6345,3037
2566,52,ลำปาง,5279,ท้องถิ่นเทศบาลตำบลนาแก้ว,4242,4470,8712,4247,4472,8719,3193
2566,52,ลำปาง,5280,ท้องถิ่นเทศบาลตำบลลำปางหลวง,4259,4714,8973,4265,4720,8985,3398
2566,52,ลำปาง,5281,ท้องถิ่นเทศบาลตำบลสิริราช,2313,2217,4530,2317,2219,4536,1624
2566,52,ลำปาง,5282,ท้องถิ่นเทศบาลตำบลแม่เมาะ,7311,7647,14958,7325,7659,14984,8848
2566,52,ลำปาง,5283,ท้องถิ่นเทศบาลตำบลเวียงมอก,5011,5089,10100,5016,5097,10113,3610
2566,52,ลำปาง,5284,ท้องถิ่นเทศบาลตำบลห้างฉัตร,1206,1488,2694,1207,1490,2697,1326
2566,52,ลำปาง,5285,ท้องถิ่นเทศบาลตำบลสบปราบ,2539,2830,5369,2540,2831,5371,2120
2566,52,ลำปาง,5286,ท้องถิ่นเทศบาลตำบลป่าตันนาครัว,3676,3926,7602,3679,3926,7605,3036
2566,52,ลำปาง,5287,ท้องถิ่นเทศบาลตำบลแม่พริก,1173,1311,2484,1173,1311,2484,1151
2566,52,ลำปาง,5288,ท้องถิ่นเทศบาลตำบลแม่ปุ,1744,1947,3691,1749,1948,3697,1362
2566,52,ลำปาง,5289,ท้องถิ่นเทศบาลเมืองล้อมแรด,6326,7352,13678,6356,7383,13739,7270
2566,52,ลำปาง,5290,ท้องถิ่นเทศบาลตำบลวังเหนือ,1929,1964,3893,1941,1969,3910,2012
2566,52,ลำปาง,5291,ท้องถิ่นเทศบาลตำบลบ้านใหม่,1218,1255,2473,1219,1257,2476,897
2566,52,ลำปาง,5292,ท้องถิ่นเทศบาลตำบลแจ้ห่ม,1551,1745,3296,1553,1745,3298,1696
2566,52,ลำปาง,5293,ท้องถิ่นเทศบาลตำบลเสริมงาม,3971,4069,8040,3975,4072,8047,3090
2566,52,ลำปาง,5294,ท้องถิ่นเทศบาลตำบลหลวงเหนือ,1859,2100,3959,1866,2103,3969,2392
2566,52,ลำปาง,5295,ท้องถิ่นเทศบาลตำบลเกาะคา,2028,2366,4394,2050,2384,4434,2413
2566,52,ลำปาง,5296,ท้องถิ่นเทศบาลเมืองพิชัย,6166,7022,13188,6192,7029,13221,6638
2566,52,ลำปาง,5297,ท้องถิ่นเทศบาลตำบลบ่อแฮ้ว,4456,4997,9453,4473,5013,9486,4479
2566,52,ลำปาง,5298,ท้องถิ่นเทศบาลเมืองเขลางค์นคร,27778,31025,58803,27852,31072,58924,26934
2566,52,ลำปาง,5299,ท้องถิ่นเทศบาลนครลำปาง,21477,26615,48092,21705,26793,48498,29980
2566,53,อุตรดิตถ์,5301,อำเภอเมืองอุตรดิตถ์,22104,23318,45422,22123,23334,45457,18319
2566,53,อุตรดิตถ์,5302,อำเภอตรอน,14177,15083,29260,14186,15093,29279,10290
2566,53,อุตรดิตถ์,5303,อำเภอท่าปลา,14151,14379,28530,14166,14397,28563,10093
2566,53,อุตรดิตถ์,5304,อำเภอน้ำปาด,16344,16290,32634,16383,16378,32761,12272
2566,53,อุตรดิตถ์,5305,อำเภอฟากท่า,6337,6676,13013,6343,6693,13036,5231
2566,53,อุตรดิตถ์,5306,อำเภอบ้านโคก,5136,4908,10044,5255,5132,10387,4635
2566,53,อุตรดิตถ์,5307,อำเภอพิชัย,34236,36220,70456,34265,36240,70505,26408
2566,53,อุตรดิตถ์,5308,อำเภอลับแล,17798,18287,36085,17805,18294,36099,15448
2566,53,อุตรดิตถ์,5309,อำเภอทองแสนขัน,12889,13221,26110,12894,13223,26117,9749
2566,53,อุตรดิตถ์,5377,ท้องถิ่นเทศบาลตำบลท่าเสา,7475,7280,14755,7487,7286,14773,7883
2566,53,อุตรดิตถ์,5378,ท้องถิ่นเทศบาลตำบลน้ำริด,3329,3518,6847,3331,3519,6850,2658
2566,53,อุตรดิตถ์,5379,ท้องถิ่นเทศบาลตำบลหาดกรวด,3563,3876,7439,3575,3880,7455,2703
2566,53,อุตรดิตถ์,5380,ท้องถิ่นเทศบาลตำบลจริม,4263,4121,8384,4265,4122,8387,2362
2566,53,อุตรดิตถ์,5381,ท้องถิ่นเทศบาลตำบลคุ้งตะเภา,4227,4541,8768,4232,4545,8777,3573
2566,53,อุตรดิตถ์,5382,ท้องถิ่นเทศบาลตำบลผาจุก,3817,4105,7922,3820,4108,7928,3129
2566,53,อุตรดิตถ์,5383,ท้องถิ่นเทศบาลตำบลบ้านเกาะ,4355,5042,9397,4370,5048,9418,3968
2566,53,อุตรดิตถ์,5384,ท้องถิ่นเทศบาลตำบลทองแสนขัน,2137,2315,4452,2140,2317,4457,1851
2566,53,อุตรดิตถ์,5385,ท้องถิ่นเทศบาลตำบลหัวดง,2661,2792,5453,2662,2792,5454,2212
2566,53,อุตรดิตถ์,5386,ท้องถิ่นเทศบาลตำบลทุ่งยั้ง,4497,5206,9703,4507,5207,9714,4224
2566,53,อุตรดิตถ์,5387,ท้องถิ่นเทศบาลตำบลในเมือง,802,970,1772,809,971,1780,1016
2566,53,อุตรดิตถ์,5388,ท้องถิ่นเทศบาลตำบลท่าสัก,549,622,1171,550,624,1174,583
2566,53,อุตรดิตถ์,5389,ท้องถิ่นเทศบาลตำบลบ้านโคก,1851,1728,3579,1926,1905,3831,1951
2566,53,อุตรดิตถ์,5390,ท้องถิ่นเทศบาลตำบลฟากท่า,402,367,769,402,367,769,433
2566,53,อุตรดิตถ์,5391,ท้องถิ่นเทศบาลตำบลน้ำปาด,1351,1469,2820,1353,1475,2828,1611
2566,53,อุตรดิตถ์,5392,ท้องถิ่นเทศบาลตำบลร่วมจิต,1580,1741,3321,1580,1743,3323,1226
2566,53,อุตรดิตถ์,5393,ท้องถิ่นเทศบาลตำบลท่าปลา,1042,1146,2188,1046,1146,2192,976
2566,53,อุตรดิตถ์,5394,ท้องถิ่นเทศบาลตำบลบ้านแก่ง,997,1074,2071,997,1075,2072,904
2566,53,อุตรดิตถ์,5395,ท้องถิ่นเทศบาลตำบลตรอน,790,869,1659,791,869,1660,698
2566,53,อุตรดิตถ์,5396,ท้องถิ่นเทศบาลตำบลวังกะพี้,4421,5028,9449,4428,5032,9460,3491
2566,53,อุตรดิตถ์,5397,ท้องถิ่นเทศบาลตำบลบ้านด่านนาขาม,1842,1932,3774,1843,1932,3775,1406
2566,53,อุตรดิตถ์,5398,ท้องถิ่นเทศบาลตำบลศรีพนมมาศ,1292,1513,2805,1293,1513,2806,1208
2566,53,อุตรดิตถ์,5399,ท้องถิ่นเทศบาลเมืองอุตรดิตถ์,12997,15440,28437,13055,15487,28542,15085
2566,54,แพร่,5401,อำเภอเมืองแพร่,28907,32712,61619,28960,32735,61695,28327
2566,54,แพร่,5402,อำเภอร้องกวาง,16633,17979,34612,16676,18033,34709,13020
2566,54,แพร่,5403,อำเภอลอง,14834,15136,29970,14854,15147,30001,11671
2566,54,แพร่,5404,อำเภอสูงเม่น,32000,35280,67280,32030,35308,67338,28506
2566,54,แพร่,5405,อำเภอเด่นชัย,9949,9508,19457,9956,9517,19473,8621
2566,54,แพร่,5406,อำเภอสอง,20134,21073,41207,20176,21099,41275,16602
2566,54,แพร่,5407,อำเภอวังชิ้น,20748,20939,41687,20805,20992,41797,15691
2566,54,แพร่,5408,อำเภอหนองม่วงไข่,5752,6626,12378,5759,6630,12389,5116
2566,54,แพร่,5482,ท้องถิ่นเทศบาลตำบลแม่ลานนา,3139,3292,6431,3143,3295,6438,2743
2566,54,แพร่,5483,ท้องถิ่นเทศบาลตำบลแม่ปาน,1432,1417,2849,1432,1417,2849,1165
2566,54,แพร่,5484,ท้องถิ่นเทศบาลตำบลเวียงต้า,3099,3077,6176,3101,3078,6179,2491
2566,54,แพร่,5485,ท้องถิ่นเทศบาลตำบลป่าแมต,5543,6365,11908,5551,6368,11919,5115
2566,54,แพร่,5486,ท้องถิ่นเทศบาลตำบลแม่คำมี,3418,3585,7003,3419,3585,7004,2756
2566,54,แพร่,5487,ท้องถิ่นเทศบาลตำบลหนองม่วงไข่,1986,2325,4311,1987,2327,4314,1925
2566,54,แพร่,5488,ท้องถิ่นเทศบาลตำบลวังชิ้น,1358,1444,2802,1363,1444,2807,1464
2566,54,แพร่,5489,ท้องถิ่นเทศบาลตำบลสอง,2882,3465,6347,2891,3470,6361,3161
2566,54,แพร่,5490,ท้องถิ่นเทศบาลตำบลแม่จั๊วะ,1730,1902,3632,1736,1904,3640,1580
2566,54,แพร่,5491,ท้องถิ่นเทศบาลตำบลเด่นชัย,5020,5605,10625,5032,5611,10643,5285
2566,54,แพร่,5492,ท้องถิ่นเทศบาลตำบลสูงเม่น,1673,1938,3611,1675,1941,3616,1948
2566,54,แพร่,5493,ท้องถิ่นเทศบาลตำบลห้วยอ้อ,2190,2482,4672,2197,2482,4679,2245
2566,54,แพร่,5494,ท้องถิ่นเทศบาลตำบลบ้านปิน,976,1183,2159,980,1184,2164,831
2566,54,แพร่,5495,ท้องถิ่นเทศบาลตำบลร้องกวาง,5656,6377,12033,5666,6381,12047,6137
2566,54,แพร่,5496,ท้องถิ่นเทศบาลตำบลแม่หล่าย,1970,2291,4261,1974,2300,4274,2050
2566,54,แพร่,5497,ท้องถิ่นเทศบาลตำบลทุ่งโฮ้ง,2832,3279,6111,2837,3285,6122,3282
2566,54,แพร่,5498,ท้องถิ่นเทศบาลตำบลช่อแฮ,4148,4426,8574,4151,4428,8579,3788
2566,54,แพร่,5499,ท้องถิ่นเทศบาลเมืองแพร่,6390,7543,13933,6436,7583,14019,8873
2566,55,น่าน,5501,อำเภอเมืองน่าน,31283,31636,62919,31385,31741,63126,25983
2566,55,น่าน,5502,อำเภอแม่จริม,8309,7994,16303,8334,8018,16352,5001
2566,55,น่าน,5503,อำเภอบ้านหลวง,5697,5595,11292,5700,5602,11302,4027
2566,55,น่าน,5504,อำเภอนาน้อย,14752,14707,29459,14768,14721,29489,10725
2566,55,น่าน,5505,อำเภอปัว,26511,26896,53407,26564,26991,53555,16615
2566,55,น่าน,5506,อำเภอท่าวังผา,22303,22455,44758,22367,22552,44919,15078
2566,55,น่าน,5507,อำเภอเวียงสา,32944,32823,65767,33042,32933,65975,25445
2566,55,น่าน,5508,อำเภอทุ่งช้าง,7789,7609,15398,7879,7762,15641,5277
2566,55,น่าน,5509,อำเภอเชียงกลาง,8537,8709,17246,8561,8729,17290,5991
2566,55,น่าน,5510,อำเภอนาหมื่น,7037,6923,13960,7042,6927,13969,4616
2566,55,น่าน,5511,อำเภอสันติสุข,7985,7588,15573,7995,7600,15595,5321
2566,55,น่าน,5512,อำเภอบ่อเกลือ,7843,7488,15331,7872,7516,15388,5292
2566,55,น่าน,5513,อำเภอสองแคว,6319,5872,12191,6396,5994,12390,3985
2566,55,น่าน,5514,อำเภอภูเพียง,17625,18125,35750,17658,18157,35815,14283
2566,55,น่าน,5515,อำเภอเฉลิมพระเกียรติ,4973,4710,9683,5032,4759,9791,3462
2566,55,น่าน,5592,ท้องถิ่นเทศบาลตำบลเชียงกลาง,4661,4816,9477,4674,4825,9499,4063
2566,55,น่าน,5593,ท้องถิ่นเทศบาลตำบลทุ่งช้าง,1638,1601,3239,1649,1618,3267,1457
2566,55,น่าน,5594,ท้องถิ่นเทศบาลตำบลเวียงสา,1265,1464,2729,1265,1466,2731,1335
2566,55,น่าน,5595,ท้องถิ่นเทศบาลตำบลท่าวังผา,2455,2709,5164,2464,2728,5192,2816
2566,55,น่าน,5596,ท้องถิ่นเทศบาลตำบลปัว,4952,5309,10261,4981,5344,10325,5153
2566,55,น่าน,5597,ท้องถิ่นเทศบาลตำบลนาน้อย,1096,1222,2318,1098,1225,2323,1264
2566,55,น่าน,5598,ท้องถิ่นเทศบาลตำบลหนองแดง,0,0,0,0,0,0,0
2566,55,น่าน,5599,ท้องถิ่นเทศบาลเมืองน่าน,9236,9459,18695,9282,9506,18788,10978
2566,56,พะเยา,5601,อำเภอเมืองพะเยา,20564,22026,42590,20612,22075,42687,17889
2566,56,พะเยา,5602,อำเภอจุน,8359,9261,17620,8402,9286,17688,7497
2566,56,พะเยา,5603,อำเภอเชียงคำ,27010,27228,54238,27431,27698,55129,22085
2566,56,พะเยา,5604,อำเภอเชียงม่วน,4662,4766,9428,4686,4804,9490,4035
2566,56,พะเยา,5605,อำเภอดอกคำใต้,18180,19180,37360,18225,19231,37456,15217
2566,56,พะเยา,5606,อำเภอปง,19526,19485,39011,19623,19593,39216,12882
2566,56,พะเยา,5607,อำเภอแม่ใจ,9597,10235,19832,9617,10254,19871,9543
2566,56,พะเยา,5608,อำเภอภูซาง,11859,12055,23914,11979,12261,24240,9844
2566,56,พะเยา,5609,อำเภอภูกามยาว,5928,6488,12416,5949,6499,12448,5188
2566,56,พะเยา,5677,ท้องถิ่นเทศบาลตำบลบ้านต๋อม,5683,6684,12367,5799,6776,12575,7574
2566,56,พะเยา,5678,ท้องถิ่นเทศบาลตำบลห้วยลาน,4085,4479,8564,4096,4493,8589,3409
2566,56,พะเยา,5679,ท้องถิ่นเทศบาลตำบลฝายกวาง,4197,4455,8652,4215,4479,8694,3826
2566,56,พะเยา,5680,ท้องถิ่นเทศบาลตำบลเวียงลอ,2885,3113,5998,2892,3121,6013,2718
2566,56,พะเยา,5681,ท้องถิ่นเทศบาลตำบลหงส์หิน,3145,3399,6544,3155,3406,6561,2858
2566,56,พะเยา,5682,ท้องถิ่นเทศบาลตำบลจุน,4298,4561,8859,4316,4570,8886,4082
2566,56,พะเยา,5683,ท้องถิ่นเทศบาลตำบลบ้านเหล่า,3681,3893,7574,3687,3899,7586,3034
2566,56,พะเยา,5684,ท้องถิ่นเทศบาลตำบลแม่กา,6037,6630,12667,6069,6660,12729,7148
2566,56,พะเยา,5685,ท้องถิ่นเทศบาลตำบลแม่ปืม,4305,4533,8838,4308,4542,8850,3522
2566,56,พะเยา,5686,ท้องถิ่นเทศบาลตำบลบ้านต๊ำ,3373,3594,6967,3383,3601,6984,3334
2566,56,พะเยา,5687,ท้องถิ่นเทศบาลตำบลท่าวังทอง,7930,7749,15679,7954,7762,15716,9978
2566,56,พะเยา,5688,ท้องถิ่นเทศบาลตำบลดงเจน,3751,4283,8034,3762,4292,8054,3675
2566,56,พะเยา,5689,ท้องถิ่นเทศบาลตำบลสบบง,3923,4196,8119,3948,4245,8193,3610
2566,56,พะเยา,5690,ท้องถิ่นเทศบาลตำบลแม่ใจ,2310,2516,4826,2313,2518,4831,2227
2566,56,พะเยา,5691,ท้องถิ่นเทศบาลตำบลปง,2554,2844,5398,2565,2850,5415,2848
2566,56,พะเยา,5692,ท้องถิ่นเทศบาลตำบลงิม,3230,3277,6507,3233,3283,6516,2532
2566,56,พะเยา,5693,ท้องถิ่นเทศบาลเมืองดอกคำใต้,5625,6555,12180,5640,6567,12207,5454
2566,56,พะเยา,5694,ท้องถิ่นเทศบาลตำบลบ้านถ้ำ,4032,4024,8056,4034,4026,8060,3391
2566,56,พะเยา,5695,ท้องถิ่นเทศบาลตำบลเชียงม่วน,4163,4311,8474,4171,4319,8490,3940
2566,56,พะเยา,5696,ท้องถิ่นเทศบาลตำบลเวียง,2585,2756,5341,2589,2763,5352,2320
2566,56,พะเยา,5697,ท้องถิ่นเทศบาลตำบลเชียงคำ,2718,3313,6031,2729,3333,6062,3759
2566,56,พะเยา,5698,ท้องถิ่นเทศบาลตำบลห้วยข้าวก่ำ,3826,4207,8033,3833,4220,8053,4432
2566,56,พะเยา,5699,ท้องถิ่นเทศบาลเมืองพะเยา,7156,8428,15584,7193,8453,15646,8351
2566,57,เชียงราย,5701,อำเภอเมืองเชียงราย,49373,54025,103398,52379,57205,109584,55563
2566,57,เชียงราย,5702,อำเภอเวียงชัย,18674,19898,38572,18813,20012,38825,16280
2566,57,เชียงราย,5703,อำเภอเชียงของ,11914,12009,23923,12279,12690,24969,10895
2566,57,เชียงราย,5704,อำเภอเทิง,36048,36878,72926,36677,37561,74238,29790
2566,57,เชียงราย,5705,อำเภอพาน,52448,55800,108248,53242,56624,109866,49558
2566,57,เชียงราย,5706,อำเภอป่าแดด,5754,5900,11654,5762,5908,11670,4193
2566,57,เชียงราย,5707,อำเภอแม่จัน,29160,31113,60273,33838,36372,70210,29374
2566,57,เชียงราย,5708,อำเภอเชียงแสน,21026,21612,42638,23980,25230,49210,19475
2566,57,เชียงราย,5709,อำเภอแม่สาย,22551,24312,46863,35964,40403,76367,30897
2566,57,เชียงราย,5710,อำเภอแม่สรวย,36649,36244,72893,39472,39177,78649,30428
2566,57,เชียงราย,5711,อำเภอเวียงป่าเป้า,28473,29217,57690,29981,30667,60648,25407
2566,57,เชียงราย,5712,อำเภอพญาเม็งราย,13369,13600,26969,13539,13782,27321,10149
2566,57,เชียงราย,5713,อำเภอเวียงแก่น,17526,16794,34320,19097,18784,37881,14192
2566,57,เชียงราย,5714,อำเภอขุนตาล,6824,7123,13947,6858,7151,14009,5724
2566,57,เชียงราย,5715,อำเภอแม่ฟ้าหลวง,29104,28293,57397,38621,39076,77697,26255
2566,57,เชียงราย,5716,อำเภอแม่ลาว,11720,12581,24301,11819,12687,24506,11473
2566,57,เชียงราย,5717,อำเภอเวียงเชียงรุ้ง,11627,12025,23652,11677,12058,23735,9609
2566,57,เชียงราย,5718,อำเภอดอยหลวง,9169,9117,18286,9293,9276,18569,8940
2566,57,เชียงราย,5764,ท้องถิ่นเทศบาลตำบลแม่ยาว,8825,8993,17818,10877,11175,22052,9580
2566,57,เชียงราย,5765,ท้องถิ่นเทศบาลตำบลห้วยซ้อ,5914,5881,11795,6040,6114,12154,5356
2566,57,เชียงราย,5766,ท้องถิ่นเทศบาลตำบลไม้ยา,5212,5222,10434,5219,5230,10449,3921
2566,57,เชียงราย,5767,ท้องถิ่นเทศบาลตำบลครึ่ง,3083,3119,6202,3099,3135,6234,2752
2566,57,เชียงราย,5768,ท้องถิ่นเทศบาลตำบลป่าอ้อดอนชัย,5313,5917,11230,5461,6061,11522,5803
2566,57,เชียงราย,5769,ท้องถิ่นเทศบาลตำบลยางฮอม,5229,5464,10693,5272,5510,10782,4112
2566,57,เชียงราย,5770,ท้องถิ่นเทศบาลตำบลเวียง,4580,4634,9214,4804,4965,9769,4466
2566,57,เชียงราย,5771,ท้องถิ่นเทศบาลตำบลนางแล,5299,5945,11244,5914,6536,12450,6646
2566,57,เชียงราย,5772,ท้องถิ่นเทศบาลตำบลป่าซาง,4844,5446,10290,5463,6145,11608,5828
2566,57,เชียงราย,5773,ท้องถิ่นเทศบาลตำบลเวียงพางคำ,5132,5349,10481,10739,12343,23082,10316
2566,57,เชียงราย,5774,ท้องถิ่นเทศบาลตำบลบ้านดู่,9112,10562,19674,10196,11656,21852,15319
2566,57,เชียงราย,5775,ท้องถิ่นเทศบาลตำบลบ้านเหล่า,1974,1995,3969,1975,1997,3972,1784
2566,57,เชียงราย,5776,ท้องถิ่นเทศบาลตำบลแม่ลาว,831,921,1752,835,926,1761,835
2566,57,เชียงราย,5777,ท้องถิ่นเทศบาลตำบลป่าก่อดำ,1957,2203,4160,1981,2215,4196,2069
2566,57,เชียงราย,5778,ท้องถิ่นเทศบาลตำบลบ้านต้า,2827,3062,5889,2834,3068,5902,2307
2566,57,เชียงราย,5779,ท้องถิ่นเทศบาลตำบลพญาเม็งราย,1902,2101,4003,1963,2143,4106,2305
2566,57,เชียงราย,5780,ท้องถิ่นเทศบาลตำบลเวียงป่าเป้า,1899,2260,4159,1935,2308,4243,2425
2566,57,เชียงราย,5781,ท้องถิ่นเทศบาลตำบลแม่ขะจาน,1314,1493,2807,1320,1498,2818,1625
2566,57,เชียงราย,5782,ท้องถิ่นเทศบาลตำบลเจดีย์หลวง,2269,2337,4606,2287,2354,4641,2190
2566,57,เชียงราย,5783,ท้องถิ่นเทศบาลตำบลแม่สรวย,652,707,1359,704,751,1455,1144
2566,57,เชียงราย,5784,ท้องถิ่นเทศบาลตำบลห้วยไคร้,2057,2304,4361,2291,2642,4933,2566
2566,57,เชียงราย,5785,ท้องถิ่นเทศบาลตำบลแม่สาย,8338,8787,17125,12792,14721,27513,13849
2566,57,เชียงราย,5786,ท้องถิ่นเทศบาลตำบลเวียงเชียงแสน,2217,2509,4726,2937,3284,6221,3408
2566,57,เชียงราย,5787,ท้องถิ่นเทศบาลตำบลสันทราย,1194,1354,2548,1261,1408,2669,1300
2566,57,เชียงราย,5788,ท้องถิ่นเทศบาลตำบลแม่จัน,1405,1622,3027,1635,1894,3529,2496
2566,57,เชียงราย,5789,ท้องถิ่นเทศบาลตำบลแม่คำ,2045,2303,4348,2079,2338,4417,2203
2566,57,เชียงราย,5790,ท้องถิ่นเทศบาลตำบลจันจว้า,6551,7257,13808,6636,7366,14002,6352
2566,57,เชียงราย,5791,ท้องถิ่นเทศบาลตำบลป่าแดด,3022,3173,6195,3032,3187,6219,2532
2566,57,เชียงราย,5792,ท้องถิ่นเทศบาลตำบลป่าแงะ,3645,3745,7390,3651,3755,7406,3228
2566,57,เชียงราย,5793,ท้องถิ่นเทศบาลตำบลเมืองพาน,2843,3349,6192,2868,3372,6240,3570
2566,57,เชียงราย,5794,ท้องถิ่นเทศบาลตำบลเวียงเทิง,2254,2617,4871,2296,2665,4961,2868
2566,57,เชียงราย,5795,ท้องถิ่นเทศบาลตำบลบ้านปล้อง,1869,2009,3878,1871,2012,3883,1620
2566,57,เชียงราย,5796,ท้องถิ่นเทศบาลตำบลเวียงเชียงของ,1682,1940,3622,1695,1974,3669,2384
2566,57,เชียงราย,5797,ท้องถิ่นเทศบาลตำบลบุญเรือง,2815,2976,5791,2824,2992,5816,2569
2566,57,เชียงราย,5798,ท้องถิ่นเทศบาลตำบลเวียงชัย,3121,3581,6702,3155,3600,6755,3266
2566,57,เชียงราย,5799,ท้องถิ่นเทศบาลนครเชียงราย,32973,37651,70624,36685,41057,77742,52921
2566,58,แม่ฮ่องสอน,5801,อำเภอเมืองแม่ฮ่องสอน,19932,19406,39338,28589,28257,56846,24369
2566,58,แม่ฮ่องสอน,5802,อำเภอขุนยวม,9654,9245,18899,10409,9898,20307,8115
2566,58,แม่ฮ่องสอน,5803,อำเภอปาย,15448,14556,30004,18202,17092,35294,15931
2566,58,แม่ฮ่องสอน,5804,อำเภอแม่สะเรียง,25058,24992,50050,26487,26299,52786,22549
2566,58,แม่ฮ่องสอน,5805,อำเภอแม่ลาน้อย,16078,15960,32038,16179,16029,32208,11238
2566,58,แม่ฮ่องสอน,5806,อำเภอสบเมย,18646,18168,36814,24235,23549,47784,18005
2566,58,แม่ฮ่องสอน,5807,อำเภอปางมะผ้า,9110,8657,17767,11526,10792,22318,9263
2566,58,แม่ฮ่องสอน,5895,ท้องถิ่นเทศบาลตำบลแม่ลาน้อย,1710,1751,3461,1736,1772,3508,1848
2566,58,แม่ฮ่องสอน,5896,ท้องถิ่นเทศบาลตำบลแม่สะเรียง,1109,1312,2421,1274,1449,2723,2017
2566,58,แม่ฮ่องสอน,5897,ท้องถิ่นเทศบาลตำบลปาย,1054,1150,2204,1668,1719,3387,1930
2566,58,แม่ฮ่องสอน,5898,ท้องถิ่นเทศบาลตำบลขุนยวม,1589,1672,3261,1731,1797,3528,1839
2566,58,แม่ฮ่องสอน,5899,ท้องถิ่นเทศบาลเมืองแม่ฮ่องสอน,3100,3222,6322,3464,3491,6955,4792
2566,60,นครสวรรค์,6001,อำเภอเมืองนครสวรรค์,77703,83638,161341,77915,83745,161660,74212
2566,60,นครสวรรค์,6002,อำเภอโกรกพระ,12811,13551,26362,12827,13561,26388,9989
2566,60,นครสวรรค์,6003,อำเภอชุมแสง,25320,26979,52299,25349,26996,52345,18841
2566,60,นครสวรรค์,6004,อำเภอหนองบัว,26553,27056,53609,26573,27066,53639,23985
2566,60,นครสวรรค์,6005,อำเภอบรรพตพิสัย,38990,40709,79699,39059,40743,79802,29273
2566,60,นครสวรรค์,6006,อำเภอเก้าเลี้ยว,13759,14501,28260,13778,14514,28292,10891
2566,60,นครสวรรค์,6007,อำเภอตาคลี,37499,38606,76105,37548,38646,76194,30790
2566,60,นครสวรรค์,6008,อำเภอท่าตะโก,28972,30373,59345,29010,30388,59398,24152
2566,60,นครสวรรค์,6009,อำเภอไพศาลี,29295,29912,59207,29307,29930,59237,21881
2566,60,นครสวรรค์,6010,อำเภอพยุหะคีรี,23871,25461,49332,23911,25480,49391,21792
2566,60,นครสวรรค์,6011,อำเภอลาดยาว,35467,36905,72372,35504,36936,72440,28535
2566,60,นครสวรรค์,6012,อำเภอตากฟ้า,16530,17083,33613,16540,17089,33629,13042
2566,60,นครสวรรค์,6013,อำเภอแม่วงก์,24484,24751,49235,24514,24761,49275,19141
2566,60,นครสวรรค์,6014,อำเภอแม่เปิน,10387,10328,20715,10393,10329,20722,6369
2566,60,นครสวรรค์,6015,อำเภอชุมตาบง,8833,8926,17759,8837,8928,17765,6617
2566,60,นครสวรรค์,6082,ท้องถิ่นเทศบาลตำบลตากฟ้า,2501,2711,5212,2509,2717,5226,2835
2566,60,นครสวรรค์,6083,ท้องถิ่นเทศบาลตำบลลาดยาว,2678,3047,5725,2689,3056,5745,3522
2566,60,นครสวรรค์,6084,ท้องถิ่นเทศบาลตำบลศาลเจ้าไก่ต่อ,1513,1707,3220,1514,1711,3225,1495
2566,60,นครสวรรค์,6085,ท้องถิ่นเทศบาลตำบลพยุหะ,2484,2915,5399,2497,2923,5420,3046
2566,60,นครสวรรค์,6086,ท้องถิ่นเทศบาลตำบลท่าน้ำอ้อยม่วงหัก,2312,2577,4889,2320,2580,4900,2794
2566,60,นครสวรรค์,6087,ท้องถิ่นเทศบาลตำบลไพศาลี,4746,5262,10008,4757,5267,10024,5090
2566,60,นครสวรรค์,6088,ท้องถิ่นเทศบาลตำบลท่าตะโก,2495,2849,5344,2506,2863,5369,2925
2566,60,นครสวรรค์,6089,ท้องถิ่นเทศบาลตำบลช่องแค,1383,1538,2921,1385,1538,2923,1084
2566,60,นครสวรรค์,6090,ท้องถิ่นเทศบาลตำบลเก้าเลี้ยว,2672,2917,5589,2686,2923,5609,2376
2566,60,นครสวรรค์,6091,ท้องถิ่นเทศบาลตำบลบรรพตพิสัย,1716,1909,3625,1721,1909,3630,1881
2566,60,นครสวรรค์,6092,ท้องถิ่นเทศบาลเมืองหนองบัว,5374,5995,11369,5379,6008,11387,5178
2566,60,นครสวรรค์,6093,ท้องถิ่นเทศบาลตำบลทับกฤช,994,1076,2070,996,1077,2073,836
2566,60,นครสวรรค์,6094,ท้องถิ่นเทศบาลตำบลบางประมุง,2432,2518,4950,2438,2519,4957,1637
2566,60,นครสวรรค์,6095,ท้องถิ่นเทศบาลตำบลโกรกพระ,1054,1135,2189,1055,1137,2192,1010
2566,60,นครสวรรค์,6096,ท้องถิ่นเทศบาลตำบลหนองเบน,1303,1570,2873,1306,1576,2882,1533
2566,60,นครสวรรค์,6097,ท้องถิ่นเทศบาลเมืองตาคลี,10544,11632,22176,10588,11663,22251,10151
2566,60,นครสวรรค์,6098,ท้องถิ่นเทศบาลเมืองชุมแสง,3405,3810,7215,3412,3817,7229,3655
2566,60,นครสวรรค์,6099,ท้องถิ่นเทศบาลนครนครสวรรค์,36115,39748,75863,36552,40112,76664,43257
2566,61,อุทัยธานี,6101,อำเภอเมืองอุทัยธานี,16873,18402,35275,16890,18418,35308,14390
2566,61,อุทัยธานี,6102,อำเภอทัพทัน,7701,8087,15788,7708,8092,15800,5650
2566,61,อุทัยธานี,6103,อำเภอสว่างอารมณ์,14760,14858,29618,14768,14877,29645,10227
2566,61,อุทัยธานี,6104,อำเภอหนองฉาง,16306,17324,33630,16319,17336,33655,12261
2566,61,อุทัยธานี,6105,อำเภอหนองขาหย่าง,7156,8041,15197,7160,8042,15202,6116
2566,61,อุทัยธานี,6106,อำเภอบ้านไร่,31243,31756,62999,31314,31828,63142,25806
2566,61,อุทัยธานี,6107,อำเภอลานสัก,27281,27724,55005,27321,27775,55096,19647
2566,61,อุทัยธานี,6108,อำเภอห้วยคต,9930,10200,20130,9954,10210,20164,7723
2566,61,อุทัยธานี,6189,ท้องถิ่นเทศบาลตำบลหนองสระ,994,1129,2123,994,1129,2123,692
2566,61,อุทัยธานี,6190,ท้องถิ่นเทศบาลตำบลลานสัก,1641,1661,3302,1645,1664,3309,2215
2566,61,อุทัยธานี,6191,ท้องถิ่นเทศบาลตำบลเมืองการุ้ง,994,1107,2101,997,1109,2106,1071
2566,61,อุทัยธานี,6192,ท้องถิ่นเทศบาลตำบลบ้านไร่,1202,1254,2456,1204,1256,2460,1435
2566,61,อุทัยธานี,6193,ท้องถิ่นเทศบาลตำบลหนองขาหย่าง,270,301,571,270,301,571,341
2566,61,อุทัยธานี,6194,ท้องถิ่นเทศบาลตำบลหนองฉาง,1258,1428,2686,1259,1430,2689,1966
2566,61,อุทัยธานี,6195,ท้องถิ่นเทศบาลตำบลเขาบางแกรก,2917,3187,6104,2922,3188,6110,2457
2566,61,อุทัยธานี,6196,ท้องถิ่นเทศบาลตำบลสว่างอารมณ์,759,824,1583,763,825,1588,1014
2566,61,อุทัยธานี,6197,ท้องถิ่นเทศบาลตำบลทัพทัน,4141,4522,8663,4148,4528,8676,3791
2566,61,อุทัยธานี,6198,ท้องถิ่นเทศบาลตำบลตลุกดู่,5434,5702,11136,5437,5708,11145,3770
2566,61,อุทัยธานี,6199,ท้องถิ่นเทศบาลเมืองอุทัยธานี,6154,7263,13417,6193,7291,13484,9746
2566,62,กำแพงเพชร,6201,อำเภอเมืองกำแพงเพชร,66265,68595,134860,66367,68666,135033,54935
2566,62,กำแพงเพชร,6202,อำเภอไทรงาม,22213,22525,44738,22236,22540,44776,15352
2566,62,กำแพงเพชร,6203,อำเภอคลองลาน,19955,19459,39414,20012,19498,39510,15528
2566,62,กำแพงเพชร,6204,อำเภอขาณุวรลักษบุรี,33583,34212,67795,33613,34230,67843,26443
2566,62,กำแพงเพชร,6205,อำเภอคลองขลุง,26940,28052,54992,27021,28115,55136,24171
2566,62,กำแพงเพชร,6206,อำเภอพรานกระต่าย,24182,24278,48460,24195,24287,48482,16699
2566,62,กำแพงเพชร,6207,อำเภอลานกระบือ,16203,16211,32414,16214,16232,32446,11520
2566,62,กำแพงเพชร,6208,อำเภอทรายทองวัฒนา,6865,6878,13743,6873,6884,13757,4272
2566,62,กำแพงเพชร,6209,อำเภอปางศิลาทอง,14974,14988,29962,15004,15010,30014,11550
2566,62,กำแพงเพชร,6210,อำเภอบึงสามัคคี,9009,9072,18081,9025,9085,18110,7540
2566,62,กำแพงเพชร,6211,อำเภอโกสัมพีนคร,13881,13894,27775,13895,13899,27794,11088
2566,62,กำแพงเพชร,6278,ท้องถิ่นเทศบาลเมืองปางมะค่า,8695,8733,17428,8706,8743,17449,6940
2566,62,กำแพงเพชร,6279,ท้องถิ่นเทศบาลตำบลบ้านพราน,3509,3510,7019,3529,3528,7057,3018
2566,62,กำแพงเพชร,6280,ท้องถิ่นเทศบาลตำบลระหาน,3499,3640,7139,3529,3669,7198,3671
2566,62,กำแพงเพชร,6281,ท้องถิ่นเทศบาลตำบลคลองพิไกร,2823,2971,5794,2827,2975,5802,2298
2566,62,กำแพงเพชร,6282,ท้องถิ่นเทศบาลตำบลนิคมทุ่งโพธิ์ทะเล,4444,4614,9058,4453,4625,9078,3732
2566,62,กำแพงเพชร,6283,ท้องถิ่นเทศบาลตำบลวังยาง,2635,2733,5368,2643,2743,5386,2165
2566,62,กำแพงเพชร,6284,ท้องถิ่นเทศบาลตำบลทุ่งทราย,4178,4350,8528,4186,4357,8543,3334
2566,62,กำแพงเพชร,6285,ท้องถิ่นเทศบาลตำบลเทพนคร,9759,10299,20058,9772,10311,20083,8706
2566,62,กำแพงเพชร,6286,ท้องถิ่นเทศบาลตำบลคลองลานพัฒนา,10848,11263,22111,10888,11317,22205,8707
2566,62,กำแพงเพชร,6287,ท้องถิ่นเทศบาลตำบลช่องลม,2844,2868,5712,2847,2870,5717,1833
2566,62,กำแพงเพชร,6288,ท้องถิ่นเทศบาลตำบลลานกระบือ,2080,2131,4211,2097,2148,4245,2607
2566,62,กำแพงเพชร,6289,ท้องถิ่นเทศบาลตำบลพรานกระต่าย,3982,4387,8369,3985,4391,8376,3763
2566,62,กำแพงเพชร,6290,ท้องถิ่นเทศบาลตำบลท่ามะเขือ,1744,1876,3620,1757,1882,3639,2062
2566,62,กำแพงเพชร,6291,ท้องถิ่นเทศบาลตำบลท่าพุทรา,720,764,1484,722,764,1486,653
2566,62,กำแพงเพชร,6292,ท้องถิ่นเทศบาลตำบลคลองขลุง,907,966,1873,927,979,1906,1040
2566,62,กำแพงเพชร,6293,ท้องถิ่นเทศบาลตำบลสลกบาตร,3770,4119,7889,3790,4149,7939,4520
2566,62,กำแพงเพชร,6294,ท้องถิ่นเทศบาลตำบลขาณุวรลักษบุรี,3745,4001,7746,3810,4066,7876,3507
2566,62,กำแพงเพชร,6295,ท้องถิ่นเทศบาลตำบลไทรงาม,2324,2577,4901,2331,2590,4921,2548
2566,62,กำแพงเพชร,6296,ท้องถิ่นเทศบาลตำบลปากดง,1486,1631,3117,1488,1633,3121,1356
2566,62,กำแพงเพชร,6297,ท้องถิ่นเทศบาลตำบลนครชุม,3127,3566,6693,3137,3569,6706,3566
2566,62,กำแพงเพชร,6298,ท้องถิ่นเทศบาลตำบลคลองแม่ลาย,2762,2943,5705,2768,2950,5718,2507
2566,62,กำแพงเพชร,6299,ท้องถิ่นเทศบาลเมืองกำแพงเพชร,12763,14521,27284,12932,14664,27596,16760
2566,63,ตาก,6301,อำเภอเมืองตาก,36785,37387,74172,36891,37479,74370,29559
2566,63,ตาก,6302,อำเภอบ้านตาก,15223,15608,30831,15273,15643,30916,11252
2566,63,ตาก,6303,อำเภอสามเงา,12410,12758,25168,12425,12775,25200,9732
2566,63,ตาก,6304,อำเภอแม่ระมาด,21416,20777,42193,26021,24663,50684,17637
2566,63,ตาก,6305,อำเภอท่าสองยาง,36202,34619,70821,48687,45924,94611,25337
2566,63,ตาก,6306,อำเภอแม่สอด,39073,39369,78442,51949,50858,102807,39172
2566,63,ตาก,6307,อำเภอพบพระ,31213,30567,61780,45857,44104,89961,21495
2566,63,ตาก,6308,อำเภออุ้มผาง,16519,15505,32024,24222,22401,46623,12096
2566,63,ตาก,6309,อำเภอวังเจ้า,14713,14585,29298,15286,15168,30454,9564
2566,63,ตาก,6386,ท้องถิ่นเทศบาลตำบลไม้งาม,6268,5201,11469,6284,5217,11501,6554
2566,63,ตาก,6387,ท้องถิ่นเทศบาลตำบลวังเจ้า,2087,2100,4187,2090,2104,4194,1988
2566,63,ตาก,6388,ท้องถิ่นเทศบาลตำบลอุ้มผาง,818,828,1646,2348,2209,4557,940
2566,63,ตาก,6389,ท้องถิ่นเทศบาลตำบลพบพระ,2460,2369,4829,3600,3397,6997,2897
2566,63,ตาก,6390,ท้องถิ่นเทศบาลตำบลแม่กุ,3112,3262,6374,3217,3372,6589,3170
2566,63,ตาก,6391,ท้องถิ่นเทศบาลตำบลท่าสายลวด,3092,3064,6156,12534,11843,24377,4973
2566,63,ตาก,6392,ท้องถิ่นเทศบาลตำบลแม่ต้าน,1290,1347,2637,2147,2233,4380,1436
2566,63,ตาก,6393,ท้องถิ่นเทศบาลตำบลแม่ระมาด,1784,1823,3607,1927,1955,3882,1898
2566,63,ตาก,6394,ท้องถิ่นเทศบาลตำบลแม่จะเรา,2435,2585,5020,2476,2636,5112,2183
2566,63,ตาก,6395,ท้องถิ่นเทศบาลตำบลสามเงา,2094,2307,4401,2104,2309,4413,2202
2566,63,ตาก,6396,ท้องถิ่นเทศบาลตำบลบ้านตาก,2899,3400,6299,2923,3417,6340,2757
2566,63,ตาก,6397,ท้องถิ่นเทศบาลตำบลทุ่งกระเชาะ,2937,2983,5920,2940,2989,5929,2172
2566,63,ตาก,6398,ท้องถิ่นเทศบาลนครแม่สอด,12575,13707,26282,21135,21381,42516,20310
2566,63,ตาก,6399,ท้องถิ่นเทศบาลเมืองตาก,7008,7994,15002,7168,8133,15301,7578
2566,64,สุโขทัย,6401,อำเภอเมืองสุโขทัย,28948,31328,60276,28986,31344,60330,23550
2566,64,สุโขทัย,6402,อำเภอบ้านด่านลานหอย,21895,22151,44046,22009,22248,44257,14936
2566,64,สุโขทัย,6403,อำเภอคีรีมาศ,22629,23171,45800,22648,23186,45834,14797
2566,64,สุโขทัย,6404,อำเภอกงไกรลาศ,28443,29998,58441,28462,30009,58471,21033
2566,64,สุโขทัย,6405,อำเภอศรีสัชนาลัย,33939,35174,69113,33990,35220,69210,27566
2566,64,สุโขทัย,6406,อำเภอศรีสำโรง,28992,31471,60463,29028,31492,60520,23065
2566,64,สุโขทัย,6407,อำเภอสวรรคโลก,23706,25755,49461,23725,25766,49491,20594
2566,64,สุโขทัย,6408,อำเภอศรีนคร,10693,11370,22063,10709,11377,22086,8346
2566,64,สุโขทัย,6409,อำเภอทุ่งเสลี่ยม,20320,20913,41233,20360,20935,41295,15238
2566,64,สุโขทัย,6484,ท้องถิ่นเทศบาลตำบลในเมือง,3958,4169,8127,3962,4173,8135,3466
2566,64,สุโขทัย,6485,ท้องถิ่นเทศบาลตำบลป่ากุมเกาะ,3661,3924,7585,3662,3926,7588,2840
2566,64,สุโขทัย,6486,ท้องถิ่นเทศบาลตำบลบ้านกล้วย,7447,8401,15848,7458,8417,15875,7396
2566,64,สุโขทัย,6487,ท้องถิ่นเทศบาลตำบลทุ่งเสลี่ยม,3355,3723,7078,3364,3731,7095,3088
2566,64,สุโขทัย,6488,ท้องถิ่นเทศบาลตำบลศรีนคร,1382,1603,2985,1387,1607,2994,1716
2566,64,สุโขทัย,6489,ท้องถิ่นเทศบาลตำบลศรีสำโรง,3256,3813,7069,3262,3819,7081,3579
2566,64,สุโขทัย,6490,ท้องถิ่นเทศบาลตำบลหาดเสี้ยว,3011,3389,6400,3016,3394,6410,3689
2566,64,สุโขทัย,6491,ท้องถิ่นเทศบาลเมืองศรีสัชนาลัย,7042,7715,14757,7043,7716,14759,5944
2566,64,สุโขทัย,6492,ท้องถิ่นเทศบาลตำบลกงไกรลาศ,1892,2099,3991,1893,2100,3993,2073
2566,64,สุโขทัย,6493,ท้องถิ่นเทศบาลตำบลบ้านโตนด,1383,1563,2946,1386,1563,2949,1665
2566,64,สุโขทัย,6494,ท้องถิ่นเทศบาลตำบลทุ่งหลวง,3316,3654,6970,3317,3654,6971,2454
2566,64,สุโขทัย,6495,ท้องถิ่นเทศบาลตำบลลานหอย,1660,1799,3459,1667,1800,3467,1757
2566,64,สุโขทัย,6496,ท้องถิ่นเทศบาลตำบลเมืองเก่า,3270,3811,7081,3276,3811,7087,2687
2566,64,สุโขทัย,6497,ท้องถิ่นเทศบาลตำบลบ้านสวน,1984,2191,4175,1984,2192,4176,1728
2566,64,สุโขทัย,6498,ท้องถิ่นเทศบาลเมืองสวรรคโลก,6692,7618,14310,6713,7632,14345,6826
2566,64,สุโขทัย,6499,ท้องถิ่นเทศบาลเมืองสุโขทัยธานี,6224,7192,13416,6248,7199,13447,7175
2566,65,พิษณุโลก,6501,อำเภอเมืองพิษณุโลก,86895,93662,180557,87086,93743,180829,90481
2566,65,พิษณุโลก,6502,อำเภอนครไทย,32993,33493,66486,33058,33555,66613,24478
2566,65,พิษณุโลก,6503,อำเภอชาติตระการ,18277,17921,36198,18331,17964,36295,12739
2566,65,พิษณุโลก,6504,อำเภอบางระกำ,36255,37544,73799,36317,37613,73930,26952
2566,65,พิษณุโลก,6505,อำเภอบางกระทุ่ม,15634,16581,32215,15644,16600,32244,12196
2566,65,พิษณุโลก,6506,อำเภอพรหมพิราม,38957,41002,79959,38994,41021,80015,31473
2566,65,พิษณุโลก,6507,อำเภอวัดโบสถ์,14489,14787,29276,14501,14801,29302,11573
2566,65,พิษณุโลก,6508,อำเภอวังทอง,55840,57475,113315,56114,57647,113761,45464
2566,65,พิษณุโลก,6509,อำเภอเนินมะปราง,18960,19170,38130,18980,19184,38164,15266
2566,65,พิษณุโลก,6580,ท้องถิ่นเทศบาลเมืองอรัญญิก,15838,13333,29171,15884,13358,29242,14544
2566,65,พิษณุโลก,6581,ท้องถิ่นเทศบาลตำบลบ้านมุง,3393,3467,6860,3403,3472,6875,2734
2566,65,พิษณุโลก,6582,ท้องถิ่นเทศบาลตำบลบึงระมาณ,2124,2270,4394,2127,2274,4401,1721
2566,65,พิษณุโลก,6583,ท้องถิ่นเทศบาลตำบลพลายชุมพล,3732,4205,7937,3742,4209,7951,4510
2566,65,พิษณุโลก,6584,ท้องถิ่นเทศบาลตำบลพันเสา,2962,3024,5986,2967,3027,5994,2134
2566,65,พิษณุโลก,6585,ท้องถิ่นเทศบาลตำบลไทรย้อย,4112,4221,8333,4120,4222,8342,3250
2566,65,พิษณุโลก,6586,ท้องถิ่นเทศบาลตำบลบ้านแยง,5062,4941,10003,5090,4966,10056,5181
2566,65,พิษณุโลก,6587,ท้องถิ่นเทศบาลตำบลเนินมะปราง,1627,1785,3412,1637,1786,3423,1682
2566,65,พิษณุโลก,6588,ท้องถิ่นเทศบาลตำบลวังทอง,1885,2154,4039,1890,2157,4047,1740
2566,65,พิษณุโลก,6589,ท้องถิ่นเทศบาลตำบลวัดโบสถ์,3735,4190,7925,3741,4192,7933,4141
2566,65,พิษณุโลก,6590,ท้องถิ่นเทศบาลตำบลวงฆ้อง,1463,1543,3006,1467,1543,3010,1588
2566,65,พิษณุโลก,6591,ท้องถิ่นเทศบาลตำบลพรหมพิราม,496,592,1088,502,595,1097,553
2566,65,พิษณุโลก,6592,ท้องถิ่นเทศบาลตำบลบางกระทุ่ม,677,697,1374,680,698,1378,625
2566,65,พิษณุโลก,6593,ท้องถิ่นเทศบาลตำบลเนินกุ่ม,5662,5962,11624,5673,5965,11638,4667
2566,65,พิษณุโลก,6594,ท้องถิ่นเทศบาลตำบลปลักแรด,1661,1823,3484,1665,1825,3490,1338
2566,65,พิษณุโลก,6595,ท้องถิ่นเทศบาลตำบลบางระกำ,1931,2144,4075,1934,2148,4082,2030
2566,65,พิษณุโลก,6596,ท้องถิ่นเทศบาลตำบลป่าแดง,2570,2692,5262,2576,2697,5273,2649
2566,65,พิษณุโลก,6597,ท้องถิ่นเทศบาลตำบลนครไทย,4224,4559,8783,4239,4565,8804,4210
2566,65,พิษณุโลก,6598,ท้องถิ่นเทศบาลตำบลบ้านใหม่,897,996,1893,899,998,1897,816
2566,65,พิษณุโลก,6599,ท้องถิ่นเทศบาลนครพิษณุโลก,27608,33717,61325,27797,33846,61643,37786
2566,66,พิจิตร,6601,อำเภอเมืองพิจิตร,35101,37483,72584,35141,37503,72644,27471
2566,66,พิจิตร,6602,อำเภอวังทรายพูน,8459,8655,17114,8467,8663,17130,6066
2566,66,พิจิตร,6603,อำเภอโพธิ์ประทับช้าง,16627,17116,33743,16646,17135,33781,11912
2566,66,พิจิตร,6604,อำเภอตะพานหิน,21413,22609,44022,21441,22621,44062,16397
2566,66,พิจิตร,6605,อำเภอบางมูลนาก,9663,10373,20036,9673,10381,20054,8123
2566,66,พิจิตร,6606,อำเภอโพทะเล,26277,27439,53716,26307,27458,53765,19290
2566,66,พิจิตร,6607,อำเภอสามง่าม,12544,12796,25340,12548,12801,25349,8979
2566,66,พิจิตร,6608,อำเภอทับคล้อ,16289,16930,33219,16296,16939,33235,13036
2566,66,พิจิตร,6609,อำเภอสากเหล็ก,8815,8929,17744,8822,8936,17758,6286
2566,66,พิจิตร,6610,อำเภอบึงนาราง,13999,14571,28570,14017,14589,28606,11053
2566,66,พิจิตร,6611,อำเภอดงเจริญ,8377,8618,16995,8392,8626,17018,6523
2566,66,พิจิตร,6612,อำเภอวชิรบารมี,15204,15620,30824,15215,15631,30846,11352
2566,66,พิจิตร,6676,ท้องถิ่นเทศบาลตำบลหนองพยอม,3275,3419,6694,3277,3419,6696,2389
2566,66,พิจิตร,6677,ท้องถิ่นเทศบาลตำบลหนองปล้อง,1658,1705,3363,1658,1705,3363,1183
2566,66,พิจิตร,6678,ท้องถิ่นเทศบาลตำบลเนินมะกอก,3183,3499,6682,3190,3515,6705,3104
2566,66,พิจิตร,6679,ท้องถิ่นเทศบาลตำบลหอไกร,2835,2982,5817,2843,2994,5837,2766
2566,66,พิจิตร,6680,ท้องถิ่นเทศบาลตำบลดงป่าคำ,2299,2382,4681,2300,2382,4682,1642
2566,66,พิจิตร,6681,ท้องถิ่นเทศบาลตำบลเนินปอ,4470,4539,9009,4470,4541,9011,3197
2566,66,พิจิตร,6682,ท้องถิ่นเทศบาลตำบลสำนักขุนเณร,1075,1081,2156,1077,1086,2163,923
2566,66,พิจิตร,6683,ท้องถิ่นเทศบาลตำบลสากเหล็ก,2452,2677,5129,2455,2680,5135,2426
2566,66,พิจิตร,6684,ท้องถิ่นเทศบาลตำบลทับคล้อ,1972,2162,4134,1977,2165,4142,1800
2566,66,พิจิตร,6685,ท้องถิ่นเทศบาลตำบลเขาทราย,2060,2102,4162,2061,2103,4164,1934
2566,66,พิจิตร,6686,ท้องถิ่นเทศบาลตำบลสามง่าม,2151,2489,4640,2152,2490,4642,2281
2566,66,พิจิตร,6687,ท้องถิ่นเทศบาลตำบลกำแพงดิน,1015,1096,2111,1016,1098,2114,831
2566,66,พิจิตร,6688,ท้องถิ่นเทศบาลตำบลโพทะเล,1122,1216,2338,1124,1217,2341,1034
2566,66,พิจิตร,6689,ท้องถิ่นเทศบาลตำบลท่าเสา,746,734,1480,746,734,1480,535
2566,66,พิจิตร,6690,ท้องถิ่นเทศบาลตำบลวังตะกู,777,766,1543,783,768,1551,660
2566,66,พิจิตร,6691,ท้องถิ่นเทศบาลตำบลบางไผ่,705,754,1459,706,757,1463,645
2566,66,พิจิตร,6692,ท้องถิ่นเทศบาลตำบลโพธิ์ประทับช้าง,4355,4633,8988,4367,4644,9011,3602
2566,66,พิจิตร,6693,ท้องถิ่นเทศบาลตำบลวังทรายพูน,1599,1643,3242,1600,1645,3245,1278
2566,66,พิจิตร,6694,ท้องถิ่นเทศบาลตำบลหัวดง,1438,1545,2983,1447,1549,2996,1209
2566,66,พิจิตร,6695,ท้องถิ่นเทศบาลตำบลวังกรด,1423,1466,2889,1426,1469,2895,1068
2566,66,พิจิตร,6696,ท้องถิ่นเทศบาลตำบลท่าฬ่อ,1502,1632,3134,1504,1636,3140,1223
2566,66,พิจิตร,6697,ท้องถิ่นเทศบาลเมืองบางมูลนาก,3635,4044,7679,3649,4048,7697,3723
2566,66,พิจิตร,6698,ท้องถิ่นเทศบาลเมืองตะพานหิน,5910,6814,12724,5939,6839,12778,6350
2566,66,พิจิตร,6699,ท้องถิ่นเทศบาลเมืองพิจิตร,9483,10835,20318,9539,10869,20408,12606
2566,67,เพชรบูรณ์,6701,อำเภอเมืองเพชรบูรณ์,78589,79278,157867,78807,79340,158147,64541
2566,67,เพชรบูรณ์,6702,อำเภอชนแดน,33477,33625,67102,33503,33652,67155,28657
2566,67,เพชรบูรณ์,6703,อำเภอหล่มสัก,69276,73235,142511,69406,73273,142679,50718
2566,67,เพชรบูรณ์,6704,อำเภอหล่มเก่า,28766,30229,58995,28806,30267,59073,19554
2566,67,เพชรบูรณ์,6705,อำเภอวิเชียรบุรี,48873,50177,99050,48945,50202,99147,34542
2566,67,เพชรบูรณ์,6706,อำเภอศรีเทพ,27876,28325,56201,27915,28356,56271,20262
2566,67,เพชรบูรณ์,6707,อำเภอหนองไผ่,37220,37816,75036,37260,37848,75108,25892
2566,67,เพชรบูรณ์,6708,อำเภอบึงสามพัน,30703,31341,62044,30758,31373,62131,26507
2566,67,เพชรบูรณ์,6709,อำเภอน้ำหนาว,9529,9162,18691,9540,9166,18706,7488
2566,67,เพชรบูรณ์,6710,อำเภอวังโป่ง,13845,14131,27976,13853,14142,27995,9535
2566,67,เพชรบูรณ์,6711,อำเภอเขาค้อ,17879,17833,35712,18135,18115,36250,12923
2566,67,เพชรบูรณ์,6778,ท้องถิ่นเทศบาลตำบลแคมป์สน,2579,2780,5359,2592,2783,5375,3267
2566,67,เพชรบูรณ์,6779,ท้องถิ่นเทศบาลตำบลโคกสะอาด,3214,3255,6469,3216,3258,6474,2234
2566,67,เพชรบูรณ์,6780,ท้องถิ่นเทศบาลตำบลบัววัฒนา,2883,2878,5761,2884,2878,5762,1940
2566,67,เพชรบูรณ์,6781,ท้องถิ่นเทศบาลตำบลบ่อไทย,4630,4828,9458,4641,4845,9486,3100
2566,67,เพชรบูรณ์,6782,ท้องถิ่นเทศบาลตำบลนางั่ว,5927,6731,12658,6000,6734,12734,5856
2566,67,เพชรบูรณ์,6783,ท้องถิ่นเทศบาลตำบลเฉลียงทอง,3691,3699,7390,3699,3701,7400,2635
2566,67,เพชรบูรณ์,6784,ท้องถิ่นเทศบาลตำบลวังโป่ง,1783,1990,3773,1785,1994,3779,1558
2566,67,เพชรบูรณ์,6785,ท้องถิ่นเทศบาลตำบลท้ายดง,1582,1721,3303,1583,1724,3307,1086
2566,67,เพชรบูรณ์,6786,ท้องถิ่นเทศบาลตำบลซับสมอทอด,4047,4261,8308,4088,4303,8391,5222
2566,67,เพชรบูรณ์,6787,ท้องถิ่นเทศบาลตำบลหนองไผ่,3334,3695,7029,3343,3701,7044,3892
2566,67,เพชรบูรณ์,6788,ท้องถิ่นเทศบาลตำบลนาเฉลียง,1910,2168,4078,1915,2170,4085,1765
2566,67,เพชรบูรณ์,6789,ท้องถิ่นเทศบาลตำบลสว่างวัฒนา,3063,3353,6416,3070,3354,6424,2954
2566,67,เพชรบูรณ์,6790,ท้องถิ่นเทศบาลเมืองวิเชียรบุรี,10276,11459,21735,10378,11486,21864,8999
2566,67,เพชรบูรณ์,6791,ท้องถิ่นเทศบาลตำบลพุเตย,3473,3633,7106,3483,3634,7117,3061
2566,67,เพชรบูรณ์,6792,ท้องถิ่นเทศบาลตำบลหล่มเก่า,2612,2975,5587,2617,2975,5592,2674
2566,67,เพชรบูรณ์,6793,ท้องถิ่นเทศบาลตำบลท่าข้าม,1194,1191,2385,1196,1193,2389,995
2566,67,เพชรบูรณ์,6794,ท้องถิ่นเทศบาลตำบลดงขุย,1163,1304,2467,1165,1304,2469,1080
2566,67,เพชรบูรณ์,6795,ท้องถิ่นเทศบาลตำบลชนแดน,1728,1643,3371,1735,1645,3380,1860
2566,67,เพชรบูรณ์,6796,ท้องถิ่นเทศบาลตำบลวังชมภู,1561,1788,3349,1570,1792,3362,1341
2566,67,เพชรบูรณ์,6797,ท้องถิ่นเทศบาลตำบลท่าพล,3526,3884,7410,3542,3892,7434,2627
2566,67,เพชรบูรณ์,6798,ท้องถิ่นเทศบาลเมืองหล่มสัก,5192,5829,11021,5219,5844,11063,6695
2566,67,เพชรบูรณ์,6799,ท้องถิ่นเทศบาลเมืองเพชรบูรณ์,9183,10588,19771,9221,10607,19828,12856
2566,70,ราชบุรี,7001,อำเภอเมืองราชบุรี,59156,63267,122423,59854,63885,123739,51174
2566,70,ราชบุรี,7002,อำเภอจอมบึง,28369,29311,57680,28607,29537,58144,20460
2566,70,ราชบุรี,7003,อำเภอสวนผึ้ง,15367,14746,30113,24816,22909,47725,15301
2566,70,ราชบุรี,7004,อำเภอดำเนินสะดวก,34802,37214,72016,35083,37460,72543,24205
2566,70,ราชบุรี,7005,อำเภอบ้านโป่ง,46059,50315,96374,46295,50525,96820,39006
2566,70,ราชบุรี,7006,อำเภอบางแพ,8421,9204,17625,8466,9246,17712,6831
2566,70,ราชบุรี,7007,อำเภอโพธาราม,34358,36767,71125,34520,36933,71453,26710
2566,70,ราชบุรี,7008,อำเภอปากท่อ,24481,25629,50110,25028,26138,51166,19607
2566,70,ราชบุรี,7009,อำเภอวัดเพลง,5092,5591,10683,5099,5600,10699,3798
2566,70,ราชบุรี,7010,อำเภอบ้านคา,12136,11804,23940,12825,12315,25140,10007
2566,70,ราชบุรี,7070,ท้องถิ่นเทศบาลตำบลดอนทราย,3282,3654,6936,3340,3694,7034,3265
2566,70,ราชบุรี,7071,ท้องถิ่นเทศบาลตำบลหลุมดิน,2504,2623,5127,2521,2639,5160,1872
2566,70,ราชบุรี,7072,ท้องถิ่นเทศบาลตำบลเบิกไพร,7584,8661,16245,7608,8678,16286,7013
2566,70,ราชบุรี,7073,ท้องถิ่นเทศบาลตำบลทุ่งหลวง,6867,6976,13843,6923,7014,13937,4609
2566,70,ราชบุรี,7074,ท้องถิ่นเทศบาลตำบลบ้านฆ้อง,4052,4554,8606,4084,4582,8666,3755
2566,70,ราชบุรี,7075,ท้องถิ่นเทศบาลตำบลกรับใหญ่,6140,6680,12820,6164,6695,12859,4071
2566,70,ราชบุรี,7076,ท้องถิ่นเทศบาลตำบลบ้านสิงห์,5672,6279,11951,5711,6316,12027,4755
2566,70,ราชบุรี,7077,ท้องถิ่นเทศบาลตำบลวัดเพลง,637,703,1340,648,716,1364,564
2566,70,ราชบุรี,7078,ท้องถิ่นเทศบาลตำบลปากท่อ,1302,1389,2691,1311,1390,2701,1444
2566,70,ราชบุรี,7079,ท้องถิ่นเทศบาลตำบลหนองโพ,1749,2013,3762,1752,2023,3775,2254
2566,70,ราชบุรี,7080,ท้องถิ่นเทศบาลตำบลบ้านเลือก,5257,5784,11041,5281,5810,11091,5519
2566,70,ราชบุรี,7081,ท้องถิ่นเทศบาลตำบลเจ็ดเสมียน,2692,2967,5659,2729,3016,5745,2422
2566,70,ราชบุรี,7082,ท้องถิ่นเทศบาลตำบลเขาขวาง,3508,3749,7257,3513,3758,7271,2722
2566,70,ราชบุรี,7083,ท้องถิ่นเทศบาลตำบลโพหัก,5006,5331,10337,5020,5342,10362,3856
2566,70,ราชบุรี,7084,ท้องถิ่นเทศบาลตำบลบางแพ,7468,8251,15719,7547,8313,15860,6905
2566,70,ราชบุรี,7085,ท้องถิ่นเทศบาลตำบลห้วยกระบอก,775,815,1590,788,821,1609,746
2566,70,ราชบุรี,7086,ท้องถิ่นเทศบาลเมืองท่าผา,9649,10345,19994,9700,10383,20083,8639
2566,70,ราชบุรี,7087,ท้องถิ่นเทศบาลตำบลกระจับ,3638,4056,7694,3696,4098,7794,3966
2566,70,ราชบุรี,7088,ท้องถิ่นเทศบาลตำบลศรีดอนไผ่,4879,5459,10338,4909,5479,10388,3581
2566,70,ราชบุรี,7089,ท้องถิ่นเทศบาลตำบลดำเนินสะดวก,3201,3699,6900,3216,3707,6923,3321
2566,70,ราชบุรี,7090,ท้องถิ่นเทศบาลตำบลสวนผึ้ง,1678,1681,3359,1718,1714,3432,1890
2566,70,ราชบุรี,7091,ท้องถิ่นเทศบาลตำบลบ้านชัฏป่าหวาย,1820,1850,3670,1900,1914,3814,1976
2566,70,ราชบุรี,7092,ท้องถิ่นเทศบาลตำบลด่านทับตะโก,1244,1213,2457,1246,1216,2462,856
2566,70,ราชบุรี,7093,ท้องถิ่นเทศบาลตำบลจอมบึง,2228,2543,4771,2233,2547,4780,3750
2566,70,ราชบุรี,7094,ท้องถิ่นเทศบาลตำบลห้วยชินสีห์,5295,5780,11075,5327,5818,11145,4577
2566,70,ราชบุรี,7095,ท้องถิ่นเทศบาลตำบลหลักเมือง,9106,8013,17119,9162,8055,17217,7539
2566,70,ราชบุรี,7096,ท้องถิ่นเทศบาลตำบลเขางู,4378,4856,9234,4399,4879,9278,3244
2566,70,ราชบุรี,7097,ท้องถิ่นเทศบาลเมืองโพธาราม,3706,4079,7785,3935,4310,8245,3778
2566,70,ราชบุรี,7098,ท้องถิ่นเทศบาลเมืองบ้านโป่ง,6666,7722,14388,6992,8027,15019,8344
2566,70,ราชบุรี,7099,ท้องถิ่นเทศบาลเมืองราชบุรี,14536,17433,31969,15215,18063,33278,16573
2566,71,กาญจนบุรี,7101,อำเภอเมืองกาญจนบุรี,50876,41410,92286,54002,43691,97693,40482
2566,71,กาญจนบุรี,7102,อำเภอไทรโยค,22120,21677,43797,31106,29351,60457,21530
2566,71,กาญจนบุรี,7103,อำเภอบ่อพลอย,24051,24174,48225,24156,24274,48430,19267
2566,71,กาญจนบุรี,7104,อำเภอศรีสวัสดิ์,12290,11715,24005,13351,12559,25910,10512
2566,71,กาญจนบุรี,7105,อำเภอท่ามะกา,43477,46345,89822,43812,46649,90461,32885
2566,71,กาญจนบุรี,7106,อำเภอท่าม่วง,28030,29973,58003,28197,30118,58315,25166
2566,71,กาญจนบุรี,7107,อำเภอทองผาภูมิ,22074,20588,42662,35302,32757,68059,28505
2566,71,กาญจนบุรี,7108,อำเภอสังขละบุรี,11161,10581,21742,22337,20965,43302,12744
2566,71,กาญจนบุรี,7109,อำเภอพนมทวน,15748,16734,32482,15774,16772,32546,11779
2566,71,กาญจนบุรี,7110,อำเภอเลาขวัญ,26673,26892,53565,26754,26953,53707,19370
2566,71,กาญจนบุรี,7111,อำเภอด่านมะขามเตี้ย,15548,15644,31192,15639,15718,31357,11278
2566,71,กาญจนบุรี,7112,อำเภอหนองปรือ,13652,13336,26988,13761,13411,27172,9900
2566,71,กาญจนบุรี,7113,อำเภอห้วยกระเจา,16641,17244,33885,16691,17271,33962,12376
2566,71,กาญจนบุรี,7167,ท้องถิ่นเทศบาลตำบลรางหวาย,3579,3601,7180,3591,3610,7201,2664
2566,71,กาญจนบุรี,7168,ท้องถิ่นเทศบาลตำบลหนองสาหร่าย,1710,1929,3639,1726,1933,3659,1245
2566,71,กาญจนบุรี,7169,ท้องถิ่นเทศบาลเมืองปากแพรก,13245,14903,28148,13425,15041,28466,16690
2566,71,กาญจนบุรี,7170,ท้องถิ่นเทศบาลตำบลวังศาลา,5676,6054,11730,5703,6086,11789,5361
2566,71,กาญจนบุรี,7171,ท้องถิ่นเทศบาลตำบลท่าล้อ,4265,4784,9049,4302,4810,9112,4087
2566,71,กาญจนบุรี,7172,ท้องถิ่นเทศบาลตำบลวังขนาย,4400,4861,9261,4437,4883,9320,4031
2566,71,กาญจนบุรี,7173,ท้องถิ่นเทศบาลตำบลหนองปรือ,2104,2257,4361,2110,2262,4372,1869
2566,71,กาญจนบุรี,7174,ท้องถิ่นเทศบาลตำบลด่านมะขามเตี้ย,1157,1238,2395,1195,1256,2451,1322
2566,71,กาญจนบุรี,7175,ท้องถิ่นเทศบาลตำบลหนองฝ้าย,1026,1123,2149,1070,1160,2230,963
2566,71,กาญจนบุรี,7176,ท้องถิ่นเทศบาลตำบลเลาขวัญ,1300,1313,2613,1307,1314,2621,1395
2566,71,กาญจนบุรี,7177,ท้องถิ่นเทศบาลตำบลตลาดเขต,1879,2106,3985,1889,2114,4003,1859
2566,71,กาญจนบุรี,7178,ท้องถิ่นเทศบาลตำบลพนมทวน,2356,2683,5039,2403,2712,5115,2254
2566,71,กาญจนบุรี,7179,ท้องถิ่นเทศบาลตำบลวังกะ,3568,3440,7008,4884,4747,9631,2702
2566,71,กาญจนบุรี,7180,ท้องถิ่นเทศบาลตำบลทองผาภูมิ,1400,1376,2776,1576,1530,3106,1617
2566,71,กาญจนบุรี,7181,ท้องถิ่นเทศบาลตำบลหนองตากยา,1459,1550,3009,1463,1553,3016,994
2566,71,กาญจนบุรี,7182,ท้องถิ่นเทศบาลตำบลหนองขาว,2329,2591,4920,2343,2595,4938,1634
2566,71,กาญจนบุรี,7183,ท้องถิ่นเทศบาลตำบลสำรอง,870,912,1782,878,914,1792,664
2566,71,กาญจนบุรี,7184,ท้องถิ่นเทศบาลตำบลท่าม่วง,4248,5026,9274,4380,5147,9527,5560
2566,71,กาญจนบุรี,7185,ท้องถิ่นเทศบาลตำบลหวายเหนียว,2072,2230,4302,2093,2250,4343,1985
2566,71,กาญจนบุรี,7186,ท้องถิ่นเทศบาลตำบลพระแท่น,2950,3222,6172,2963,3230,6193,2278
2566,71,กาญจนบุรี,7187,ท้องถิ่นเทศบาลตำบลท่าไม้,4250,4621,8871,4274,4631,8905,3976
2566,71,กาญจนบุรี,7188,ท้องถิ่นเทศบาลตำบลท่ามะกา,3396,3985,7381,3838,4407,8245,4774
2566,71,กาญจนบุรี,7189,ท้องถิ่นเทศบาลตำบลลูกแก,1577,1812,3389,1580,1814,3394,1524
2566,71,กาญจนบุรี,7190,ท้องถิ่นเทศบาลตำบลเอราวัณ,482,513,995,482,513,995,727
2566,71,กาญจนบุรี,7191,ท้องถิ่นเทศบาลตำบลหนองรี,1034,1095,2129,1036,1095,2131,826
2566,71,กาญจนบุรี,7192,ท้องถิ่นเทศบาลตำบลบ่อพลอย,3296,3342,6638,3373,3402,6775,2782
2566,71,กาญจนบุรี,7193,ท้องถิ่นเทศบาลตำบลวังโพธิ์,904,906,1810,1031,990,2021,908
2566,71,กาญจนบุรี,7194,ท้องถิ่นเทศบาลตำบลน้ำตกไทรโยคน้อย,1899,1955,3854,1921,1971,3892,1678
2566,71,กาญจนบุรี,7195,ท้องถิ่นเทศบาลตำบลหนองบัว,3293,3715,7008,3312,3731,7043,3309
2566,71,กาญจนบุรี,7196,ท้องถิ่นเทศบาลตำบลลาดหญ้า,2594,2790,5384,2606,2803,5409,2448
2566,71,กาญจนบุรี,7197,ท้องถิ่นเทศบาลตำบลแก่งเสี้ยน,3016,3416,6432,3034,3438,6472,3881
2566,71,กาญจนบุรี,7198,ท้องถิ่นเทศบาลเมืองท่าเรือพระแท่น,4977,5545,10522,5021,5586,10607,5161
2566,71,กาญจนบุรี,7199,ท้องถิ่นเทศบาลเมืองกาญจนบุรี,11482,13156,24638,11750,13386,25136,16133
2566,72,สุพรรณบุรี,7201,อำเภอเมืองสุพรรณบุรี,50407,56056,106463,50535,56168,106703,40089
2566,72,สุพรรณบุรี,7202,อำเภอเดิมบางนางบวช,19637,21107,40744,19672,21133,40805,15685
2566,72,สุพรรณบุรี,7203,อำเภอด่านช้าง,30208,31005,61213,30332,31081,61413,24234
2566,72,สุพรรณบุรี,7204,อำเภอบางปลาม้า,27986,29488,57474,28031,29543,57574,20175
2566,72,สุพรรณบุรี,7205,อำเภอศรีประจันต์,18887,20688,39575,18912,20716,39628,15513
2566,72,สุพรรณบุรี,7206,อำเภอดอนเจดีย์,19430,20824,40254,19456,20844,40300,15330
2566,72,สุพรรณบุรี,7207,อำเภอสองพี่น้อง,53499,55666,109165,53693,55843,109536,37323
2566,72,สุพรรณบุรี,7208,อำเภอสามชุก,18776,20372,39148,18818,20398,39216,15418
2566,72,สุพรรณบุรี,7209,อำเภออู่ทอง,31245,33170,64415,31356,33266,64622,22471
2566,72,สุพรรณบุรี,7210,อำเภอหนองหญ้าไซ,22568,23740,46308,22580,23756,46336,17223
2566,72,สุพรรณบุรี,7265,ท้องถิ่นเทศบาลตำบลปากน้ำ,2113,2318,4431,2114,2320,4434,1809
2566,72,สุพรรณบุรี,7266,ท้องถิ่นเทศบาลตำบลท้าวอู่ทอง,7578,8028,15606,7603,8044,15647,6061
2566,72,สุพรรณบุรี,7267,ท้องถิ่นเทศบาลตำบลกระจัน,3546,3734,7280,3551,3737,7288,2034
2566,72,สุพรรณบุรี,7268,ท้องถิ่นเทศบาลตำบลบ้านโข้ง,4421,4542,8963,4427,4547,8974,3372
2566,72,สุพรรณบุรี,7269,ท้องถิ่นเทศบาลตำบลเดิมบาง,3109,3562,6671,3111,3568,6679,2884
2566,72,สุพรรณบุรี,7270,ท้องถิ่นเทศบาลตำบลบางกุ้ง,904,974,1878,909,977,1886,596
2566,72,สุพรรณบุรี,7271,ท้องถิ่นเทศบาลตำบลท่าระหัด,4200,5003,9203,4219,5018,9237,5425
2566,72,สุพรรณบุรี,7272,ท้องถิ่นเทศบาลตำบลตะค่า,2604,2801,5405,2607,2805,5412,1959
2566,72,สุพรรณบุรี,7273,ท้องถิ่นเทศบาลตำบลบ้านดอน,3633,3859,7492,3635,3865,7500,2105
2566,72,สุพรรณบุรี,7274,ท้องถิ่นเทศบาลตำบลต้นคราม,2549,2804,5353,2569,2825,5394,2089
2566,72,สุพรรณบุรี,7275,ท้องถิ่นเทศบาลตำบลปลายนา,3931,4260,8191,3933,4264,8197,2972
2566,72,สุพรรณบุรี,7276,ท้องถิ่นเทศบาลตำบลขุนพัดเพ็ง,2625,2673,5298,2633,2677,5310,1970
2566,72,สุพรรณบุรี,7277,ท้องถิ่นเทศบาลตำบลวังยาง,3221,3577,6798,3228,3582,6810,2828
2566,72,สุพรรณบุรี,7278,ท้องถิ่นเทศบาลตำบลเขาดิน,2914,3082,5996,2917,3083,6000,2101
2566,72,สุพรรณบุรี,7279,ท้องถิ่นเทศบาลตำบลหนองหญ้าไซ,1137,1275,2412,1137,1275,2412,1135
2566,72,สุพรรณบุรี,7280,ท้องถิ่นเทศบาลตำบลอู่ทอง,3444,3841,7285,3460,3853,7313,3690
2566,72,สุพรรณบุรี,7281,ท้องถิ่นเทศบาลตำบลสระยายโสม,1295,1456,2751,1303,1459,2762,1075
2566,72,สุพรรณบุรี,7282,ท้องถิ่นเทศบาลตำบลสามชุก,5801,6604,12405,5819,6615,12434,6902
2566,72,สุพรรณบุรี,7283,ท้องถิ่นเทศบาลตำบลทุ่งคอก,1494,1744,3238,1508,1757,3265,1323
2566,72,สุพรรณบุรี,7284,ท้องถิ่นเทศบาลตำบลสระกระโจม,1186,1184,2370,1189,1186,2375,1055
2566,72,สุพรรณบุรี,7285,ท้องถิ่นเทศบาลตำบลดอนเจดีย์,1354,1459,2813,1393,1495,2888,1404
2566,72,สุพรรณบุรี,7286,ท้องถิ่นเทศบาลตำบลศรีประจันต์,2555,2898,5453,2572,2908,5480,2682
2566,72,สุพรรณบุรี,7287,ท้องถิ่นเทศบาลตำบลไผ่กองดิน,804,838,1642,804,844,1648,621
2566,72,สุพรรณบุรี,7288,ท้องถิ่นเทศบาลตำบลบ้านแหลม,575,584,1159,576,586,1162,459
2566,72,สุพรรณบุรี,7289,ท้องถิ่นเทศบาลตำบลบางปลาม้า,861,917,1778,895,921,1816,691
2566,72,สุพรรณบุรี,7290,ท้องถิ่นเทศบาลตำบลโคกคราม,713,760,1473,720,762,1482,899
2566,72,สุพรรณบุรี,7291,ท้องถิ่นเทศบาลตำบลด่านช้าง,2675,2993,5668,2696,3011,5707,3408
2566,72,สุพรรณบุรี,7292,ท้องถิ่นเทศบาลตำบลบ่อกรุ,911,1031,1942,911,1031,1942,784
2566,72,สุพรรณบุรี,7293,ท้องถิ่นเทศบาลตำบลนางบวช,2055,2181,4236,2056,2185,4241,1696
2566,72,สุพรรณบุรี,7294,ท้องถิ่นเทศบาลตำบลเขาพระ,2507,2924,5431,2533,2944,5477,3318
2566,72,สุพรรณบุรี,7295,ท้องถิ่นเทศบาลตำบลสวนแตง,3086,3318,6404,3100,3329,6429,2356
2566,72,สุพรรณบุรี,7296,ท้องถิ่นเทศบาลตำบลโพธิ์พระยา,1464,1829,3293,1468,1831,3299,1720
2566,72,สุพรรณบุรี,7297,ท้องถิ่นเทศบาลตำบลท่าเสด็จ,6585,7056,13641,6602,7075,13677,4546
2566,72,สุพรรณบุรี,7298,ท้องถิ่นเทศบาลเมืองสองพี่น้อง,5448,6266,11714,5564,6388,11952,5324
2566,72,สุพรรณบุรี,7299,ท้องถิ่นเทศบาลเมืองสุพรรณบุรี,10632,12683,23315,10854,12875,23729,13132
2566,73,นครปฐม,7301,อำเภอเมืองนครปฐม,83728,91387,175115,84095,91707,175802,70692
2566,73,นครปฐม,7302,อำเภอกำแพงแสน,57369,60504,117873,57799,60903,118702,41533
2566,73,นครปฐม,7303,อำเภอนครชัยศรี,47944,52984,100928,48149,53184,101333,41217
2566,73,นครปฐม,7304,อำเภอดอนตูม,17291,18219,35510,17328,18247,35575,11689
2566,73,นครปฐม,7305,อำเภอบางเลน,38894,40075,78969,39585,40744,80329,30577
2566,73,นครปฐม,7306,อำเภอสามพราน,47078,52386,99464,47399,52674,100073,51469
2566,73,นครปฐม,7307,อำเภอพุทธมณฑล,10333,12169,22502,10428,12278,22706,12289
2566,73,นครปฐม,7380,ท้องถิ่นเทศบาลตำบลบ่อพลับ,4470,5035,9505,4512,5063,9575,4997
2566,73,นครปฐม,7381,ท้องถิ่นเทศบาลตำบลบางกระทึก,7015,8141,15156,7048,8174,15222,9470
2566,73,นครปฐม,7382,ท้องถิ่นเทศบาลเมืองกระทุ่มล้ม,13391,15668,29059,13461,15736,29197,18995
2566,73,นครปฐม,7383,ท้องถิ่นเทศบาลเมืองไร่ขิง,15823,18134,33957,16699,19012,35711,26467
2566,73,นครปฐม,7384,ท้องถิ่นเทศบาลเมืองคลองโยง,5108,5710,10818,5140,5742,10882,4609
2566,73,นครปฐม,7385,ท้องถิ่นเทศบาลตำบลศาลายา,6359,5226,11585,6383,5240,11623,9430
2566,73,นครปฐม,7386,ท้องถิ่นเทศบาลตำบลอ้อมใหญ่,11370,12581,23951,11496,12709,24205,22273
2566,73,นครปฐม,7387,ท้องถิ่นเทศบาลเมืองสามพราน,7910,7187,15097,8643,7873,16516,9160
2566,73,นครปฐม,7388,ท้องถิ่นเทศบาลตำบลลำพญา,903,970,1873,904,974,1878,655
2566,73,นครปฐม,7389,ท้องถิ่นเทศบาลตำบลรางกระทุ่ม,987,1028,2015,994,1032,2026,743
2566,73,นครปฐม,7390,ท้องถิ่นเทศบาลตำบลบางหลวง,993,1036,2029,998,1039,2037,743
2566,73,นครปฐม,7391,ท้องถิ่นเทศบาลตำบลบางเลน,3867,3957,7824,4165,4198,8363,4345
2566,73,นครปฐม,7392,ท้องถิ่นเทศบาลตำบลสามง่าม,6588,7216,13804,6645,7281,13926,5130
2566,73,นครปฐม,7393,ท้องถิ่นเทศบาลตำบลห้วยพลู,908,1029,1937,1015,1142,2157,939
2566,73,นครปฐม,7394,ท้องถิ่นเทศบาลตำบลนครชัยศรี,3623,4325,7948,3630,4331,7961,5161
2566,73,นครปฐม,7395,ท้องถิ่นเทศบาลตำบลกำแพงแสน,3141,3573,6714,3159,3590,6749,4336
2566,73,นครปฐม,7396,ท้องถิ่นเทศบาลตำบลโพรงมะเดื่อ,5127,5647,10774,5144,5663,10807,4403
2566,73,นครปฐม,7397,ท้องถิ่นเทศบาลตำบลธรรมศาลา,3232,3592,6824,3253,3601,6854,3039
2566,73,นครปฐม,7398,ท้องถิ่นเทศบาลตำบลดอนยายหอม,3025,3285,6310,3035,3292,6327,2260
2566,73,นครปฐม,7399,ท้องถิ่นเทศบาลนครนครปฐม,30712,34629,65341,32143,35842,67985,38037
2566,74,สมุทรสาคร,7401,อำเภอเมืองสมุทรสาคร,100013,110261,210274,101489,111477,212966,123880
2566,74,สมุทรสาคร,7402,อำเภอกระทุ่มแบน,31600,34337,65937,32270,34974,67244,40121
2566,74,สมุทรสาคร,7403,อำเภอบ้านแพ้ว,24195,26440,50635,24330,26565,50895,16815
2566,74,สมุทรสาคร,7491,ท้องถิ่นเทศบาลตำบลสวนหลวง,18719,19086,37805,18845,19214,38059,23836
2566,74,สมุทรสาคร,7492,ท้องถิ่นเทศบาลตำบลนาดี,13215,14749,27964,13322,14836,28158,17127
2566,74,สมุทรสาคร,7493,ท้องถิ่นเทศบาลตำบลหลักห้า,20438,21728,42166,20479,21775,42254,11216
2566,74,สมุทรสาคร,7494,ท้องถิ่นเทศบาลตำบลบ้านแพ้ว,1171,1274,2445,1412,1533,2945,1062
2566,74,สมุทรสาคร,7495,ท้องถิ่นเทศบาลตำบลเกษตรพัฒนา,2496,2667,5163,2518,2687,5205,1646
2566,74,สมุทรสาคร,7496,ท้องถิ่นเทศบาลตำบลบางปลา,3549,3891,7440,3560,3897,7457,4749
2566,74,สมุทรสาคร,7497,ท้องถิ่นเทศบาลนครอ้อมน้อย,25325,28196,53521,25493,28345,53838,50496
2566,74,สมุทรสาคร,7498,ท้องถิ่นเทศบาลเมืองกระทุ่มแบน,8107,9025,17132,12215,12809,25024,6668
2566,74,สมุทรสาคร,7499,ท้องถิ่นเทศบาลนครสมุทรสาคร,20324,22109,42433,28404,29584,57988,19102
2566,75,สมุทรสงคราม,7501,อำเภอเมืองสมุทรสงคราม,37334,40794,78128,37476,40929,78405,33879
2566,75,สมุทรสงคราม,7502,อำเภอบางคนที,12614,13927,26541,12637,13943,26580,10253
2566,75,สมุทรสงคราม,7503,อำเภออัมพวา,22687,24521,47208,22718,24558,47276,16405
2566,75,สมุทรสงคราม,7595,ท้องถิ่นเทศบาลตำบลเหมืองใหม่,894,968,1862,895,970,1865,799
2566,75,สมุทรสงคราม,7596,ท้องถิ่นเทศบาลตำบลบางนกแขวก,776,910,1686,784,922,1706,861
2566,75,สมุทรสงคราม,7597,ท้องถิ่นเทศบาลตำบลกระดังงา,965,1124,2089,972,1131,2103,871
2566,75,สมุทรสงคราม,7598,ท้องถิ่นเทศบาลตำบลอัมพวา,2098,2325,4423,2102,2333,4435,2016
2566,75,สมุทรสงคราม,7599,ท้องถิ่นเทศบาลเมืองสมุทรสงคราม,11481,12961,24442,12095,13528,25623,11259
2566,76,เพชรบุรี,7601,อำเภอเมืองเพชรบุรี,42521,48512,91033,42615,48615,91230,37230
2566,76,เพชรบุรี,7602,อำเภอเขาย้อย,11440,12091,23531,11480,12119,23599,11370
2566,76,เพชรบุรี,7603,อำเภอหนองหญ้าปล้อง,8241,8217,16458,8263,8252,16515,7206
2566,76,เพชรบุรี,7604,อำเภอชะอำ,10903,11112,22015,10972,11146,22118,9424
2566,76,เพชรบุรี,7605,อำเภอท่ายาง,23724,25118,48842,23763,25133,48896,20645
2566,76,เพชรบุรี,7606,อำเภอบ้านลาด,22952,25170,48122,22979,25193,48172,16375
2566,76,เพชรบุรี,7607,อำเภอบ้านแหลม,17650,18310,35960,17675,18323,35998,12113
2566,76,เพชรบุรี,7608,อำเภอแก่งกระจาน,16608,15919,32527,17518,16584,34102,16141
2566,76,เพชรบุรี,7688,ท้องถิ่นเทศบาลตำบลท่าแลง,3068,3249,6317,3071,3253,6324,2252
2566,76,เพชรบุรี,7689,ท้องถิ่นเทศบาลตำบลบ้านแหลม,5419,5779,11198,5465,5816,11281,4311
2566,76,เพชรบุรี,7690,ท้องถิ่นเทศบาลตำบลบางตะบูน,2395,2516,4911,2396,2519,4915,1901
2566,76,เพชรบุรี,7691,ท้องถิ่นเทศบาลตำบลบ้านลาด,1685,1981,3666,1688,1981,3669,1736
2566,76,เพชรบุรี,7692,ท้องถิ่นเทศบาลตำบลหนองจอก,1270,1414,2684,1274,1415,2689,1056
2566,76,เพชรบุรี,7693,ท้องถิ่นเทศบาลตำบลท่ายาง,13061,14510,27571,13129,14571,27700,11937
2566,76,เพชรบุรี,7694,ท้องถิ่นเทศบาลตำบลนายาง,9125,9831,18956,9209,9859,19068,7627
2566,76,เพชรบุรี,7695,ท้องถิ่นเทศบาลตำบลเขาย้อย,6922,7577,14499,7188,7841,15029,8706
2566,76,เพชรบุรี,7696,ท้องถิ่นเทศบาลตำบลหาดเจ้าสำราญ,2374,2569,4943,2380,2572,4952,2673
2566,76,เพชรบุรี,7697,ท้องถิ่นเทศบาลตำบลหัวสะพาน,2755,3084,5839,2758,3085,5843,2076
2566,76,เพชรบุรี,7698,ท้องถิ่นเทศบาลเมืองชะอำ,19236,21882,41118,19878,22078,41956,48389
2566,76,เพชรบุรี,7699,ท้องถิ่นเทศบาลเมืองเพชรบุรี,8909,10183,19092,9171,10441,19612,10393
2566,77,ประจวบคีรีขันธ์,7701,อำเภอเมืองประจวบคีรีขันธ์,31882,32271,64153,32358,32584,64942,27678
2566,77,ประจวบคีรีขันธ์,7702,อำเภอกุยบุรี,17049,17550,34599,17150,17654,34804,11761
2566,77,ประจวบคีรีขันธ์,7703,อำเภอทับสะแก,20356,20989,41345,21163,21642,42805,15596
2566,77,ประจวบคีรีขันธ์,7704,อำเภอบางสะพาน,29609,30210,59819,30539,31041,61580,27705
2566,77,ประจวบคีรีขันธ์,7705,อำเภอบางสะพานน้อย,17871,18113,35984,18303,18471,36774,16756
2566,77,ประจวบคีรีขันธ์,7706,อำเภอปราณบุรี,20362,22060,42422,20976,22356,43332,22576
2566,77,ประจวบคีรีขันธ์,7707,อำเภอหัวหิน,26260,29463,55723,27765,30192,57957,32626
2566,77,ประจวบคีรีขันธ์,7708,อำเภอสามร้อยยอด,15515,15957,31472,15684,16034,31718,13034
2566,77,ประจวบคีรีขันธ์,7784,ท้องถิ่นเทศบาลตำบลเขาน้อย,6602,3081,9683,6661,3125,9786,6116
2566,77,ประจวบคีรีขันธ์,7785,ท้องถิ่นเทศบาลตำบลไร่เก่า,5136,5292,10428,5191,5342,10533,4345
2566,77,ประจวบคีรีขันธ์,7786,ท้องถิ่นเทศบาลตำบลหนองพลับ,2330,2560,4890,2347,2570,4917,2966
2566,77,ประจวบคีรีขันธ์,7787,ท้องถิ่นเทศบาลตำบลปากน้ำปราณ,3796,3779,7575,3818,3797,7615,3550
2566,77,ประจวบคีรีขันธ์,7788,ท้องถิ่นเทศบาลตำบลปราณบุรี,7827,8647,16474,7895,8694,16589,9713
2566,77,ประจวบคีรีขันธ์,7789,ท้องถิ่นเทศบาลตำบลบางสะพานน้อย,1435,1453,2888,1450,1463,2913,1625
2566,77,ประจวบคีรีขันธ์,7790,ท้องถิ่นเทศบาลตำบลร่อนทอง,3745,3938,7683,3798,3970,7768,3575
2566,77,ประจวบคีรีขันธ์,7791,ท้องถิ่นเทศบาลตำบลบ้านกรูด,1948,2143,4091,1975,2156,4131,2413
2566,77,ประจวบคีรีขันธ์,7792,ท้องถิ่นเทศบาลตำบลกำเนิดนพคุณ,1226,1296,2522,1245,1313,2558,1661
2566,77,ประจวบคีรีขันธ์,7793,ท้องถิ่นเทศบาลตำบลทับสะแก,2938,3363,6301,2953,3381,6334,3590
2566,77,ประจวบคีรีขันธ์,7794,ท้องถิ่นเทศบาลตำบลไร่ใหม่,3557,3863,7420,3680,3972,7652,2990
2566,77,ประจวบคีรีขันธ์,7795,ท้องถิ่นเทศบาลตำบลกุยบุรี,4065,4413,8478,4091,4430,8521,4375
2566,77,ประจวบคีรีขันธ์,7796,ท้องถิ่นเทศบาลตำบลคลองวาฬ,2042,2191,4233,2055,2199,4254,1889
2566,77,ประจวบคีรีขันธ์,7797,ท้องถิ่นเทศบาลตำบล กม.5,1718,1850,3568,1784,1871,3655,1454
2566,77,ประจวบคีรีขันธ์,7798,ท้องถิ่นเทศบาลนครหัวหิน,26819,32095,58914,29031,33030,62061,58998
2566,77,ประจวบคีรีขันธ์,7799,ท้องถิ่นเทศบาลเมืองประจวบคีรีขันธ์,7868,9382,17250,8162,9616,17778,11196
2566,80,นครศรีธรรมราช,8001,อำเภอเมืองนครศรีธรรมราช,79418,81859,161277,79500,81888,161388,66398
2566,80,นครศรีธรรมราช,8002,อำเภอพรหมคีรี,13452,13885,27337,13457,13893,27350,9454
2566,80,นครศรีธรรมราช,8003,อำเภอลานสกา,19079,20029,39108,19083,20033,39116,15121
2566,80,นครศรีธรรมราช,8004,อำเภอฉวาง,25634,26798,52432,25720,26886,52606,19650
2566,80,นครศรีธรรมราช,8005,อำเภอพิปูน,8789,9117,17906,8797,9125,17922,7467
2566,80,นครศรีธรรมราช,8006,อำเภอเชียรใหญ่,20076,20045,40121,20085,20053,40138,15064
2566,80,นครศรีธรรมราช,8007,อำเภอชะอวด,40533,41173,81706,40563,41199,81762,30749
2566,80,นครศรีธรรมราช,8008,อำเภอท่าศาลา,55867,57848,113715,55959,57894,113853,38199
2566,80,นครศรีธรรมราช,8009,อำเภอทุ่งสง,58762,57310,116072,58973,57506,116479,50035
2566,80,นครศรีธรรมราช,8010,อำเภอนาบอน,11819,12004,23823,11872,12070,23942,8802
2566,80,นครศรีธรรมราช,8011,อำเภอทุ่งใหญ่,34601,34779,69380,34616,34789,69405,24875
2566,80,นครศรีธรรมราช,8012,อำเภอปากพนัง,38883,38296,77179,38895,38311,77206,27071
2566,80,นครศรีธรรมราช,8013,อำเภอร่อนพิบูลย์,30584,30797,61381,30609,30822,61431,20980
2566,80,นครศรีธรรมราช,8014,อำเภอสิชล,40414,41086,81500,40541,41185,81726,30360
2566,80,นครศรีธรรมราช,8015,อำเภอขนอม,10100,10454,20554,10156,10499,20655,10089
2566,80,นครศรีธรรมราช,8016,อำเภอหัวไทร,21652,21859,43511,21667,21864,43531,18351
2566,80,นครศรีธรรมราช,8017,อำเภอบางขัน,23953,23368,47321,23981,23390,47371,17254
2566,80,นครศรีธรรมราช,8018,อำเภอถ้ำพรรณรา,9562,9515,19077,9580,9530,19110,7610
2566,80,นครศรีธรรมราช,8019,อำเภอจุฬาภรณ์,15460,15942,31402,15465,15946,31411,11160
2566,80,นครศรีธรรมราช,8020,อำเภอพระพรหม,22041,22702,44743,22047,22707,44754,17226
2566,80,นครศรีธรรมราช,8021,อำเภอนบพิตำ,16994,16851,33845,16996,16855,33851,12572
2566,80,นครศรีธรรมราช,8022,อำเภอช้างกลาง,13735,14251,27986,13741,14255,27996,11242
2566,80,นครศรีธรรมราช,8023,อำเภอเฉลิมพระเกียรติ,11046,11101,22147,11051,11104,22155,8191
2566,80,นครศรีธรรมราช,8070,ท้องถิ่นเทศบาลตำบลหน้าสตน,4057,4021,8078,4064,4026,8090,2981
2566,80,นครศรีธรรมราช,8071,ท้องถิ่นเทศบาลตำบลเขาพระ,4058,4060,8118,4060,4060,8120,3419
2566,80,นครศรีธรรมราช,8072,ท้องถิ่นเทศบาลตำบลเกาะเพชร,3395,3349,6744,3397,3352,6749,2230
2566,80,นครศรีธรรมราช,8073,ท้องถิ่นเทศบาลตำบลทางพูน,4508,4332,8840,4510,4334,8844,2955
2566,80,นครศรีธรรมราช,8074,ท้องถิ่นเทศบาลตำบลที่วัง,7255,7298,14553,7260,7300,14560,6738
2566,80,นครศรีธรรมราช,8075,ท้องถิ่นเทศบาลตำบลท้องเนียน,2808,2837,5645,2827,2848,5675,3403
2566,80,นครศรีธรรมราช,8076,ท้องถิ่นเทศบาลตำบลหัวไทร,1899,2106,4005,1903,2111,4014,1907
2566,80,นครศรีธรรมราช,8077,ท้องถิ่นเทศบาลตำบลขนอม,2020,2035,4055,2178,2202,4380,2510
2566,80,นครศรีธรรมราช,8078,ท้องถิ่นเทศบาลตำบลสิชล,3152,3487,6639,3317,3620,6937,4161
2566,80,นครศรีธรรมราช,8079,ท้องถิ่นเทศบาลตำบลหินตก,4160,4126,8286,4161,4128,8289,2876
2566,80,นครศรีธรรมราช,8080,ท้องถิ่นเทศบาลตำบลร่อนพิบูลย์,3593,3932,7525,3605,3939,7544,3429
2566,80,นครศรีธรรมราช,8081,ท้องถิ่นเทศบาลตำบลเขาชุมทอง,2085,2231,4316,2087,2233,4320,1426
2566,80,นครศรีธรรมราช,8082,ท้องถิ่นเทศบาลตำบลท่ายาง,2342,2523,4865,2415,2617,5032,3122
2566,80,นครศรีธรรมราช,8083,ท้องถิ่นเทศบาลตำบลนาบอน,1031,1082,2113,1045,1096,2141,1159
2566,80,นครศรีธรรมราช,8084,ท้องถิ่นเทศบาลตำบลท่าศาลา,1318,1485,2803,1320,1486,2806,1815
2566,80,นครศรีธรรมราช,8085,ท้องถิ่นเทศบาลตำบลชะอวด,1573,1839,3412,1575,1839,3414,1684
2566,80,นครศรีธรรมราช,8086,ท้องถิ่นเทศบาลตำบลเชียรใหญ่,770,811,1581,771,811,1582,781
2566,80,นครศรีธรรมราช,8087,ท้องถิ่นเทศบาลตำบลพิปูน,1312,1391,2703,1313,1391,2704,1145
2566,80,นครศรีธรรมราช,8088,ท้องถิ่นเทศบาลตำบลไม้เรียง,1128,1183,2311,1135,1190,2325,1263
2566,80,นครศรีธรรมราช,8089,ท้องถิ่นเทศบาลตำบลฉวาง,1179,1226,2405,1181,1227,2408,1307
2566,80,นครศรีธรรมราช,8090,ท้องถิ่นเทศบาลตำบลจันดี,3392,3790,7182,3437,3822,7259,4021
2566,80,นครศรีธรรมราช,8091,ท้องถิ่นเทศบาลตำบลลานสกา,869,950,1819,870,952,1822,1038
2566,80,นครศรีธรรมราช,8092,ท้องถิ่นเทศบาลตำบลพรหมโลก,3263,3416,6679,3269,3428,6697,2823
2566,80,นครศรีธรรมราช,8093,ท้องถิ่นเทศบาลตำบลทอนหงส์,1705,1733,3438,1708,1735,3443,1130
2566,80,นครศรีธรรมราช,8094,ท้องถิ่นเทศบาลตำบลปากนคร,3125,3053,6178,3127,3055,6182,2102
2566,80,นครศรีธรรมราช,8095,ท้องถิ่นเทศบาลตำบลบางจาก,881,949,1830,881,949,1830,691
2566,80,นครศรีธรรมราช,8096,ท้องถิ่นเทศบาลตำบลท่าแพ,1854,1899,3753,1857,1902,3759,1289
2566,80,นครศรีธรรมราช,8097,ท้องถิ่นเทศบาลเมืองทุ่งสง,13421,15836,29257,13435,15842,29277,11716
2566,80,นครศรีธรรมราช,8098,ท้องถิ่นเทศบาลเมืองปากพนัง,9224,9490,18714,9255,9506,18761,8186
2566,80,นครศรีธรรมราช,8099,ท้องถิ่นเทศบาลนครนครศรีธรรมราช,45391,51163,96554,45569,51262,96831,47306
2566,81,กระบี่,8101,อำเภอเมืองกระบี่,37140,38102,75242,37472,38276,75748,40728
2566,81,กระบี่,8102,อำเภอเขาพนม,25359,25120,50479,25418,25186,50604,18906
2566,81,กระบี่,8103,อำเภอเกาะลันตา,17720,17259,34979,17822,17319,35141,15408
2566,81,กระบี่,8104,อำเภอคลองท่อม,36635,35495,72130,36708,35577,72285,25863
2566,81,กระบี่,8105,อำเภออ่าวลึก,23269,23555,46824,23303,23589,46892,17256
2566,81,กระบี่,8106,อำเภอปลายพระยา,16295,16180,32475,16308,16203,32511,11464
2566,81,กระบี่,8107,อำเภอลำทับ,10308,10040,20348,10315,10044,20359,7558
2566,81,กระบี่,8108,อำเภอเหนือคลอง,30131,30776,60907,30178,30825,61003,21433
2566,81,กระบี่,8189,ท้องถิ่นเทศบาลตำบลกระบี่น้อย,9473,9797,19270,9489,9813,19302,9437
2566,81,กระบี่,8190,ท้องถิ่นเทศบาลตำบลเหนือคลอง,2093,2265,4358,2105,2270,4375,2488
2566,81,กระบี่,8191,ท้องถิ่นเทศบาลตำบลลำทับ,2084,2225,4309,2121,2255,4376,2457
2566,81,กระบี่,8192,ท้องถิ่นเทศบาลตำบลปลายพระยา,3003,3010,6013,3011,3026,6037,2667
2566,81,กระบี่,8193,ท้องถิ่นเทศบาลตำบลอ่าวลึกใต้,2576,2834,5410,2597,2848,5445,3056
2566,81,กระบี่,8194,ท้องถิ่นเทศบาลตำบลแหลมสัก,2053,2047,4100,2053,2048,4101,1288
2566,81,กระบี่,8195,ท้องถิ่นเทศบาลตำบลคลองพน,1401,1469,2870,1402,1471,2873,1359
2566,81,กระบี่,8196,ท้องถิ่นเทศบาลตำบลคลองท่อมใต้,1525,1700,3225,1526,1700,3226,1818
2566,81,กระบี่,8197,ท้องถิ่นเทศบาลตำบลเกาะลันตาใหญ่,561,587,1148,561,588,1149,506
2566,81,กระบี่,8198,ท้องถิ่นเทศบาลตำบลเขาพนม,2592,2772,5364,2652,2815,5467,2547
2566,81,กระบี่,8199,ท้องถิ่นเทศบาลเมืองกระบี่,13968,16472,30440,14400,16827,31227,18201
2566,82,พังงา,8201,อำเภอเมืองพังงา,15409,15871,31280,15441,15900,31341,12852
2566,82,พังงา,8202,อำเภอเกาะยาว,7352,7206,14558,7403,7252,14655,6126
2566,82,พังงา,8203,อำเภอกะปง,6645,6633,13278,6711,6683,13394,6182
2566,82,พังงา,8204,อำเภอตะกั่วทุ่ง,19659,19485,39144,19747,19572,39319,16695
2566,82,พังงา,8205,อำเภอตะกั่วป่า,20171,20504,40675,20873,21122,41995,24742
2566,82,พังงา,8206,อำเภอคุระบุรี,12432,12085,24517,12617,12284,24901,10645
2566,82,พังงา,8207,อำเภอทับปุด,12505,12406,24911,12544,12443,24987,8424
2566,82,พังงา,8208,อำเภอท้ายเหมือง,22742,22087,44829,22917,22206,45123,21569
2566,82,พังงา,8291,ท้องถิ่นเทศบาลตำบลท้ายเหมือง,1502,1608,3110,1511,1613,3124,1782
2566,82,พังงา,8292,ท้องถิ่นเทศบาลตำบลทับปุด,478,491,969,481,493,974,620
2566,82,พังงา,8293,ท้องถิ่นเทศบาลตำบลคุระบุรี,1629,1658,3287,1702,1720,3422,2198
2566,82,พังงา,8294,ท้องถิ่นเทศบาลเมืองโคกกลอย,1702,1892,3594,1796,1972,3768,1761
2566,82,พังงา,8295,ท้องถิ่นเทศบาลตำบลกระโสม,853,950,1803,853,954,1807,788
2566,82,พังงา,8296,ท้องถิ่นเทศบาลตำบลท่านา,466,522,988,469,524,993,598
2566,82,พังงา,8297,ท้องถิ่นเทศบาลตำบลเกาะยาว,0,0,0,0,0,0,0
2566,82,พังงา,8298,ท้องถิ่นเทศบาลเมืองตะกั่วป่า,3655,4006,7661,3671,4011,7682,2833
2566,82,พังงา,8299,ท้องถิ่นเทศบาลเมืองพังงา,4216,4544,8760,4643,4929,9572,6045
2566,83,ภูเก็ต,8301,อำเภอเมืองภูเก็ต,21341,24410,45751,21607,24514,46121,31895
2566,83,ภูเก็ต,8302,อำเภอกะทู้,3314,3682,6996,3406,3732,7138,7487
2566,83,ภูเก็ต,8303,อำเภอถลาง,46990,50262,97252,47686,50602,98288,75560
2566,83,ภูเก็ต,8391,ท้องถิ่นเทศบาลตำบลวิชิต,24834,28650,53484,25326,29065,54391,35763
2566,83,ภูเก็ต,8392,ท้องถิ่นเทศบาลตำบลราไวย์,8674,10196,18870,8971,10293,19264,20383
2566,83,ภูเก็ต,8393,ท้องถิ่นเทศบาลตำบลรัษฎา,23393,26282,49675,23704,26553,50257,31605
2566,83,ภูเก็ต,8394,ท้องถิ่นเทศบาลตำบลเทพกระษัตรี,4318,4699,9017,4712,5033,9745,5180
2566,83,ภูเก็ต,8395,ท้องถิ่นเทศบาลตำบลเชิงทะเล,3067,3795,6862,3130,3851,6981,3765
2566,83,ภูเก็ต,8396,ท้องถิ่นเทศบาลเมืองกะทู้,14251,17051,31302,14648,17145,31793,21837
2566,83,ภูเก็ต,8397,ท้องถิ่นเทศบาลตำบลกะรน,3503,3934,7437,3572,3974,7546,8915
2566,83,ภูเก็ต,8398,ท้องถิ่นเทศบาลเมืองป่าตอง,8588,9616,18204,9275,10111,19386,16616
2566,83,ภูเก็ต,8399,ท้องถิ่นเทศบาลนครภูเก็ต,31170,37190,68360,33463,39226,72689,26931
2566,84,สุราษฎร์ธานี,8401,อำเภอเมืองสุราษฎร์ธานี,9085,10092,19177,9094,10101,19195,8451
2566,84,สุราษฎร์ธานี,8402,อำเภอกาญจนดิษฐ์,40474,41288,81762,40686,41453,82139,35459
2566,84,สุราษฎร์ธานี,8403,อำเภอดอนสัก,12353,12418,24771,12505,12490,24995,10886
2566,84,สุราษฎร์ธานี,8405,อำเภอเกาะพะงัน,5057,5143,10200,5767,5543,11310,13115
2566,84,สุราษฎร์ธานี,8406,อำเภอไชยา,18833,19727,38560,18882,19766,38648,17461
2566,84,สุราษฎร์ธานี,8407,อำเภอท่าชนะ,25968,25603,51571,26009,25633,51642,23360
2566,84,สุราษฎร์ธานี,8408,อำเภอคีรีรัฐนิคม,20987,21126,42113,21041,21193,42234,17506
2566,84,สุราษฎร์ธานี,8409,อำเภอบ้านตาขุน,4583,4660,9243,4587,4664,9251,4088
2566,84,สุราษฎร์ธานี,8410,อำเภอพนม,12477,11999,24476,12492,12009,24501,9738
2566,84,สุราษฎร์ธานี,8411,อำเภอท่าฉาง,14838,14675,29513,14867,14698,29565,13470
2566,84,สุราษฎร์ธานี,8412,อำเภอบ้านนาสาร,25070,25572,50642,25082,25588,50670,18817
2566,84,สุราษฎร์ธานี,8413,อำเภอบ้านนาเดิม,10319,10469,20788,10325,10473,20798,7998
2566,84,สุราษฎร์ธานี,8414,อำเภอเคียนซา,13755,13685,27440,13852,13786,27638,11664
2566,84,สุราษฎร์ธานี,8415,อำเภอเวียงสระ,8513,8786,17299,8515,8787,17302,7191
2566,84,สุราษฎร์ธานี,8416,อำเภอพระแสง,31629,31196,62825,31641,31210,62851,25111
2566,84,สุราษฎร์ธานี,8417,อำเภอพุนพิน,37657,37413,75070,37802,37561,75363,37474
2566,84,สุราษฎร์ธานี,8418,อำเภอชัยบุรี,14309,14063,28372,14328,14075,28403,11892
2566,84,สุราษฎร์ธานี,8419,อำเภอวิภาวดี,8144,7588,15732,8209,7649,15858,7579
2566,84,สุราษฎร์ธานี,8471,ท้องถิ่นเทศบาลตำบลบ้านเสด็จ,9778,9584,19362,9784,9585,19369,8040
2566,84,สุราษฎร์ธานี,8472,ท้องถิ่นเทศบาลตำบลคลองชะอุ่น,4978,4915,9893,4979,4919,9898,3533
2566,84,สุราษฎร์ธานี,8473,ท้องถิ่นเทศบาลตำบลทุ่งหลวง,5449,5769,11218,5451,5771,11222,4325
2566,84,สุราษฎร์ธานี,8474,ท้องถิ่นเทศบาลตำบลขุนทะเล,7846,10877,18723,7868,10963,18831,11833
2566,84,สุราษฎร์ธานี,8475,ท้องถิ่นเทศบาลตำบลช้างซ้าย,5554,5625,11179,5565,5634,11199,4093
2566,84,สุราษฎร์ธานี,8476,ท้องถิ่นเทศบาลตำบลเขานิพันธ์,3405,3430,6835,3406,3431,6837,3067
2566,84,สุราษฎร์ธานี,8477,ท้องถิ่นเทศบาลตำบลวัดประดู่,9660,10816,20476,9681,10823,20504,12254
2566,84,สุราษฎร์ธานี,8478,ท้องถิ่นเทศบาลตำบลบ้านส้อง,8696,8949,17645,8698,8953,17651,7179
2566,84,สุราษฎร์ธานี,8479,ท้องถิ่นเทศบาลตำบลย่านดินแดง,1117,1158,2275,1138,1174,2312,1091
2566,84,สุราษฎร์ธานี,8480,ท้องถิ่นเทศบาลตำบลบางสวรรค์,2063,2131,4194,2063,2131,4194,2058
2566,84,สุราษฎร์ธานี,8481,ท้องถิ่นเทศบาลเมืองเวียงสระ,4270,4856,9126,4334,4925,9259,5929
2566,84,สุราษฎร์ธานี,8482,ท้องถิ่นเทศบาลตำบลเคียนซา,839,801,1640,841,802,1643,758
2566,84,สุราษฎร์ธานี,8483,ท้องถิ่นเทศบาลตำบลบ้านนา,1550,1664,3214,1563,1673,3236,1724
2566,84,สุราษฎร์ธานี,8484,ท้องถิ่นเทศบาลตำบลท่าฉาง,2205,2410,4615,2232,2435,4667,1996
2566,84,สุราษฎร์ธานี,8485,ท้องถิ่นเทศบาลตำบลพนม,2451,2428,4879,2468,2450,4918,2054
2566,84,สุราษฎร์ธานี,8486,ท้องถิ่นเทศบาลตำบลบ้านตาขุน,1154,1234,2388,1157,1237,2394,1892
2566,84,สุราษฎร์ธานี,8487,ท้องถิ่นเทศบาลตำบลบ้านเชี่ยวหลาน,2268,2275,4543,2270,2275,4545,2066
2566,84,สุราษฎร์ธานี,8488,ท้องถิ่นเทศบาลตำบลท่าขนอน,913,895,1808,919,900,1819,1112
2566,84,สุราษฎร์ธานี,8489,ท้องถิ่นเทศบาลตำบลท่าชนะ,1356,1489,2845,1357,1492,2849,1813
2566,84,สุราษฎร์ธานี,8490,ท้องถิ่นเทศบาลตำบลพุมเรียง,3825,3998,7823,3825,3999,7824,2918
2566,84,สุราษฎร์ธานี,8491,ท้องถิ่นเทศบาลตำบลตลาดไชยา,2242,2555,4797,2409,2712,5121,2991
2566,84,สุราษฎร์ธานี,8492,ท้องถิ่นเทศบาลตำบลเกาะพะงัน,3581,3804,7385,3894,3949,7843,5998
2566,84,สุราษฎร์ธานี,8493,ท้องถิ่นเทศบาลนครเกาะสมุย,30631,34194,64825,32717,35583,68300,59311
2566,84,สุราษฎร์ธานี,8494,ท้องถิ่นเทศบาลเมืองดอนสัก,5838,6120,11958,5868,6152,12020,6019
2566,84,สุราษฎร์ธานี,8495,ท้องถิ่นเทศบาลตำบลท่าทองใหม่,3555,3619,7174,3562,3623,7185,3285
2566,84,สุราษฎร์ธานี,8496,ท้องถิ่นเทศบาลตำบลกาญจนดิษฐ์,4484,4853,9337,4492,4857,9349,4940
2566,84,สุราษฎร์ธานี,8497,ท้องถิ่นเทศบาลเมืองท่าข้าม,8616,9237,17853,8712,9345,18057,9178
2566,84,สุราษฎร์ธานี,8498,ท้องถิ่นเทศบาลเมืองนาสาร,9283,9741,19024,9310,9756,19066,8510
2566,84,สุราษฎร์ธานี,8499,ท้องถิ่นเทศบาลนครสุราษฎร์ธานี,61281,68513,129794,62111,69202,131313,78528
2566,85,ระนอง,8501,อำเภอเมืองระนอง,32686,32444,65130,35625,35083,70708,39864
2566,85,ระนอง,8502,อำเภอละอุ่น,6340,6184,12524,6390,6231,12621,5772
2566,85,ระนอง,8503,อำเภอกะเปอร์,10212,9981,20193,10427,10181,20608,8357
2566,85,ระนอง,8504,อำเภอกระบุรี,22315,21587,43902,22710,21950,44660,23162
2566,85,ระนอง,8505,อำเภอสุขสำราญ,7063,7055,14118,7308,7286,14594,4784
2566,85,ระนอง,8594,ท้องถิ่นเทศบาลตำบลน้ำจืด,1569,1647,3216,1733,1770,3503,1987
2566,85,ระนอง,8595,ท้องถิ่นเทศบาลตำบลกะเปอร์,730,747,1477,734,751,1485,683
2566,85,ระนอง,8596,ท้องถิ่นเทศบาลตำบลละอุ่น,1258,1203,2461,1346,1283,2629,1239
2566,85,ระนอง,8597,ท้องถิ่นเทศบาลตำบลหงาว,1102,1196,2298,1147,1252,2399,1119
2566,85,ระนอง,8598,ท้องถิ่นเทศบาลตำบลปากน้ำ,1204,1088,2292,1242,1143,2385,1829
2566,85,ระนอง,8599,ท้องถิ่นเทศบาลเมืองระนอง,5773,6310,12083,8697,9082,17779,8285
2566,86,ชุมพร,8601,อำเภอเมืองชุมพร,46113,46995,93108,46195,47064,93259,46825
2566,86,ชุมพร,8602,อำเภอท่าแซะ,40947,41161,82108,41328,41535,82863,36945
2566,86,ชุมพร,8603,อำเภอปะทิว,19621,20090,39711,19738,20179,39917,18812
2566,86,ชุมพร,8604,อำเภอหลังสวน,27296,28518,55814,27513,28701,56214,25436
2566,86,ชุมพร,8605,อำเภอละแม,12912,12944,25856,13049,13059,26108,12282
2566,86,ชุมพร,8606,อำเภอพะโต๊ะ,11846,11416,23262,11854,11424,23278,11188
2566,86,ชุมพร,8607,อำเภอสวี,34706,35030,69736,34778,35098,69876,33396
2566,86,ชุมพร,8608,อำเภอทุ่งตะโก,10815,10707,21522,10846,10735,21581,10200
2566,86,ชุมพร,8685,ท้องถิ่นเทศบาลเมืองท่ายาง,5048,5298,10346,5060,5302,10362,4919
2566,86,ชุมพร,8686,ท้องถิ่นเทศบาลตำบลปากตะโก,2044,2016,4060,2046,2017,4063,1708
2566,86,ชุมพร,8687,ท้องถิ่นเทศบาลตำบลนาโพธิ์,1356,1545,2901,1359,1546,2905,1716
2566,86,ชุมพร,8688,ท้องถิ่นเทศบาลตำบลพะโต๊ะ,742,740,1482,749,745,1494,708
2566,86,ชุมพร,8689,ท้องถิ่นเทศบาลตำบลละแม,1552,1676,3228,1562,1687,3249,2008
2566,86,ชุมพร,8690,ท้องถิ่นเทศบาลตำบลปากน้ำหลังสวน,3098,3169,6267,3128,3197,6325,3168
2566,86,ชุมพร,8691,ท้องถิ่นเทศบาลตำบลสะพลี,1034,1114,2148,1042,1114,2156,1197
2566,86,ชุมพร,8692,ท้องถิ่นเทศบาลตำบลมาบอำมฤต,1663,1683,3346,1796,1854,3650,2283
2566,86,ชุมพร,8693,ท้องถิ่นเทศบาลตำบลปะทิว,542,607,1149,598,670,1268,895
2566,86,ชุมพร,8694,ท้องถิ่นเทศบาลตำบลเนินสันติ,914,975,1889,917,981,1898,1318
2566,86,ชุมพร,8695,ท้องถิ่นเทศบาลตำบลท่าแซะ,939,1059,1998,939,1061,2000,1405
2566,86,ชุมพร,8696,ท้องถิ่นเทศบาลตำบลวังไผ่,3209,3534,6743,3218,3539,6757,4833
2566,86,ชุมพร,8697,ท้องถิ่นเทศบาลตำบลปากน้ำชุมพร,2786,2951,5737,2990,3129,6119,3461
2566,86,ชุมพร,8698,ท้องถิ่นเทศบาลเมืองหลังสวน,5093,5803,10896,5109,5813,10922,7108
2566,86,ชุมพร,8699,ท้องถิ่นเทศบาลเมืองชุมพร,14581,17054,31635,15107,17486,32593,20575
2566,90,สงขลา,9001,อำเภอเมืองสงขลา,7254,7946,15200,7269,7949,15218,5816
2566,90,สงขลา,9002,อำเภอสทิงพระ,21589,22637,44226,21598,22642,44240,14381
2566,90,สงขลา,9003,อำเภอจะนะ,50667,51342,102009,50706,51379,102085,29231
2566,90,สงขลา,9004,อำเภอนาทวี,31778,31162,62940,31821,31198,63019,20285
2566,90,สงขลา,9005,อำเภอเทพา,31096,29513,60609,31147,29570,60717,17325
2566,90,สงขลา,9006,อำเภอสะบ้าย้อย,40379,39576,79955,40443,39633,80076,20199
2566,90,สงขลา,9007,อำเภอระโนด,23599,24109,47708,23618,24137,47755,20038
2566,90,สงขลา,9008,อำเภอกระแสสินธุ์,7252,7510,14762,7258,7513,14771,5437
2566,90,สงขลา,9009,อำเภอรัตภูมิ,33529,34129,67658,33781,34142,67923,23155
2566,90,สงขลา,9010,อำเภอสะเดา,29442,29118,58560,29631,29297,58928,22163
2566,90,สงขลา,9011,อำเภอหาดใหญ่,15441,16822,32263,15485,16857,32342,14855
2566,90,สงขลา,9012,อำเภอนาหม่อม,11053,11919,22972,11071,11930,23001,9629
2566,90,สงขลา,9013,อำเภอควนเนียง,14824,15376,30200,14848,15394,30242,10413
2566,90,สงขลา,9014,อำเภอบางกล่ำ,5078,5225,10303,5157,5278,10435,3862
2566,90,สงขลา,9015,อำเภอสิงหนคร,21381,22440,43821,21389,22441,43830,15477
2566,90,สงขลา,9016,อำเภอคลองหอยโข่ง,5911,5843,11754,5953,5895,11848,5423
2566,90,สงขลา,9066,ท้องถิ่นเทศบาลเมืองทุ่งตำเสา,8355,8849,17204,8368,8860,17228,6625
2566,90,สงขลา,9067,ท้องถิ่นเทศบาลตำบลโคกม่วง,4180,3511,7691,4183,3520,7703,2886
2566,90,สงขลา,9068,ท้องถิ่นเทศบาลตำบลทุ่งลาน,3683,3946,7629,3690,3946,7636,2752
2566,90,สงขลา,9069,ท้องถิ่นเทศบาลตำบลเกาะแต้ว,5729,5997,11726,5734,5999,11733,3987
2566,90,สงขลา,9070,ท้องถิ่นเทศบาลตำบลคูเต่า,5853,5925,11778,5859,5926,11785,3395
2566,90,สงขลา,9071,ท้องถิ่นเทศบาลตำบลท่าช้าง,11592,11750,23342,11613,11764,23377,10691
2566,90,สงขลา,9072,ท้องถิ่นเทศบาลตำบลน้ำน้อย,7265,8109,15374,7286,8113,15399,6713
2566,90,สงขลา,9073,ท้องถิ่นเทศบาลตำบลลำไพล,7832,8027,15859,7862,8046,15908,4797
2566,90,สงขลา,9074,ท้องถิ่นเทศบาลตำบลบ้านไร่,4010,4295,8305,4023,4300,8323,3621
2566,90,สงขลา,9075,ท้องถิ่นเทศบาลตำบลพะวง,16421,18234,34655,16862,18664,35526,16507
2566,90,สงขลา,9076,ท้องถิ่นเทศบาลเมืองเขารูปช้าง,20306,22747,43053,20354,22761,43115,21937
2566,90,สงขลา,9077,ท้องถิ่นเทศบาลตำบลสำนักขาม,6268,7298,13566,6342,7345,13687,9438
2566,90,สงขลา,9078,ท้องถิ่นเทศบาลเมืองคลองแห,20520,23200,43720,20562,23226,43788,22798
2566,90,สงขลา,9079,ท้องถิ่นเทศบาลเมืองควนลัง,24128,27586,51714,24204,27656,51860,27934
2566,90,สงขลา,9080,ท้องถิ่นเทศบาลเมืองคอหงส์,21432,24242,45674,21564,24321,45885,29396
2566,90,สงขลา,9081,ท้องถิ่นเทศบาลเมืองสิงหนคร,19750,20182,39932,19769,20187,39956,13909
2566,90,สงขลา,9082,ท้องถิ่นเทศบาลตำบลควนเนียง,1864,2143,4007,1878,2153,4031,1818
2566,90,สงขลา,9083,ท้องถิ่นเทศบาลตำบลพะตง,3583,4022,7605,3622,4051,7673,4892
2566,90,สงขลา,9084,ท้องถิ่นเทศบาลตำบลคลองแงะ,3884,4101,7985,3951,4157,8108,3224
2566,90,สงขลา,9085,ท้องถิ่นเทศบาลเมืองปาดังเบซาร์,7662,8119,15781,7695,8146,15841,6397
2566,90,สงขลา,9086,ท้องถิ่นเทศบาลตำบลปริก,3120,3287,6407,3129,3288,6417,2130
2566,90,สงขลา,9087,ท้องถิ่นเทศบาลตำบลนาสีทอง,1355,1522,2877,1356,1523,2879,1174
2566,90,สงขลา,9088,ท้องถิ่นเทศบาลตำบลกำแพงเพชร,2288,2496,4784,2333,2547,4880,2669
2566,90,สงขลา,9089,ท้องถิ่นเทศบาลตำบลระโนด,2019,2257,4276,2020,2259,4279,1996
2566,90,สงขลา,9090,ท้องถิ่นเทศบาลตำบลบ่อตรุ,5286,5552,10838,5288,5552,10840,3615
2566,90,สงขลา,9091,ท้องถิ่นเทศบาลตำบลสะบ้าย้อย,605,654,1259,605,654,1259,805
2566,90,สงขลา,9092,ท้องถิ่นเทศบาลตำบลเทพา,1132,1149,2281,1140,1157,2297,1106
2566,90,สงขลา,9093,ท้องถิ่นเทศบาลตำบลนาทวี,2846,2932,5778,3006,3071,6077,3810
2566,90,สงขลา,9094,ท้องถิ่นเทศบาลตำบลจะนะ,3293,3422,6715,3352,3461,6813,3437
2566,90,สงขลา,9095,ท้องถิ่นเทศบาลตำบลสทิงพระ,1246,1417,2663,1248,1417,2665,1326
2566,90,สงขลา,9096,ท้องถิ่นเทศบาลเมืองบ้านพรุ,13204,14573,27777,13253,14607,27860,13659
2566,90,สงขลา,9097,ท้องถิ่นเทศบาลเมืองสะเดา,10167,10847,21014,10408,11074,21482,9117
2566,90,สงขลา,9098,ท้องถิ่นเทศบาลนครหาดใหญ่,63892,75554,139446,66182,77551,143733,70431
2566,90,สงขลา,9099,ท้องถิ่นเทศบาลนครสงขลา,26607,28755,55362,26685,28801,55486,27744
2566,91,สตูล,9101,อำเภอเมืองสตูล,32779,33556,66335,32807,33578,66385,19335
2566,91,สตูล,9102,อำเภอควนโดน,10984,11083,22067,10993,11084,22077,6273
2566,91,สตูล,9103,อำเภอควนกาหลง,17871,17761,35632,17879,17770,35649,12297
2566,91,สตูล,9104,อำเภอท่าแพ,14827,15063,29890,14840,15067,29907,9101
2566,91,สตูล,9105,อำเภอละงู,34317,34640,68957,34434,34746,69180,21947
2566,91,สตูล,9106,อำเภอทุ่งหว้า,10736,10630,21366,10757,10643,21400,6997
2566,91,สตูล,9107,อำเภอมะนัง,9519,9149,18668,9523,9150,18673,6624
2566,91,สตูล,9193,ท้องถิ่นเทศบาลตำบลคลองขุด,10543,9943,20486,10554,9949,20503,9530
2566,91,สตูล,9194,ท้องถิ่นเทศบาลตำบลทุ่งหว้า,1581,1639,3220,1583,1639,3222,1264
2566,91,สตูล,9195,ท้องถิ่นเทศบาลตำบลกำแพง,2328,2603,4931,2332,2606,4938,2934
2566,91,สตูล,9196,ท้องถิ่นเทศบาลตำบลควนโดน,2696,2776,5472,2698,2779,5477,2008
2566,91,สตูล,9197,ท้องถิ่นเทศบาลตำบลฉลุง,1104,1216,2320,1104,1216,2320,1034
2566,91,สตูล,9198,ท้องถิ่นเทศบาลตำบลเจ๊ะบิลัง,2011,2020,4031,2020,2029,4049,1031
2566,91,สตูล,9199,ท้องถิ่นเทศบาลเมืองสตูล,10450,11124,21574,10515,11175,21690,10170
2566,92,ตรัง,9201,อำเภอเมืองตรัง,46211,49922,96133,46284,49959,96243,42536
2566,92,ตรัง,9202,อำเภอกันตัง,37290,37902,75192,37310,37928,75238,24991
2566,92,ตรัง,9203,อำเภอย่านตาขาว,27749,28714,56463,27791,28742,56533,18499
2566,92,ตรัง,9204,อำเภอปะเหลียน,30744,31584,62328,30797,31626,62423,22190
2566,92,ตรัง,9205,อำเภอสิเกา,17641,17240,34881,17667,17270,34937,13006
2566,92,ตรัง,9206,อำเภอห้วยยอด,38345,39521,77866,38415,39585,78000,27582
2566,92,ตรัง,9207,อำเภอวังวิเศษ,20060,20355,40415,20073,20367,40440,14287
2566,92,ตรัง,9208,อำเภอนาโยง,19930,21150,41080,19939,21151,41090,14016
2566,92,ตรัง,9209,อำเภอรัษฎา,13221,13519,26740,13243,13544,26787,10105
2566,92,ตรัง,9210,อำเภอหาดสำราญ,8454,8349,16803,8460,8356,16816,5088
2566,92,ตรัง,9286,ท้องถิ่นเทศบาลตำบลคลองปาง,1093,1200,2293,1093,1201,2294,1368
2566,92,ตรัง,9287,ท้องถิ่นเทศบาลตำบลนาโยงเหนือ,1630,1832,3462,1634,1835,3469,1602
2566,92,ตรัง,9288,ท้องถิ่นเทศบาลตำบลวังวิเศษ,1455,1476,2931,1472,1495,2967,1392
2566,92,ตรัง,9289,ท้องถิ่นเทศบาลตำบลลำภูรา,1850,1474,3324,1851,1474,3325,1463
2566,92,ตรัง,9290,ท้องถิ่นเทศบาลตำบลนาวง,1916,2057,3973,1923,2057,3980,1876
2566,92,ตรัง,9291,ท้องถิ่นเทศบาลตำบลสิเกา,614,676,1290,640,697,1337,659
2566,92,ตรัง,9292,ท้องถิ่นเทศบาลตำบลควนกุน,1018,1068,2086,1018,1068,2086,784
2566,92,ตรัง,9293,ท้องถิ่นเทศบาลตำบลทุ่งยาว,1084,1256,2340,1090,1260,2350,1112
2566,92,ตรัง,9294,ท้องถิ่นเทศบาลตำบลท่าข้าม,677,659,1336,679,661,1340,669
2566,92,ตรัง,9295,ท้องถิ่นเทศบาลตำบลย่านตาขาว,3450,3999,7449,3467,4019,7486,3858
2566,92,ตรัง,9296,ท้องถิ่นเทศบาลตำบลคลองเต็ง,1827,2006,3833,1834,2008,3842,1808
2566,92,ตรัง,9297,ท้องถิ่นเทศบาลตำบลห้วยยอด,3776,4153,7929,3785,4159,7944,4204
2566,92,ตรัง,9298,ท้องถิ่นเทศบาลเมืองกันตัง,5527,5722,11249,5576,5764,11340,5134
2566,92,ตรัง,9299,ท้องถิ่นเทศบาลนครตรัง,24929,29349,54278,25171,29579,54750,25727
2566,93,พัทลุง,9301,อำเภอเมืองพัทลุง,42632,46780,89412,42670,46794,89464,35478
2566,93,พัทลุง,9302,อำเภอกงหรา,14700,14816,29516,14702,14821,29523,9793
2566,93,พัทลุง,9303,อำเภอเขาชัยสน,15101,15736,30837,15108,15739,30847,11955
2566,93,พัทลุง,9304,อำเภอตะโหมด,7116,7221,14337,7120,7223,14343,4918
2566,93,พัทลุง,9305,อำเภอควนขนุน,37710,40938,78648,37722,40943,78665,31054
2566,93,พัทลุง,9306,อำเภอปากพะยูน,16101,16665,32766,16105,16670,32775,11395
2566,93,พัทลุง,9307,อำเภอศรีบรรพต,9015,9031,18046,9020,9040,18060,7084
2566,93,พัทลุง,9308,อำเภอป่าบอน,21555,21981,43536,21560,21982,43542,16358
2566,93,พัทลุง,9309,อำเภอบางแก้ว,8905,9061,17966,8911,9064,17975,6682
2566,93,พัทลุง,9310,อำเภอป่าพะยอม,13164,13690,26854,13170,13700,26870,11115
2566,93,พัทลุง,9311,อำเภอศรีนครินทร์,5112,5287,10399,5114,5290,10404,3733
2566,93,พัทลุง,9382,ท้องถิ่นเทศบาลตำบลเขาหัวช้าง,3613,3590,7203,3613,3591,7204,2227
2566,93,พัทลุง,9383,ท้องถิ่นเทศบาลตำบลชะรัด,3606,3697,7303,3608,3698,7306,2347
2566,93,พัทลุง,9384,ท้องถิ่นเทศบาลตำบลหารเทา,4902,5097,9999,4907,5098,10005,3588
2566,93,พัทลุง,9385,ท้องถิ่นเทศบาลตำบลบางแก้ว,1876,1922,3798,1878,1923,3801,1481
2566,93,พัทลุง,9386,ท้องถิ่นเทศบาลตำบลอ่าวพะยูน,2270,2339,4609,2275,2341,4616,1700
2566,93,พัทลุง,9387,ท้องถิ่นเทศบาลตำบลชุมพล,4731,4176,8907,4734,4176,8910,3655
2566,93,พัทลุง,9388,ท้องถิ่นเทศบาลตำบลโคกม่วง,5075,5310,10385,5075,5311,10386,3739
2566,93,พัทลุง,9389,ท้องถิ่นเทศบาลตำบลบ้านนา,3697,3782,7479,3699,3783,7482,3219
2566,93,พัทลุง,9390,ท้องถิ่นเทศบาลตำบลลานข่อย,4211,4470,8681,4216,4470,8686,3043
2566,93,พัทลุง,9391,ท้องถิ่นเทศบาลตำบลท่ามะเดื่อ,1924,2104,4028,1926,2106,4032,1889
2566,93,พัทลุง,9392,ท้องถิ่นเทศบาลตำบลป่าบอน,1940,1993,3933,1941,1993,3934,1803
2566,93,พัทลุง,9393,ท้องถิ่นเทศบาลตำบลปากพะยูน,1486,1605,3091,1490,1607,3097,1534
2566,93,พัทลุง,9394,ท้องถิ่นเทศบาลตำบลมะกอกเหนือ,991,1147,2138,993,1150,2143,809
2566,93,พัทลุง,9395,ท้องถิ่นเทศบาลตำบลควนขนุน,908,1078,1986,911,1081,1992,1202
2566,93,พัทลุง,9396,ท้องถิ่นเทศบาลตำบลแม่ขรี,2971,3220,6191,2977,3224,6201,3531
2566,93,พัทลุง,9397,ท้องถิ่นเทศบาลตำบลตะโหมด,2080,2199,4279,2080,2199,4279,1594
2566,93,พัทลุง,9398,ท้องถิ่นเทศบาลตำบลเขาชัยสน,1620,1802,3422,1624,1806,3430,1669
2566,93,พัทลุง,9399,ท้องถิ่นเทศบาลเมืองพัทลุง,14021,16488,30509,14083,16543,30626,16441
2566,94,ปัตตานี,9401,อำเภอเมืองปัตตานี,44268,47028,91296,44347,47093,91440,33109
2566,94,ปัตตานี,9402,อำเภอโคกโพธิ์,30700,32217,62917,30717,32224,62941,18478
2566,94,ปัตตานี,9403,อำเภอหนองจิก,30153,30607,60760,30160,30609,60769,14239
2566,94,ปัตตานี,9404,อำเภอปะนาเระ,18292,18939,37231,18301,18945,37246,9928
2566,94,ปัตตานี,9405,อำเภอมายอ,28507,29109,57616,28523,29124,57647,13423
2566,94,ปัตตานี,9406,อำเภอทุ่งยางแดง,12756,13208,25964,12760,13214,25974,6142
2566,94,ปัตตานี,9407,อำเภอสายบุรี,28279,29534,57813,28289,29540,57829,14125
2566,94,ปัตตานี,9408,อำเภอไม้แก่น,6477,6717,13194,6477,6718,13195,3569
2566,94,ปัตตานี,9409,อำเภอยะหริ่ง,35980,36404,72384,36021,36439,72460,16801
2566,94,ปัตตานี,9410,อำเภอยะรัง,46041,46265,92306,46062,46278,92340,22393
2566,94,ปัตตานี,9411,อำเภอกะพ้อ,9569,9826,19395,9571,9828,19399,4628
2566,94,ปัตตานี,9412,อำเภอแม่ลาน,8851,9077,17928,8857,9083,17940,4723
2566,94,ปัตตานี,9488,ท้องถิ่นเทศบาลตำบลยะรัง,2502,2655,5157,2503,2655,5158,1427
2566,94,ปัตตานี,9489,ท้องถิ่นเทศบาลตำบลยะหริ่ง,3171,3071,6242,3173,3073,6246,1995
2566,94,ปัตตานี,9490,ท้องถิ่นเทศบาลตำบลบางปู,5248,5330,10578,5250,5331,10581,2403
2566,94,ปัตตานี,9491,ท้องถิ่นเทศบาลตำบลตันหยง,1357,1536,2893,1361,1537,2898,753
2566,94,ปัตตานี,9492,ท้องถิ่นเทศบาลตำบลมายอ,2474,2496,4970,2477,2497,4974,1280
2566,94,ปัตตานี,9493,ท้องถิ่นเทศบาลตำบลปะนาเระ,5435,5444,10879,5436,5445,10881,2846
2566,94,ปัตตานี,9494,ท้องถิ่นเทศบาลตำบลหนองจิก,3111,3133,6244,3116,3140,6256,2079
2566,94,ปัตตานี,9495,ท้องถิ่นเทศบาลตำบลบ่อทอง,9453,6525,15978,9458,6529,15987,6085
2566,94,ปัตตานี,9496,ท้องถิ่นเทศบาลตำบลนาประดู่,1464,1608,3072,1468,1609,3077,1454
2566,94,ปัตตานี,9497,ท้องถิ่นเทศบาลตำบลโคกโพธิ์,1579,1802,3381,1580,1803,3383,1904
2566,94,ปัตตานี,9498,ท้องถิ่นเทศบาลเมืองตะลุบัน,7135,7361,14496,7159,7382,14541,4647
2566,94,ปัตตานี,9499,ท้องถิ่นเทศบาลเมืองปัตตานี,20793,22072,42865,21330,22585,43915,16471
2566,95,ยะลา,9501,อำเภอเมืองยะลา,38531,39521,78052,38540,39527,78067,19838
2566,95,ยะลา,9502,อำเภอเบตง,18512,17381,35893,18752,17680,36432,16145
2566,95,ยะลา,9503,อำเภอบันนังสตา,29259,28227,57486,29313,28276,57589,16417
2566,95,ยะลา,9504,อำเภอธารโต,12816,11842,24658,12878,11883,24761,9348
2566,95,ยะลา,9505,อำเภอยะหา,31647,31473,63120,31656,31477,63133,15067
2566,95,ยะลา,9506,อำเภอรามัน,43473,44358,87831,43489,44367,87856,21493
2566,95,ยะลา,9507,อำเภอกาบัง,13329,12722,26051,13343,12733,26076,7382
2566,95,ยะลา,9508,อำเภอกรงปินัง,15556,15325,30881,15560,15325,30885,6615
2566,95,ยะลา,9590,ท้องถิ่นเทศบาลเมืองสะเตงนอก,17900,19279,37179,17909,19290,37199,16821
2566,95,ยะลา,9591,ท้องถิ่นเทศบาลตำบลเขื่อนบางลาง,2409,2212,4621,2409,2212,4621,2062
2566,95,ยะลา,9592,ท้องถิ่นเทศบาลตำบลโกตาบารู,2915,3042,5957,2917,3042,5959,1776
2566,95,ยะลา,9593,ท้องถิ่นเทศบาลตำบลเมืองรามันห์,2503,2577,5080,2508,2578,5086,1931
2566,95,ยะลา,9594,ท้องถิ่นเทศบาลตำบลยะหา,1240,1198,2438,1240,1198,2438,806
2566,95,ยะลา,9595,ท้องถิ่นเทศบาลตำบลคอกช้าง,728,718,1446,728,718,1446,599
2566,95,ยะลา,9596,ท้องถิ่นเทศบาลตำบลบันนังสตา,1279,1280,2559,1279,1280,2559,1041
2566,95,ยะลา,9597,ท้องถิ่นเทศบาลตำบลลำใหม่,496,506,1002,496,506,1002,388
2566,95,ยะลา,9598,ท้องถิ่นเทศบาลเมืองเบตง,12433,13427,25860,12522,13530,26052,11588
2566,95,ยะลา,9599,ท้องถิ่นเทศบาลนครยะลา,27435,30789,58224,27709,31076,58785,29400
2566,96,นราธิวาส,9601,อำเภอเมืองนราธิวาส,44072,43575,87647,44109,43602,87711,27781
2566,96,นราธิวาส,9602,อำเภอตากใบ,27222,27927,55149,27245,27942,55187,12628
2566,96,นราธิวาส,9603,อำเภอบาเจาะ,20703,21405,42108,20715,21411,42126,9796
2566,96,นราธิวาส,9604,อำเภอยี่งอ,22126,22819,44945,22138,22833,44971,10959
2566,96,นราธิวาส,9605,อำเภอระแงะ,39043,40468,79511,39056,40479,79535,18172
2566,96,นราธิวาส,9606,อำเภอรือเสาะ,33870,34045,67915,33875,34049,67924,16294
2566,96,นราธิวาส,9607,อำเภอศรีสาคร,19031,18507,37538,19041,18517,37558,9887
2566,96,นราธิวาส,9608,อำเภอแว้ง,21927,22400,44327,21953,22432,44385,10831
2566,96,นราธิวาส,9609,อำเภอสุคิริน,11804,11358,23162,11809,11371,23180,7588
2566,96,นราธิวาส,9610,อำเภอสุไหงโกลก,18726,19952,38678,18747,19968,38715,11670
2566,96,นราธิวาส,9611,อำเภอสุไหงปาดี,24142,24813,48955,24172,24837,49009,12660
2566,96,นราธิวาส,9612,อำเภอจะแนะ,20369,19844,40213,20388,19854,40242,10046
2566,96,นราธิวาส,9613,อำเภอเจาะไอร้อง,20708,20825,41533,20719,20831,41550,10094
2566,96,นราธิวาส,9686,ท้องถิ่นเทศบาลตำบลปะลุรู,3372,3568,6940,3388,3582,6970,2147
2566,96,นราธิวาส,9687,ท้องถิ่นเทศบาลตำบลสุคิริน,1688,1642,3330,1694,1654,3348,1639
2566,96,นราธิวาส,9688,ท้องถิ่นเทศบาลตำบลแว้ง,2567,2714,5281,2568,2716,5284,1718
2566,96,นราธิวาส,9689,ท้องถิ่นเทศบาลตำบลบูเก๊ะตา,2524,2693,5217,2526,2694,5220,1457
2566,96,นราธิวาส,9690,ท้องถิ่นเทศบาลตำบลศรีสาคร,2599,2522,5121,2612,2530,5142,1887
2566,96,นราธิวาส,9691,ท้องถิ่นเทศบาลตำบลรือเสาะ,3664,3817,7481,3684,3823,7507,3701
2566,96,นราธิวาส,9692,ท้องถิ่นเทศบาลตำบลมะรือโบตก,4345,4243,8588,4349,4244,8593,1822
2566,96,นราธิวาส,9693,ท้องถิ่นเทศบาลตำบลตันหยงมัส,3262,3516,6778,3291,3532,6823,3900
2566,96,นราธิวาส,9694,ท้องถิ่นเทศบาลตำบลยี่งอ,1556,1539,3095,1560,1540,3100,1130
2566,96,นราธิวาส,9695,ท้องถิ่นเทศบาลตำบลบาเจาะ,4833,4864,9697,4838,4870,9708,2358
2566,96,นราธิวาส,9696,ท้องถิ่นเทศบาลตำบลต้นไทร,2406,2652,5058,2407,2652,5059,1472
2566,96,นราธิวาส,9697,ท้องถิ่นเทศบาลเมืองตากใบ,9704,10295,19999,9713,10309,20022,5929
2566,96,นราธิวาส,9698,ท้องถิ่นเทศบาลเมืองสุไหงโกลก,18763,20925,39688,18912,21072,39984,15785
2566,96,นราธิวาส,9699,ท้องถิ่นเทศบาลเมืองนราธิวาส,19493,20527,40020,19661,20648,40309,16480
2567,10,กรุงเทพมหานคร,1001,เขตพระนคร,18679,19968,38647,19110,20235,39345,19016
2567,10,กรุงเทพมหานคร,1002,เขตดุสิต,38928,34201,73129,39732,34852,74584,32869
2567,10,กรุงเทพมหานคร,1003,เขตหนองจอก,89893,95625,185518,90282,95945,186227,74844
2567,10,กรุงเทพมหานคร,1004,เขตบางรัก,15608,19100,34708,19497,22204,41701,36025
2567,10,กรุงเทพมหานคร,1005,เขตบางเขน,85109,98118,183227,85680,98551,184231,119489
2567,10,กรุงเทพมหานคร,1006,เขตบางกะปิ,62612,76559,139171,63927,77485,141412,117821
2567,10,กรุงเทพมหานคร,1007,เขตปทุมวัน,16927,19595,36522,18530,20869,39399,32452
2567,10,กรุงเทพมหานคร,1008,เขตป้อมปราบศัตรูพ่าย,16919,18004,34923,18021,18884,36905,19623
2567,10,กรุงเทพมหานคร,1009,เขตพระโขนง,37490,46789,84279,37951,47119,85070,65282
2567,10,กรุงเทพมหานคร,1010,เขตมีนบุรี,65496,74206,139702,66126,74626,140752,66394
2567,10,กรุงเทพมหานคร,1011,เขตลาดกระบัง,84888,95297,180185,85480,95773,181253,108362
2567,10,กรุงเทพมหานคร,1012,เขตยานนาวา,32299,38434,70733,33567,39266,72833,54412
2567,10,กรุงเทพมหานคร,1013,เขตสัมพันธวงศ์,8765,9458,18223,9144,9701,18845,13160
2567,10,กรุงเทพมหานคร,1014,เขตพญาไท,29546,32344,61890,30205,32820,63025,46536
2567,10,กรุงเทพมหานคร,1015,เขตธนบุรี,44456,51358,95814,45180,51989,97169,65530
2567,10,กรุงเทพมหานคร,1016,เขตบางกอกใหญ่,27463,31764,59227,27759,32038,59797,32954
2567,10,กรุงเทพมหานคร,1017,เขตห้วยขวาง,35907,45464,81371,37334,46624,83958,95001
2567,10,กรุงเทพมหานคร,1018,เขตคลองสาน,27162,32687,59849,29066,34291,63357,42956
2567,10,กรุงเทพมหานคร,1019,เขตตลิ่งชัน,46586,53681,100267,46929,53958,100887,45173
2567,10,กรุงเทพมหานคร,1020,เขตบางกอกน้อย,43867,50898,94765,44877,51868,96745,55591
2567,10,กรุงเทพมหานคร,1021,เขตบางขุนเทียน,86195,97836,184031,87025,98570,185595,95111
2567,10,กรุงเทพมหานคร,1022,เขตภาษีเจริญ,55552,65187,120739,56096,65620,121716,69711
2567,10,กรุงเทพมหานคร,1023,เขตหนองแขม,71243,82607,153850,71814,83142,154956,66262
2567,10,กรุงเทพมหานคร,1024,เขตราษฎร์บูรณะ,35160,38897,74057,35669,39308,74977,39190
2567,10,กรุงเทพมหานคร,1025,เขตบางพลัด,38706,47207,85913,39053,47518,86571,60745
2567,10,กรุงเทพมหานคร,1026,เขตดินแดง,48801,58428,107229,50731,60049,110780,65046
2567,10,กรุงเทพมหานคร,1027,เขตบึงกุ่ม,61258,73954,135212,61733,74375,136108,77441
2567,10,กรุงเทพมหานคร,1028,เขตสาทร,31550,35974,67524,33209,37111,70320,45256
2567,10,กรุงเทพมหานคร,1029,เขตบางซื่อ,53442,63055,116497,54023,63483,117506,78559
2567,10,กรุงเทพมหานคร,1030,เขตจตุจักร,69689,83463,153152,70502,83998,154500,140621
2567,10,กรุงเทพมหานคร,1031,เขตบางคอแหลม,34780,39618,74398,35777,40447,76224,40867
2567,10,กรุงเทพมหานคร,1032,เขตประเวศ,84383,97040,181423,86073,98282,184355,97910
2567,10,กรุงเทพมหานคร,1033,เขตคลองเตย,40430,46043,86473,41969,47044,89013,83803
2567,10,กรุงเทพมหานคร,1034,เขตสวนหลวง,54640,66362,121002,56013,67392,123405,85646
2567,10,กรุงเทพมหานคร,1035,เขตจอมทอง,64276,72662,136938,65638,73789,139427,74595
2567,10,กรุงเทพมหานคร,1036,เขตดอนเมือง,81954,83337,165291,82415,83632,166047,83308
2567,10,กรุงเทพมหานคร,1037,เขตราชเทวี,26869,30846,57715,29553,33079,62632,58075
2567,10,กรุงเทพมหานคร,1038,เขตลาดพร้าว,50246,61067,111313,50667,61419,112086,60732
2567,10,กรุงเทพมหานคร,1039,เขตวัฒนา,30006,36928,66934,37206,43066,80272,87305
2567,10,กรุงเทพมหานคร,1040,เขตบางแค,87836,102875,190711,88757,103724,192481,97890
2567,10,กรุงเทพมหานคร,1041,เขตหลักสี่,46382,51319,97701,46653,51524,98177,62353
2567,10,กรุงเทพมหานคร,1042,เขตสายไหม,97887,112521,210408,99098,113477,212575,112297
2567,10,กรุงเทพมหานคร,1043,เขตคันนายาว,39842,47010,86852,43668,50526,94194,48118
2567,10,กรุงเทพมหานคร,1044,เขตสะพานสูง,44254,52678,96932,44684,52975,97659,43914
2567,10,กรุงเทพมหานคร,1045,เขตวังทองหลาง,46084,56061,102145,46600,56456,103056,65168
2567,10,กรุงเทพมหานคร,1046,เขตคลองสามวา,99813,113504,213317,100401,113910,214311,93955
2567,10,กรุงเทพมหานคร,1047,เขตบางนา,38080,45139,83219,39112,45889,85001,78445
2567,10,กรุงเทพมหานคร,1048,เขตทวีวัฒนา,36523,42823,79346,37026,43323,80349,37042
2567,10,กรุงเทพมหานคร,1049,เขตทุ่งครุ,57224,65999,123223,57702,66362,124064,57688
2567,10,กรุงเทพมหานคร,1050,เขตบางบอน,46086,51050,97136,47136,52032,99168,53919
2567,11,สมุทรปราการ,1101,อำเภอเมืองสมุทรปราการ,60950,68230,129180,61166,68415,129581,61601
2567,11,สมุทรปราการ,1102,อำเภอบางบ่อ,47919,51400,99319,48301,51734,100035,52769
2567,11,สมุทรปราการ,1103,อำเภอบางพลี,132358,151320,283678,133427,152067,285494,192624
2567,11,สมุทรปราการ,1104,อำเภอพระประแดง,17816,19389,37205,17857,19426,37283,13733
2567,11,สมุทรปราการ,1105,อำเภอพระสมุทรเจดีย์,60589,66387,126976,60736,66527,127263,61264
2567,11,สมุทรปราการ,1106,อำเภอบางเสาธง,30291,32966,63257,30437,33064,63501,48202
2567,11,สมุทรปราการ,1183,ท้องถิ่นเทศบาลเมืองปากน้ำสมุทรปราการ,19048,21961,41009,19139,22020,41159,17887
2567,11,สมุทรปราการ,1184,ท้องถิ่นเทศบาลตำบลบางเสาธง,9536,10628,20164,9566,10654,20220,18771
2567,11,สมุทรปราการ,1185,ท้องถิ่นเทศบาลตำบลแหลมฟ้าผ่า,10663,11316,21979,10700,11358,22058,9612
2567,11,สมุทรปราการ,1186,ท้องถิ่นเทศบาลตำบลพระสมุทรเจดีย์,5258,5514,10772,5441,5681,11122,5764
2567,11,สมุทรปราการ,1187,ท้องถิ่นเทศบาลตำบลบางพลี,3188,3358,6546,5358,5382,10740,2252
2567,11,สมุทรปราการ,1188,ท้องถิ่นเทศบาลตำบลบางบ่อ,3067,3383,6450,3087,3393,6480,2520
2567,11,สมุทรปราการ,1189,ท้องถิ่นเทศบาลตำบลคลองสวน,1366,1420,2786,1368,1420,2788,928
2567,11,สมุทรปราการ,1190,ท้องถิ่นเทศบาลตำบลคลองด่าน,5366,5644,11010,5388,5663,11051,3327
2567,11,สมุทรปราการ,1191,ท้องถิ่นเทศบาลตำบลบางปู,57057,62293,119350,57311,62508,119819,62862
2567,11,สมุทรปราการ,1192,ท้องถิ่นเทศบาลตำบลแพรกษา,12019,13759,25778,12070,13823,25893,15843
2567,11,สมุทรปราการ,1193,ท้องถิ่นเทศบาลตำบลบางเมือง,44233,51081,95314,44467,51284,95751,50820
2567,11,สมุทรปราการ,1194,ท้องถิ่นเทศบาลตำบลด่านสำโรง,24781,28513,53294,24941,28638,53579,29381
2567,11,สมุทรปราการ,1195,ท้องถิ่นเทศบาลเมืองปู่เจ้าสมิงพราย,32511,34835,67346,32662,34961,67623,36471
2567,11,สมุทรปราการ,1196,ท้องถิ่นเทศบาลตำบลสำโรงเหนือ,13590,16666,30256,13772,16775,30547,31575
2567,11,สมุทรปราการ,1197,ท้องถิ่นเทศบาลเมืองลัดหลวง,30787,34011,64798,31356,34584,65940,38716
2567,11,สมุทรปราการ,1198,ท้องถิ่นเทศบาลเมืองพระประแดง,3785,4067,7852,3836,4128,7964,2187
2567,11,สมุทรปราการ,1199,ท้องถิ่นเทศบาลนครสมุทรปราการ,19504,21217,40721,21671,23264,44935,24121
2567,12,นนทบุรี,1201,อำเภอเมืองนนทบุรี,27448,31986,59434,27551,32083,59634,32547
2567,12,นนทบุรี,1202,อำเภอบางกรวย,16901,20008,36909,16983,20085,37068,21583
2567,12,นนทบุรี,1203,อำเภอบางใหญ่,51686,60488,112174,52035,60762,112797,57746
2567,12,นนทบุรี,1204,อำเภอบางบัวทอง,70751,81034,151785,71049,81309,152358,87928
2567,12,นนทบุรี,1205,อำเภอไทรน้อย,35527,39453,74980,35700,39636,75336,37897
2567,12,นนทบุรี,1206,อำเภอปากเกร็ด,25151,28174,53325,25423,28622,54045,27816
2567,12,นนทบุรี,1285,ท้องถิ่นเทศบาลเมืองบางคูรัด,18959,22163,41122,19010,22221,41231,17483
2567,12,นนทบุรี,1286,ท้องถิ่นเทศบาลเมืองเสาธงหิน,18114,22029,40143,18241,22123,40364,27183
2567,12,นนทบุรี,1287,ท้องถิ่นเทศบาลเมืองบางพลับ,5616,6516,12132,5654,6530,12184,7024
2567,12,นนทบุรี,1288,ท้องถิ่นเทศบาลเมืองพิมลราช,23814,28107,51921,23889,28185,52074,25259
2567,12,นนทบุรี,1289,ท้องถิ่นเทศบาลเมืองศาลากลาง,11371,13497,24868,11408,13521,24929,13668
2567,12,นนทบุรี,1290,ท้องถิ่นเทศบาลเมืองไทรม้า,11195,13322,24517,11264,13370,24634,16101
2567,12,นนทบุรี,1291,ท้องถิ่นเทศบาลตำบลไทรน้อย,1266,1294,2560,1294,1305,2599,1237
2567,12,นนทบุรี,1292,ท้องถิ่นเทศบาลเมืองบางใหญ่,6588,7348,13936,6621,7376,13997,6572
2567,12,นนทบุรี,1293,ท้องถิ่นเทศบาลตำบลบางม่วง,2914,3062,5976,2932,3071,6003,2847
2567,12,นนทบุรี,1294,ท้องถิ่นเทศบาลเมืองปลายบาง,22072,26212,48284,22198,26310,48508,24758
2567,12,นนทบุรี,1295,ท้องถิ่นเทศบาลเมืองบางศรีเมือง,15202,17879,33081,15241,17920,33161,13922
2567,12,นนทบุรี,1296,ท้องถิ่นเทศบาลเมืองบางกรวย,20129,24005,44134,20294,24158,44452,23084
2567,12,นนทบุรี,1297,ท้องถิ่นเทศบาลนครปากเกร็ด,85770,101150,186920,86885,101978,188863,141775
2567,12,นนทบุรี,1298,ท้องถิ่นเทศบาลนครบางบัวทอง,23740,28306,52046,23979,28520,52499,27957
2567,12,นนทบุรี,1299,ท้องถิ่นเทศบาลนครนนทบุรี,110151,127588,237739,112071,129112,241183,153834
2567,13,ปทุมธานี,1301,อำเภอเมืองปทุมธานี,49157,54225,103382,49341,54354,103695,53829
2567,13,ปทุมธานี,1302,อำเภอคลองหลวง,74212,82714,156926,74503,82914,157417,79158
2567,13,ปทุมธานี,1303,อำเภอธัญบุรี,0,0,0,0,0,0,0
2567,13,ปทุมธานี,1304,อำเภอหนองเสือ,26241,26812,53053,26334,26896,53230,18370
2567,13,ปทุมธานี,1305,อำเภอลาดหลุมแก้ว,30081,31777,61858,30143,31837,61980,32552
2567,13,ปทุมธานี,1306,อำเภอลำลูกกา,44300,47584,91884,44499,47784,92283,47687
2567,13,ปทุมธานี,1307,อำเภอสามโคก,22431,24018,46449,22500,24085,46585,21923
2567,13,ปทุมธานี,1379,ท้องถิ่นเทศบาลเมืองลาดสวาย,34219,39618,73837,34392,39735,74127,43060
2567,13,ปทุมธานี,1380,ท้องถิ่นเทศบาลตำบลบางพูน,12508,14154,26662,12562,14183,26745,22598
2567,13,ปทุมธานี,1381,ท้องถิ่นเทศบาลตำบลบ้านกลาง,6235,7118,13353,6278,7143,13421,7614
2567,13,ปทุมธานี,1382,ท้องถิ่นเทศบาลเมืองลำสามแก้ว,30267,35293,65560,30376,35368,65744,34215
2567,13,ปทุมธานี,1383,ท้องถิ่นเทศบาลเมืองบางคูวัด,15417,17897,33314,15493,17926,33419,21232
2567,13,ปทุมธานี,1384,ท้องถิ่นเทศบาลเมืองบึงยี่โถ,15717,18756,34473,15807,18801,34608,16961
2567,13,ปทุมธานี,1386,ท้องถิ่นเทศบาลเมืองบางกะดี,7624,8797,16421,7665,8824,16489,9185
2567,13,ปทุมธานี,1387,ท้องถิ่นเทศบาลตำบลบางเตย,5518,5909,11427,5540,5929,11469,5209
2567,13,ปทุมธานี,1388,ท้องถิ่นเทศบาลตำบลลำลูกกา,10175,11394,21569,10211,11422,21633,11782
2567,13,ปทุมธานี,1389,ท้องถิ่นเทศบาลตำบลลำไทร,1282,1347,2629,1334,1399,2733,1088
2567,13,ปทุมธานี,1390,ท้องถิ่นเทศบาลตำบลระแหง,5357,5753,11110,5387,5788,11175,6073
2567,13,ปทุมธานี,1391,ท้องถิ่นเทศบาลตำบลหนองเสือ,1989,2047,4036,1995,2067,4062,2019
2567,13,ปทุมธานี,1392,ท้องถิ่นเทศบาลเมืองสนั่นรักษ์,15587,17491,33078,15645,17542,33187,18204
2567,13,ปทุมธานี,1393,ท้องถิ่นเทศบาลตำบลธัญบุรี,30371,34134,64505,31208,34678,65886,35018
2567,13,ปทุมธานี,1394,ท้องถิ่นเทศบาลเมืองคลองหลวง,34457,39562,74019,34625,39684,74309,65588
2567,13,ปทุมธานี,1395,ท้องถิ่นเทศบาลตำบลบางหลวง,3741,4208,7949,3751,4220,7971,4625
2567,13,ปทุมธานี,1396,ท้องถิ่นเทศบาลเมืองท่าโขลง,33462,38387,71849,34959,39828,74787,60771
2567,13,ปทุมธานี,1397,ท้องถิ่นเทศบาลเมืองคูคต,19633,22063,41696,19829,22243,42072,29248
2567,13,ปทุมธานี,1398,ท้องถิ่นเทศบาลนครรังสิต,39151,45682,84833,39418,45906,85324,58403
2567,13,ปทุมธานี,1399,ท้องถิ่นเทศบาลเมืองปทุมธานี,9188,10531,19719,10375,11745,22120,9684
2567,14,พระนครศรีอยุธยา,1401,อำเภอพระนครศรีอยุธยา,34419,37858,72277,34471,37891,72362,27558
2567,14,พระนครศรีอยุธยา,1402,อำเภอท่าเรือ,14664,16162,30826,14680,16177,30857,12016
2567,14,พระนครศรีอยุธยา,1403,อำเภอนครหลวง,10515,11542,22057,10547,11571,22118,12395
2567,14,พระนครศรีอยุธยา,1404,อำเภอบางไทร,15250,16094,31344,15281,16112,31393,11241
2567,14,พระนครศรีอยุธยา,1405,อำเภอบางบาล,6815,7396,14211,6817,7399,14216,5639
2567,14,พระนครศรีอยุธยา,1406,อำเภอบางปะอิน,19002,20895,39897,19043,20931,39974,19079
2567,14,พระนครศรีอยุธยา,1407,อำเภอบางปะหัน,17313,18495,35808,17399,18569,35968,13122
2567,14,พระนครศรีอยุธยา,1408,อำเภอผักไห่,10390,11209,21599,10398,11217,21615,7573
2567,14,พระนครศรีอยุธยา,1409,อำเภอภาชี,12533,13283,25816,12548,13293,25841,8876
2567,14,พระนครศรีอยุธยา,1410,อำเภอลาดบัวหลวง,14616,15000,29616,14649,15025,29674,10235
2567,14,พระนครศรีอยุธยา,1411,อำเภอวังน้อย,28500,30166,58666,28592,30246,58838,28560
2567,14,พระนครศรีอยุธยา,1412,อำเภอเสนา,14762,15663,30425,14780,15677,30457,10296
2567,14,พระนครศรีอยุธยา,1413,อำเภอบางซ้าย,6721,6882,13603,6745,6895,13640,4652
2567,14,พระนครศรีอยุธยา,1414,อำเภออุทัย,22574,24485,47059,22617,24526,47143,23369
2567,14,พระนครศรีอยุธยา,1415,อำเภอมหาราช,6361,6982,13343,6364,6984,13348,5342
2567,14,พระนครศรีอยุธยา,1416,อำเภอบ้านแพรก,3115,3565,6680,3121,3568,6689,2766
2567,14,พระนครศรีอยุธยา,1465,ท้องถิ่นเทศบาลเมืองบ้านกรด,6917,8109,15026,6931,8122,15053,10719
2567,14,พระนครศรีอยุธยา,1466,ท้องถิ่นเทศบาลตำบลสามเมือง,3642,3793,7435,3670,3823,7493,3061
2567,14,พระนครศรีอยุธยา,1467,ท้องถิ่นเทศบาลตำบลสามกอ,3158,3517,6675,3199,3550,6749,3047
2567,14,พระนครศรีอยุธยา,1468,ท้องถิ่นเทศบาลตำบลบางนมโค,3666,4137,7803,3673,4150,7823,4352
2567,14,พระนครศรีอยุธยา,1469,ท้องถิ่นเทศบาลตำบลบางกระสั้น,6313,7312,13625,6321,7321,13642,6045
2567,14,พระนครศรีอยุธยา,1470,ท้องถิ่นเทศบาลตำบลเชียงรากน้อย,4939,5279,10218,4982,5303,10285,4727
2567,14,พระนครศรีอยุธยา,1471,ท้องถิ่นเทศบาลตำบลคลองจิก,4588,5158,9746,4598,5163,9761,6103
2567,14,พระนครศรีอยุธยา,1472,ท้องถิ่นเทศบาลตำบลปราสาททอง,2444,2800,5244,2487,2823,5310,3511
2567,14,พระนครศรีอยุธยา,1473,ท้องถิ่นเทศบาลตำบลบ้านแพรก,920,997,1917,921,1000,1921,892
2567,14,พระนครศรีอยุธยา,1474,ท้องถิ่นเทศบาลตำบลโรงช้าง,2909,3177,6086,2913,3180,6093,2573
2567,14,พระนครศรีอยุธยา,1475,ท้องถิ่นเทศบาลตำบลมหาราช,1536,1628,3164,1541,1631,3172,1506
2567,14,พระนครศรีอยุธยา,1476,ท้องถิ่นเทศบาลตำบลอุทัย,3454,3974,7428,3461,3980,7441,4734
2567,14,พระนครศรีอยุธยา,1477,ท้องถิ่นเทศบาลตำบลบางซ้าย,2506,2676,5182,2507,2679,5186,1957
2567,14,พระนครศรีอยุธยา,1478,ท้องถิ่นเทศบาลตำบลหัวเวียง,2710,2955,5665,2710,2955,5665,1860
2567,14,พระนครศรีอยุธยา,1479,ท้องถิ่นเทศบาลเมืองลำตาเสา,10680,11319,21999,10705,11338,22043,10322
2567,14,พระนครศรีอยุธยา,1480,ท้องถิ่นเทศบาลตำบลลาดบัวหลวง,1260,1301,2561,1264,1308,2572,1459
2567,14,พระนครศรีอยุธยา,1481,ท้องถิ่นเทศบาลตำบลภาชี,2399,2735,5134,2417,2758,5175,2642
2567,14,พระนครศรีอยุธยา,1482,ท้องถิ่นเทศบาลตำบลลาดชะโด,3522,3701,7223,3530,3701,7231,2858
2567,14,พระนครศรีอยุธยา,1483,ท้องถิ่นเทศบาลเมืองผักไห่,4395,4678,9073,4401,4688,9089,4451
2567,14,พระนครศรีอยุธยา,1484,ท้องถิ่นเทศบาลตำบลพระอินทราชา,4420,5013,9433,4436,5032,9468,6919
2567,14,พระนครศรีอยุธยา,1485,ท้องถิ่นเทศบาลเมืองบ้านสร้าง,5311,6141,11452,5322,6152,11474,7605
2567,14,พระนครศรีอยุธยา,1486,ท้องถิ่นเทศบาลตำบลบางปะอิน,3117,3217,6334,3124,3222,6346,2210
2567,14,พระนครศรีอยุธยา,1487,ท้องถิ่นเทศบาลตำบลบางปะหัน,2410,2705,5115,2413,2707,5120,2280
2567,14,พระนครศรีอยุธยา,1488,ท้องถิ่นเทศบาลตำบลมหาพราหมณ์,4035,4282,8317,4037,4286,8323,3426
2567,14,พระนครศรีอยุธยา,1489,ท้องถิ่นเทศบาลตำบลบางบาล,5093,5588,10681,5094,5592,10686,3851
2567,14,พระนครศรีอยุธยา,1490,ท้องถิ่นเทศบาลตำบลราชคราม,2998,3077,6075,3011,3090,6101,1900
2567,14,พระนครศรีอยุธยา,1491,ท้องถิ่นเทศบาลเมืองบางไทร,4899,5119,10018,4910,5127,10037,4048
2567,14,พระนครศรีอยุธยา,1492,ท้องถิ่นเทศบาลตำบลอรัญญิก,3652,3905,7557,3653,3907,7560,2910
2567,14,พระนครศรีอยุธยา,1493,ท้องถิ่นเทศบาลตำบลนครหลวง,3226,3518,6744,3229,3520,6749,3079
2567,14,พระนครศรีอยุธยา,1494,ท้องถิ่นเทศบาลตำบลท่าหลวง,3786,4236,8022,3793,4241,8034,4190
2567,14,พระนครศรีอยุธยา,1495,ท้องถิ่นเทศบาลเมืองอโยธยา,9020,10614,19634,9053,10645,19698,11524
2567,14,พระนครศรีอยุธยา,1496,ท้องถิ่นเทศบาลเมืองเจ้าเจ็ด,5015,5468,10483,5066,5525,10591,3362
2567,14,พระนครศรีอยุธยา,1497,ท้องถิ่นเทศบาลตำบลท่าเรือ,2896,3305,6201,2910,3318,6228,3261
2567,14,พระนครศรีอยุธยา,1498,ท้องถิ่นเทศบาลเมืองเสนา,1595,1785,3380,1615,1794,3409,1500
2567,14,พระนครศรีอยุธยา,1499,ท้องถิ่นเทศบาลนครพระนครศรีอยุธยา,22143,24474,46617,22382,24677,47059,20682
2567,15,อ่างทอง,1501,อำเภอเมืองอ่างทอง,20477,22666,43143,20501,22698,43199,17828
2567,15,อ่างทอง,1502,อำเภอไชโย,3378,3599,6977,3383,3604,6987,2535
2567,15,อ่างทอง,1503,อำเภอป่าโมก,8748,9613,18361,8767,9637,18404,6972
2567,15,อ่างทอง,1504,อำเภอโพธิ์ทอง,20361,22459,42820,20382,22485,42867,15483
2567,15,อ่างทอง,1505,อำเภอแสวงหา,14648,15383,30031,14659,15391,30050,10515
2567,15,อ่างทอง,1506,อำเภอวิเศษชัยชาญ,23847,25865,49712,23882,25891,49773,19007
2567,15,อ่างทอง,1507,อำเภอสามโก้,3982,4240,8222,3985,4246,8231,2957
2567,15,อ่างทอง,1590,ท้องถิ่นเทศบาลตำบลสามโก้,4952,5465,10417,4955,5467,10422,3734
2567,15,อ่างทอง,1591,ท้องถิ่นเทศบาลตำบลวิเศษไชยชาญ,2524,3073,5597,2539,3081,5620,3067
2567,15,อ่างทอง,1592,ท้องถิ่นเทศบาลตำบลบางจัก,3515,3864,7379,3519,3867,7386,2914
2567,15,อ่างทอง,1593,ท้องถิ่นเทศบาลตำบลแสวงหา,1487,1607,3094,1490,1611,3101,1292
2567,15,อ่างทอง,1594,ท้องถิ่นเทศบาลตำบลรำมะสัก,1946,2138,4084,1946,2140,4086,1536
2567,15,อ่างทอง,1595,ท้องถิ่นเทศบาลตำบลโพธิ์ทอง,1920,2155,4075,1923,2158,4081,1766
2567,15,อ่างทอง,1596,ท้องถิ่นเทศบาลตำบลไชโย,5916,6376,12292,5925,6380,12305,4352
2567,15,อ่างทอง,1597,ท้องถิ่นเทศบาลตำบลเกษไชโย,1303,1396,2699,1305,1398,2703,1047
2567,15,อ่างทอง,1598,ท้องถิ่นเทศบาลตำบลป่าโมก,3983,4420,8403,4001,4436,8437,3645
2567,15,อ่างทอง,1599,ท้องถิ่นเทศบาลเมืองอ่างทอง,5241,5893,11134,5283,5940,11223,6704
2567,16,ลพบุรี,1601,อำเภอเมืองลพบุรี,48843,50039,98882,48899,50068,98967,42967
2567,16,ลพบุรี,1602,อำเภอพัฒนานิคม,27052,28032,55084,27092,28062,55154,24942
2567,16,ลพบุรี,1603,อำเภอโคกสำโรง,36945,37787,74732,36982,37818,74800,29980
2567,16,ลพบุรี,1604,อำเภอชัยบาดาล,36045,36907,72952,36093,36928,73021,29362
2567,16,ลพบุรี,1605,อำเภอท่าวุ้ง,20598,22409,43007,20612,22431,43043,14624
2567,16,ลพบุรี,1606,อำเภอบ้านหมี่,31984,34753,66737,32006,34773,66779,24176
2567,16,ลพบุรี,1607,อำเภอท่าหลวง,12678,13008,25686,12697,13021,25718,8933
2567,16,ลพบุรี,1608,อำเภอสระโบสถ์,7029,6896,13925,7034,6901,13935,5500
2567,16,ลพบุรี,1609,อำเภอโคกเจริญ,12046,12071,24117,12049,12080,24129,8178
2567,16,ลพบุรี,1610,อำเภอลำสนธิ,13304,13599,26903,13320,13602,26922,9872
2567,16,ลพบุรี,1611,อำเภอหนองม่วง,13429,13918,27347,13460,13956,27416,10512
2567,16,ลพบุรี,1681,ท้องถิ่นเทศบาลตำบลกกโก,5169,6092,11261,5180,6093,11273,6169
2567,16,ลพบุรี,1682,ท้องถิ่นเทศบาลตำบลถนนใหญ่,6034,5078,11112,6044,5086,11130,5000
2567,16,ลพบุรี,1683,ท้องถิ่นเทศบาลเมืองเขาสามยอด,15125,12863,27988,15304,12993,28297,13166
2567,16,ลพบุรี,1684,ท้องถิ่นเทศบาลตำบลท่าศาลา,6708,7604,14312,6730,7628,14358,7340
2567,16,ลพบุรี,1685,ท้องถิ่นเทศบาลตำบลดีลัง,3881,4163,8044,3889,4167,8056,3955
2567,16,ลพบุรี,1686,ท้องถิ่นเทศบาลตำบลเขาพระงาม,14595,8659,23254,14600,8666,23266,12062
2567,16,ลพบุรี,1688,ท้องถิ่นเทศบาลตำบลสระโบสถ์,3335,3609,6944,3337,3610,6947,3246
2567,16,ลพบุรี,1689,ท้องถิ่นเทศบาลตำบลบ้านท่าหลวง,1849,1879,3728,1853,1882,3735,2222
2567,16,ลพบุรี,1690,ท้องถิ่นเทศบาลตำบลท่าวุ้ง,991,1052,2043,992,1053,2045,916
2567,16,ลพบุรี,1691,ท้องถิ่นเทศบาลตำบลท่าโขลง,1009,1168,2177,1017,1181,2198,1044
2567,16,ลพบุรี,1692,ท้องถิ่นเทศบาลตำบลลำนารายณ์,7186,7772,14958,7288,7844,15132,8808
2567,16,ลพบุรี,1693,ท้องถิ่นเทศบาลตำบลหนองม่วง,2293,2453,4746,2298,2454,4752,2181
2567,16,ลพบุรี,1694,ท้องถิ่นเทศบาลตำบลพัฒนานิคม,1365,1523,2888,1430,1608,3038,1485
2567,16,ลพบุรี,1695,ท้องถิ่นเทศบาลตำบลแก่งเสือเต้น,1381,1423,2804,1382,1424,2806,1151
2567,16,ลพบุรี,1696,ท้องถิ่นเทศบาลตำบลโคกตูม,14894,15293,30187,14913,15304,30217,12398
2567,16,ลพบุรี,1697,ท้องถิ่นเทศบาลตำบลโคกสำโรง,2629,2853,5482,2636,2855,5491,2445
2567,16,ลพบุรี,1698,ท้องถิ่นเทศบาลเมืองบ้านหมี่,1383,1555,2938,1410,1572,2982,1345
2567,16,ลพบุรี,1699,ท้องถิ่นเทศบาลเมืองลพบุรี,9457,10145,19602,9493,10166,19659,12808
2567,17,สิงห์บุรี,1701,อำเภอเมืองสิงห์บุรี,16786,19303,36089,16819,19331,36150,14194
2567,17,สิงห์บุรี,1702,อำเภอบางระจัน,9145,9764,18909,9154,9773,18927,7396
2567,17,สิงห์บุรี,1703,อำเภอค่ายบางระจัน,12252,13151,25403,12264,13165,25429,9318
2567,17,สิงห์บุรี,1704,อำเภอพรหมบุรี,7575,8406,15981,7587,8421,16008,6153
2567,17,สิงห์บุรี,1705,อำเภอท่าช้าง,2478,2801,5279,2482,2803,5285,1928
2567,17,สิงห์บุรี,1706,อำเภออินทร์บุรี,22720,24658,47378,22738,24680,47418,18239
2567,17,สิงห์บุรี,1793,ท้องถิ่นเทศบาลตำบลอินทร์บุรี,1994,2192,4186,1998,2195,4193,2304
2567,17,สิงห์บุรี,1794,ท้องถิ่นเทศบาลตำบลถอนสมอ,4011,4369,8380,4017,4374,8391,3544
2567,17,สิงห์บุรี,1795,ท้องถิ่นเทศบาลตำบลพรหมบุรี,1475,1580,3055,1479,1582,3061,1335
2567,17,สิงห์บุรี,1796,ท้องถิ่นเทศบาลตำบลบางน้ำเชี่ยว,1549,1702,3251,1561,1709,3270,1426
2567,17,สิงห์บุรี,1797,ท้องถิ่นเทศบาลตำบลโพสังโฆ,908,1014,1922,910,1015,1925,868
2567,17,สิงห์บุรี,1798,ท้องถิ่นเทศบาลเมืองบางระจัน,6274,7084,13358,6289,7093,13382,5839
2567,17,สิงห์บุรี,1799,ท้องถิ่นเทศบาลเมืองสิงห์บุรี,7564,8741,16305,7597,8767,16364,9448
2567,18,ชัยนาท,1801,อำเภอเมืองชัยนาท,10938,11721,22659,10954,11729,22683,9117
2567,18,ชัยนาท,1802,อำเภอมโนรมย์,11046,12121,23167,11065,12139,23204,9341
2567,18,ชัยนาท,1803,อำเภอวัดสิงห์,10483,11197,21680,10487,11203,21690,9659
2567,18,ชัยนาท,1804,อำเภอสรรพยา,14406,15473,29879,14409,15479,29888,12121
2567,18,ชัยนาท,1805,อำเภอสรรคบุรี,28409,30933,59342,28442,30956,59398,22886
2567,18,ชัยนาท,1806,อำเภอหันคา,19435,20728,40163,19462,20748,40210,15267
2567,18,ชัยนาท,1807,อำเภอหนองมะโมง,6195,6422,12617,6199,6426,12625,5316
2567,18,ชัยนาท,1808,อำเภอเนินขาม,5239,5436,10675,5241,5436,10677,4139
2567,18,ชัยนาท,1880,ท้องถิ่นเทศบาลตำบลบางหลวง,2396,2683,5079,2396,2684,5080,2670
2567,18,ชัยนาท,1881,ท้องถิ่นเทศบาลตำบลนางลือ,3466,3871,7337,3469,3879,7348,2656
2567,18,ชัยนาท,1882,ท้องถิ่นเทศบาลตำบลเสือโฮก,3599,3785,7384,3604,3787,7391,2559
2567,18,ชัยนาท,1883,ท้องถิ่นเทศบาลตำบลหาดท่าเสา,2390,2538,4928,2391,2539,4930,1886
2567,18,ชัยนาท,1884,ท้องถิ่นเทศบาลตำบลชัยนาท,3509,4247,7756,3511,4250,7761,2794
2567,18,ชัยนาท,1885,ท้องถิ่นเทศบาลตำบลบ้านกล้วย,3312,3771,7083,3322,3775,7097,3800
2567,18,ชัยนาท,1887,ท้องถิ่นเทศบาลตำบลหนองแซง,3679,3841,7520,3682,3844,7526,2908
2567,18,ชัยนาท,1889,ท้องถิ่นเทศบาลตำบลวังตะเคียน,3211,3380,6591,3212,3381,6593,2587
2567,18,ชัยนาท,1890,ท้องถิ่นเทศบาลตำบลเนินขาม,2799,3095,5894,2799,3095,5894,2800
2567,18,ชัยนาท,1891,ท้องถิ่นเทศบาลตำบลหันคา,1843,2067,3910,1845,2070,3915,2504
2567,18,ชัยนาท,1892,ท้องถิ่นเทศบาลตำบลสามง่ามท่าโบสถ์,596,644,1240,597,644,1241,492
2567,18,ชัยนาท,1893,ท้องถิ่นเทศบาลตำบลแพรกศรีราชา,1102,1253,2355,1110,1264,2374,1401
2567,18,ชัยนาท,1894,ท้องถิ่นเทศบาลตำบลสรรพยา,1421,1509,2930,1421,1509,2930,1399
2567,18,ชัยนาท,1895,ท้องถิ่นเทศบาลตำบลโพธิ์พิทักษ์,689,781,1470,689,781,1470,585
2567,18,ชัยนาท,1896,ท้องถิ่นเทศบาลตำบลหางน้ำสาคร,2873,3136,6009,2886,3140,6026,3329
2567,18,ชัยนาท,1897,ท้องถิ่นเทศบาลตำบลคุ้งสำเภา,841,926,1767,845,929,1774,1015
2567,18,ชัยนาท,1898,ท้องถิ่นเทศบาลตำบลวัดสิงห์,1414,1585,2999,1418,1587,3005,1989
2567,18,ชัยนาท,1899,ท้องถิ่นเทศบาลเมืองชัยนาท,5002,5956,10958,5039,5990,11029,7688
2567,19,สระบุรี,1901,อำเภอเมืองสระบุรี,25985,22556,48541,26031,22612,48643,21717
2567,19,สระบุรี,1902,อำเภอแก่งคอย,34729,35746,70475,34838,35823,70661,33528
2567,19,สระบุรี,1903,อำเภอหนองแค,33095,35247,68342,33161,35329,68490,36588
2567,19,สระบุรี,1904,อำเภอวิหารแดง,16222,16960,33182,16252,17001,33253,12991
2567,19,สระบุรี,1905,อำเภอหนองแซง,6150,6868,13018,6158,6875,13033,4803
2567,19,สระบุรี,1906,อำเภอบ้านหมอ,15132,16185,31317,15150,16198,31348,13085
2567,19,สระบุรี,1907,อำเภอดอนพุด,977,1072,2049,977,1072,2049,685
2567,19,สระบุรี,1908,อำเภอหนองโดน,5490,5820,11310,5497,5825,11322,4811
2567,19,สระบุรี,1909,อำเภอพระพุทธบาท,12149,12962,25111,12169,12970,25139,10928
2567,19,สระบุรี,1910,อำเภอเสาไห้,10587,11618,22205,10617,11643,22260,9050
2567,19,สระบุรี,1911,อำเภอมวกเหล็ก,24904,24950,49854,24982,24992,49974,23406
2567,19,สระบุรี,1912,อำเภอวังม่วง,5632,5924,11556,5638,5929,11567,4845
2567,19,สระบุรี,1913,อำเภอเฉลิมพระเกียรติ,14801,15731,30532,14832,15760,30592,13862
2567,19,สระบุรี,1974,ท้องถิ่นเทศบาลตำบลพุกร่าง,3295,3498,6793,3295,3502,6797,2581
2567,19,สระบุรี,1975,ท้องถิ่นเทศบาลตำบลคำพราน,2095,2181,4276,2099,2182,4281,2230
2567,19,สระบุรี,1976,ท้องถิ่นเทศบาลตำบลไผ่ต่ำ,2078,2119,4197,2084,2129,4213,2425
2567,19,สระบุรี,1977,ท้องถิ่นเทศบาลตำบลตะกุด,2370,2522,4892,2375,2527,4902,2445
2567,19,สระบุรี,1978,ท้องถิ่นเทศบาลตำบลกุดนกเปล้า,3051,3249,6300,3053,3251,6304,2863
2567,19,สระบุรี,1979,ท้องถิ่นเทศบาลตำบลหน้าพระลาน,3700,3708,7408,3717,3730,7447,3414
2567,19,สระบุรี,1980,ท้องถิ่นเทศบาลตำบลวังม่วง,2082,2206,4288,2095,2215,4310,2723
2567,19,สระบุรี,1981,ท้องถิ่นเทศบาลตำบลมวกเหล็ก,3151,3390,6541,3179,3410,6589,4531
2567,19,สระบุรี,1982,ท้องถิ่นเทศบาลตำบลเสาไห้,1435,1577,3012,1441,1583,3024,1581
2567,19,สระบุรี,1983,ท้องถิ่นเทศบาลตำบลสวนดอกไม้,3747,4174,7921,3748,4176,7924,4461
2567,19,สระบุรี,1984,ท้องถิ่นเทศบาลตำบลบ้านยาง,720,765,1485,721,766,1487,419
2567,19,สระบุรี,1985,ท้องถิ่นเทศบาลตำบลหนองโดน,1103,1227,2330,1104,1227,2331,1063
2567,19,สระบุรี,1986,ท้องถิ่นเทศบาลตำบลดอนพุด,2258,2310,4568,2260,2312,4572,1918
2567,19,สระบุรี,1987,ท้องถิ่นเทศบาลตำบลบ้านหมอ,1174,1276,2450,1177,1282,2459,1352
2567,19,สระบุรี,1988,ท้องถิ่นเทศบาลตำบลท่าลาน,3566,3827,7393,3573,3832,7405,4072
2567,19,สระบุรี,1989,ท้องถิ่นเทศบาลตำบลหนองแซง,1337,1463,2800,1342,1464,2806,1067
2567,19,สระบุรี,1990,ท้องถิ่นเทศบาลตำบลหนองหมู,812,858,1670,812,858,1670,511
2567,19,สระบุรี,1991,ท้องถิ่นเทศบาลตำบลวิหารแดง,1804,1989,3793,1814,1999,3813,2016
2567,19,สระบุรี,1992,ท้องถิ่นเทศบาลตำบลหินกอง,4397,4876,9273,4415,4893,9308,5847
2567,19,สระบุรี,1993,ท้องถิ่นเทศบาลตำบลคชสิทธิ์,622,692,1314,626,697,1323,694
2567,19,สระบุรี,1994,ท้องถิ่นเทศบาลเมืองทับกวาง,10190,10217,20407,10275,10274,20549,10521
2567,19,สระบุรี,1995,ท้องถิ่นเทศบาลตำบลป๊อกแป๊ก,354,400,754,356,400,756,450
2567,19,สระบุรี,1996,ท้องถิ่นเทศบาลเมืองพระพุทธบาท,12652,14670,27322,12826,14861,27687,13868
2567,19,สระบุรี,1997,ท้องถิ่นเทศบาลตำบลหนองแค,5769,6114,11883,5841,6182,12023,6594
2567,19,สระบุรี,1998,ท้องถิ่นเทศบาลเมืองแก่งคอย,4953,5395,10348,4972,5406,10378,6305
2567,19,สระบุรี,1999,ท้องถิ่นเทศบาลเมืองสระบุรี,27564,28561,56125,27760,28716,56476,29276
2567,20,ชลบุรี,2001,อำเภอเมืองชลบุรี,22441,24034,46475,22493,24077,46570,29911
2567,20,ชลบุรี,2002,อำเภอบ้านบึง,42187,43824,86011,42638,44181,86819,51018
2567,20,ชลบุรี,2003,อำเภอหนองใหญ่,7444,7498,14942,7656,7659,15315,7378
2567,20,ชลบุรี,2004,อำเภอบางละมุง,14982,17131,32113,15347,17433,32780,20786
2567,20,ชลบุรี,2005,อำเภอพานทอง,25724,26792,52516,25755,26832,52587,46495
2567,20,ชลบุรี,2006,อำเภอพนัสนิคม,49692,52841,102533,49977,53110,103087,41090
2567,20,ชลบุรี,2007,อำเภอศรีราชา,29248,29831,59079,29401,29925,59326,52114
2567,20,ชลบุรี,2008,อำเภอเกาะสีชัง,0,0,0,0,0,0,0
2567,20,ชลบุรี,2009,อำเภอสัตหีบ,26829,26552,53381,27158,26846,54004,31247
2567,20,ชลบุรี,2010,อำเภอบ่อทอง,18899,18732,37631,19056,18862,37918,14367
2567,20,ชลบุรี,2011,อำเภอเกาะจันทร์,13700,12809,26509,14153,13166,27319,9435
2567,20,ชลบุรี,2060,ท้องถิ่นเทศบาลตำบลเกล็ดแก้ว,6977,5875,12852,7165,5894,13059,6917
2567,20,ชลบุรี,2061,ท้องถิ่นเทศบาลตำบลเขตรอุดมศักดิ์,33794,22185,55979,33905,22232,56137,28758
2567,20,ชลบุรี,2063,ท้องถิ่นเทศบาลตำบลหมอนนาง,6466,6953,13419,6514,6976,13490,4920
2567,20,ชลบุรี,2064,ท้องถิ่นเทศบาลตำบลตะเคียนเตี้ย,13389,14654,28043,13459,14689,28148,14857
2567,20,ชลบุรี,2065,ท้องถิ่นเทศบาลตำบลเสม็ด,10432,12721,23153,10486,12746,23232,17967
2567,20,ชลบุรี,2066,ท้องถิ่นเทศบาลเมืองดอนหัวฬ่อ,7071,7326,14397,7086,7331,14417,17176
2567,20,ชลบุรี,2067,ท้องถิ่นเทศบาลตำบลห้วยกะปิ,8301,9548,17849,8328,9558,17886,12341
2567,20,ชลบุรี,2068,ท้องถิ่นเทศบาลตำบลนาป่า,21193,22422,43615,21229,22455,43684,28247
2567,20,ชลบุรี,2069,ท้องถิ่นเทศบาลตำบลหนองไม้แดง,6933,6575,13508,6943,6581,13524,11613
2567,20,ชลบุรี,2070,ท้องถิ่นเทศบาลตำบลธาตุทอง,3785,3926,7711,3840,3979,7819,2908
2567,20,ชลบุรี,2071,ท้องถิ่นเทศบาลตำบลโป่ง,5725,6409,12134,5858,6435,12293,7634
2567,20,ชลบุรี,2072,ท้องถิ่นเทศบาลเมืองหนองปรือ,40642,51682,92324,42168,51957,94125,53868
2567,20,ชลบุรี,2073,ท้องถิ่นเทศบาลตำบลท่าบุญมี,3183,3401,6584,3203,3417,6620,4290
2567,20,ชลบุรี,2074,ท้องถิ่นเทศบาลตำบลเกาะจันทร์,4302,1832,6134,4307,1834,6141,2211
2567,20,ชลบุรี,2075,ท้องถิ่นเทศบาลตำบลบ่อทอง,1720,1845,3565,1956,2046,4002,2230
2567,20,ชลบุรี,2076,ท้องถิ่นเทศบาลเมืองสัตหีบ,9832,11123,20955,9895,11161,21056,12297
2567,20,ชลบุรี,2077,ท้องถิ่นเทศบาลตำบลบางเสร่,5184,6379,11563,5383,6415,11798,9793
2567,20,ชลบุรี,2078,ท้องถิ่นเทศบาลตำบลนาจอมเทียน,3535,4058,7593,3735,4112,7847,17025
2567,20,ชลบุรี,2079,ท้องถิ่นเทศบาลตำบลเกาะสีชัง,2292,2376,4668,2298,2380,4678,2317
2567,20,ชลบุรี,2080,ท้องถิ่นเทศบาลนครเจ้าพระยาสุรศักดิ์,77596,82378,159974,77981,82601,160582,113075
2567,20,ชลบุรี,2081,ท้องถิ่นเทศบาลตำบลบางพระ,6392,7108,13500,6432,7125,13557,8355
2567,20,ชลบุรี,2082,ท้องถิ่นเทศบาลตำบลหนองตำลึง,11651,12054,23705,11668,12072,23740,18588
2567,20,ชลบุรี,2083,ท้องถิ่นเทศบาลตำบลพานทอง,3039,3266,6305,3170,3387,6557,3906
2567,20,ชลบุรี,2084,ท้องถิ่นเทศบาลตำบลห้วยใหญ่,14892,17096,31988,15127,17155,32282,20033
2567,20,ชลบุรี,2085,ท้องถิ่นเทศบาลตำบลบางละมุง,6364,7050,13414,6429,7139,13568,9373
2567,20,ชลบุรี,2086,ท้องถิ่นเทศบาลตำบลหนองใหญ่,4122,4001,8123,4426,4245,8671,3999
2567,20,ชลบุรี,2087,ท้องถิ่นเทศบาลตำบลหัวกุญแจ,1579,1789,3368,1612,1820,3432,2221
2567,20,ชลบุรี,2088,ท้องถิ่นเทศบาลตำบลหนองไผ่แก้ว,1087,1162,2249,1089,1168,2257,1662
2567,20,ชลบุรี,2089,ท้องถิ่นเทศบาลเมืองอ่างศิลา,17229,20262,37491,17287,20307,37594,23259
2567,20,ชลบุรี,2090,ท้องถิ่นเทศบาลนครบ้านสวน,33423,34030,67453,34340,34817,69157,46736
2567,20,ชลบุรี,2091,ท้องถิ่นเทศบาลตำบลบางทราย,6010,4874,10884,6043,4893,10936,7492
2567,20,ชลบุรี,2092,ท้องถิ่นเทศบาลตำบลคลองตำหรุ,2183,2468,4651,2200,2480,4680,7403
2567,20,ชลบุรี,2093,ท้องถิ่นเทศบาลนครแหลมฉบัง,45390,47250,92640,45951,47715,93666,86790
2567,20,ชลบุรี,2094,ท้องถิ่นเทศบาลเมืองแสนสุข,21218,24619,45837,21544,24848,46392,41230
2567,20,ชลบุรี,2095,ท้องถิ่นเทศบาลเมืองบ้านบึง,8407,9778,18185,9017,10324,19341,10935
2567,20,ชลบุรี,2096,ท้องถิ่นเมืองพัทยา,48838,60852,109690,53005,63499,116504,179568
2567,20,ชลบุรี,2097,ท้องถิ่นเทศบาลเมืองศรีราชา,10222,13039,23261,10949,13692,24641,8991
2567,20,ชลบุรี,2098,ท้องถิ่นเทศบาลเมืองพนัสนิคม,4435,5267,9702,4453,5271,9724,5093
2567,20,ชลบุรี,2099,ท้องถิ่นเทศบาลเมืองชลบุรี,10590,11845,22435,10668,11895,22563,12506
2567,21,ระยอง,2101,อำเภอเมืองระยอง,50759,53140,103899,51178,53322,104500,70408
2567,21,ระยอง,2102,อำเภอบ้านฉาง,5636,5355,10991,5662,5371,11033,5459
2567,21,ระยอง,2103,อำเภอแกลง,32349,34968,67317,32450,35036,67486,33340
2567,21,ระยอง,2104,อำเภอวังจันทร์,11071,11131,22202,11121,11172,22293,11834
2567,21,ระยอง,2105,อำเภอบ้านค่าย,33984,35821,69805,34112,35903,70015,39451
2567,21,ระยอง,2106,อำเภอปลวกแดง,42195,41293,83488,42285,41383,83668,116865
2567,21,ระยอง,2107,อำเภอเขาชะเมา,11638,11872,23510,11672,11906,23578,11651
2567,21,ระยอง,2108,อำเภอนิคมพัฒนา,13014,13074,26088,13056,13119,26175,23199
2567,21,ระยอง,2177,ท้องถิ่นเทศบาลตำบลพลา,4204,4320,8524,4372,4360,8732,5900
2567,21,ระยอง,2178,ท้องถิ่นเทศบาลตำบลเนินฆ้อ,2204,2337,4541,2216,2345,4561,2084
2567,21,ระยอง,2179,ท้องถิ่นเทศบาลตำบลทับมา,12865,13192,26057,12917,13219,26136,18648
2567,21,ระยอง,2180,ท้องถิ่นเทศบาลตำบลบ้านนา,4203,4418,8621,4213,4435,8648,3640
2567,21,ระยอง,2181,ท้องถิ่นเทศบาลตำบลมาบข่าพัฒนา,6027,6042,12069,6037,6055,12092,8827
2567,21,ระยอง,2182,ท้องถิ่นเทศบาลตำบลบ้านฉาง,8140,8630,16770,8261,8675,16936,10242
2567,21,ระยอง,2183,ท้องถิ่นเทศบาลเมืองมะขามคู่,7647,7719,15366,7660,7729,15389,14410
2567,21,ระยอง,2184,ท้องถิ่นเทศบาลเมืองนิคมพัฒนา,5738,5691,11429,5742,5698,11440,9067
2567,21,ระยอง,2185,ท้องถิ่นเทศบาลตำบลบ้านปลวกแดง,2375,2772,5147,2601,2969,5570,4609
2567,21,ระยอง,2186,ท้องถิ่นเทศบาลตำบลจอมพลเจ้าพระยา,204,189,393,204,189,393,620
2567,21,ระยอง,2187,ท้องถิ่นเทศบาลตำบลบ้านค่าย,1538,1689,3227,1621,1768,3389,2183
2567,21,ระยอง,2188,ท้องถิ่นเทศบาลตำบลชุมแสง,1771,1848,3619,1820,1896,3716,2499
2567,21,ระยอง,2189,ท้องถิ่นเทศบาลตำบลสุนทรภู่,6939,7920,14859,7189,7983,15172,10601
2567,21,ระยอง,2190,ท้องถิ่นเทศบาลตำบลปากน้ำประแส,2224,2359,4583,2242,2378,4620,2113
2567,21,ระยอง,2191,ท้องถิ่นเทศบาลตำบลทุ่งควายกิน,3059,3409,6468,3075,3418,6493,4223
2567,21,ระยอง,2192,ท้องถิ่นเทศบาลตำบลกองดิน,2317,2358,4675,2322,2368,4690,1919
2567,21,ระยอง,2193,ท้องถิ่นเทศบาลตำบลสำนักท้อน,5558,5771,11329,5589,5791,11380,6402
2567,21,ระยอง,2194,ท้องถิ่นเทศบาลเมืองบ้านฉาง,15214,16383,31597,15485,16505,31990,22168
2567,21,ระยอง,2195,ท้องถิ่นเทศบาลตำบลบ้านเพ,8416,9518,17934,8625,9571,18196,12698
2567,21,ระยอง,2196,ท้องถิ่นเทศบาลตำบลแกลงกะเฉด,3394,3709,7103,3427,3724,7151,3567
2567,21,ระยอง,2197,ท้องถิ่นเทศบาลนครมาบตาพุด,39530,39758,79288,39769,40004,79773,69179
2567,21,ระยอง,2198,ท้องถิ่นเทศบาลตำบลเมืองแกลง,7981,9113,17094,8647,9695,18342,12071
2567,21,ระยอง,2199,ท้องถิ่นเทศบาลนครระยอง,26198,30102,56300,27409,31205,58614,38537
2567,22,จันทบุรี,2201,อำเภอเมืองจันทบุรี,22930,25560,48490,23026,25609,48635,24450
2567,22,จันทบุรี,2202,อำเภอขลุง,12436,12982,25418,12459,13001,25460,10815
2567,22,จันทบุรี,2203,อำเภอท่าใหม่,23153,24228,47381,23241,24302,47543,19239
2567,22,จันทบุรี,2204,อำเภอโป่งน้ำร้อน,10923,10395,21318,11005,10527,21532,9196
2567,22,จันทบุรี,2205,อำเภอมะขาม,15155,15790,30945,15269,15915,31184,14383
2567,22,จันทบุรี,2206,อำเภอแหลมสิงห์,6712,7027,13739,6763,7084,13847,5522
2567,22,จันทบุรี,2207,อำเภอสอยดาว,18518,18282,36800,18607,18346,36953,15547
2567,22,จันทบุรี,2208,อำเภอแก่งหางแมว,21322,21221,42543,21455,21366,42821,22728
2567,22,จันทบุรี,2209,อำเภอนายายอาม,14725,15778,30503,14890,15938,30828,12712
2567,22,จันทบุรี,2210,อำเภอเขาคิชฌกูฏ,6301,6508,12809,6325,6530,12855,5863
2567,22,จันทบุรี,2272,ท้องถิ่นเทศบาลตำบลเขาบายศรี,3032,3199,6231,3061,3218,6279,2658
2567,22,จันทบุรี,2273,ท้องถิ่นเทศบาลตำบลคลองใหญ่,2664,2676,5340,2698,2710,5408,2192
2567,22,จันทบุรี,2274,ท้องถิ่นเทศบาลตำบลหนองตาคง,5171,4910,10081,5206,4960,10166,4188
2567,22,จันทบุรี,2275,ท้องถิ่นเทศบาลตำบลตกพรม,1947,2125,4072,1980,2143,4123,1710
2567,22,จันทบุรี,2276,ท้องถิ่นเทศบาลตำบลเกวียนหัก,2150,2499,4649,2152,2503,4655,2384
2567,22,จันทบุรี,2277,ท้องถิ่นเทศบาลตำบลบ่อ,3441,3614,7055,3443,3621,7064,2912
2567,22,จันทบุรี,2278,ท้องถิ่นเทศบาลตำบลชากไทย,2109,2237,4346,2133,2259,4392,1974
2567,22,จันทบุรี,2279,ท้องถิ่นเทศบาลตำบลตะเคียนทอง,2383,2346,4729,2388,2354,4742,1931
2567,22,จันทบุรี,2280,ท้องถิ่นเทศบาลเมืองเกาะขวาง,8489,9504,17993,8557,9548,18105,9022
2567,22,จันทบุรี,2281,ท้องถิ่นเทศบาลตำบลบ่อเวฬุ,2245,2099,4344,2269,2118,4387,2720
2567,22,จันทบุรี,2282,ท้องถิ่นเทศบาลตำบลพลวง,3440,3651,7091,3576,3776,7352,4364
2567,22,จันทบุรี,2283,ท้องถิ่นเทศบาลตำบลทับช้าง,8075,8071,16146,8098,8078,16176,6331
2567,22,จันทบุรี,2284,ท้องถิ่นเทศบาลตำบลนายายอาม,1599,1786,3385,1605,1796,3401,2034
2567,22,จันทบุรี,2285,ท้องถิ่นเทศบาลตำบลสอยดาว,5372,5566,10938,5505,5703,11208,6611
2567,22,จันทบุรี,2286,ท้องถิ่นเทศบาลตำบลพลิ้ว,3189,3682,6871,3198,3687,6885,3243
2567,22,จันทบุรี,2287,ท้องถิ่นเทศบาลตำบลปากน้ำแหลมสิงห์,4097,4356,8453,4108,4368,8476,3543
2567,22,จันทบุรี,2288,ท้องถิ่นเทศบาลตำบลมะขาม,777,895,1672,784,897,1681,1041
2567,22,จันทบุรี,2289,ท้องถิ่นเทศบาลตำบลโป่งน้ำร้อน,4907,4070,8977,5129,4292,9421,4492
2567,22,จันทบุรี,2290,ท้องถิ่นเทศบาลตำบลหนองคล้า,1739,1946,3685,1752,1963,3715,2249
2567,22,จันทบุรี,2291,ท้องถิ่นเทศบาลตำบลเนินสูง,1477,1561,3038,1481,1567,3048,1789
2567,22,จันทบุรี,2292,ท้องถิ่นเทศบาลตำบลหนองบัว,997,1152,2149,998,1152,2150,992
2567,22,จันทบุรี,2293,ท้องถิ่นเทศบาลตำบลพลับพลานารายณ์,4847,5410,10257,4859,5430,10289,6832
2567,22,จันทบุรี,2294,ท้องถิ่นเทศบาลตำบลบางกะจะ,2466,2667,5133,2474,2669,5143,2333
2567,22,จันทบุรี,2295,ท้องถิ่นเทศบาลเมืองท่าช้าง,6433,7617,14050,6468,7637,14105,11403
2567,22,จันทบุรี,2296,ท้องถิ่นเทศบาลเมืองจันทนิมิต,5245,5987,11232,5342,6103,11445,8015
2567,22,จันทบุรี,2297,ท้องถิ่นเทศบาลเมืองขลุง,4674,5334,10008,4701,5359,10060,4339
2567,22,จันทบุรี,2298,ท้องถิ่นเทศบาลเมืองท่าใหม่,4574,5260,9834,4611,5299,9910,4826
2567,22,จันทบุรี,2299,ท้องถิ่นเทศบาลเมืองจันทบุรี,9319,10512,19831,9939,11005,20944,15066
2567,23,ตราด,2301,อำเภอเมืองตราด,34690,37325,72015,36036,38610,74646,37597
2567,23,ตราด,2302,อำเภอคลองใหญ่,5905,5691,11596,7294,7120,14414,5664
2567,23,ตราด,2303,อำเภอเขาสมิง,19602,19920,39522,19764,20058,39822,18700
2567,23,ตราด,2304,อำเภอบ่อไร่,9368,8885,18253,9508,9034,18542,7901
2567,23,ตราด,2305,อำเภอแหลมงอบ,7236,6930,14166,7335,7031,14366,6172
2567,23,ตราด,2306,อำเภอเกาะกูด,1496,1374,2870,1547,1415,2962,2214
2567,23,ตราด,2307,อำเภอเกาะช้าง,4051,4150,8201,4344,4384,8728,6392
2567,23,ตราด,2389,ท้องถิ่นเทศบาลตำบลตะกาง,1227,1322,2549,1252,1350,2602,1416
2567,23,ตราด,2390,ท้องถิ่นเทศบาลตำบลหนองบอน,3632,3532,7164,3655,3568,7223,4009
2567,23,ตราด,2391,ท้องถิ่นเทศบาลตำบลแหลมงอบ,825,838,1663,833,850,1683,764
2567,23,ตราด,2392,ท้องถิ่นเทศบาลตำบลน้ำเชี่ยว,1486,1593,3079,1494,1603,3097,1350
2567,23,ตราด,2393,ท้องถิ่นเทศบาลตำบลบ่อพลอย,4085,4147,8232,4224,4298,8522,5867
2567,23,ตราด,2394,ท้องถิ่นเทศบาลตำบลแสนตุ้ง,1486,1544,3030,1525,1580,3105,2441
2567,23,ตราด,2395,ท้องถิ่นเทศบาลตำบลเขาสมิง,766,745,1511,769,748,1517,617
2567,23,ตราด,2396,ท้องถิ่นเทศบาลตำบลหาดเล็ก,2474,2362,4836,2681,2552,5233,2032
2567,23,ตราด,2397,ท้องถิ่นเทศบาลตำบลคลองใหญ่,2316,2314,4630,2525,2567,5092,2457
2567,23,ตราด,2398,ท้องถิ่นเทศบาลตำบลท่าพริกเนินทราย,3025,3329,6354,3122,3430,6552,3220
2567,23,ตราด,2399,ท้องถิ่นเทศบาลเมืองตราด,3475,3964,7439,3985,4426,8411,5580
2567,24,ฉะเชิงเทรา,2401,อำเภอเมืองฉะเชิงเทรา,61249,65041,126290,61490,65257,126747,56559
2567,24,ฉะเชิงเทรา,2402,อำเภอบางคล้า,14622,15644,30266,14658,15685,30343,13395
2567,24,ฉะเชิงเทรา,2403,อำเภอบางน้ำเปรี้ยว,36455,37109,73564,36580,37215,73795,24009
2567,24,ฉะเชิงเทรา,2404,อำเภอบางปะกง,28914,30095,59009,29250,30344,59594,29826
2567,24,ฉะเชิงเทรา,2405,อำเภอบ้านโพธิ์,22562,24472,47034,22616,24533,47149,22943
2567,24,ฉะเชิงเทรา,2406,อำเภอพนมสารคาม,34835,36917,71752,34991,37071,72062,32344
2567,24,ฉะเชิงเทรา,2407,อำเภอราชสาส์น,6121,6366,12487,6130,6380,12510,5117
2567,24,ฉะเชิงเทรา,2408,อำเภอสนามชัยเขต,35495,35485,70980,35587,35574,71161,24441
2567,24,ฉะเชิงเทรา,2409,อำเภอแปลงยาว,11983,11747,23730,12020,11789,23809,14024
2567,24,ฉะเชิงเทรา,2410,อำเภอท่าตะเกียบ,23495,23169,46664,23547,23212,46759,18165
2567,24,ฉะเชิงเทรา,2411,อำเภอคลองเขื่อน,6056,6314,12370,6064,6328,12392,4788
2567,24,ฉะเชิงเทรา,2474,ท้องถิ่นเทศบาลตำบลบางวัวคณารักษ์,5498,5993,11491,5515,6006,11521,9761
2567,24,ฉะเชิงเทรา,2475,ท้องถิ่นเทศบาลตำบลพิมพา,1817,1953,3770,1823,1957,3780,4397
2567,24,ฉะเชิงเทรา,2476,ท้องถิ่นเทศบาลตำบลวังเย็น,4892,4971,9863,4902,4984,9886,3837
2567,24,ฉะเชิงเทรา,2477,ท้องถิ่นเทศบาลตำบลดอนเกาะกา,4350,4239,8589,4368,4252,8620,2524
2567,24,ฉะเชิงเทรา,2478,ท้องถิ่นเทศบาลตำบลหัวสำโรง,3372,3527,6899,3377,3538,6915,4250
2567,24,ฉะเชิงเทรา,2479,ท้องถิ่นเทศบาลตำบลแปลงยาว,3056,3190,6246,3062,3198,6260,3832
2567,24,ฉะเชิงเทรา,2480,ท้องถิ่นเทศบาลตำบลทุ่งสะเดา,2968,2625,5593,3064,2718,5782,4773
2567,24,ฉะเชิงเทรา,2481,ท้องถิ่นเทศบาลตำบลสนามชัยเขต,1959,2183,4142,1998,2233,4231,3064
2567,24,ฉะเชิงเทรา,2482,ท้องถิ่นเทศบาลตำบลพนมสารคาม,2796,3284,6080,2806,3295,6101,4310
2567,24,ฉะเชิงเทรา,2483,ท้องถิ่นเทศบาลตำบลเขาหินซ้อน,1680,1762,3442,1683,1764,3447,2743
2567,24,ฉะเชิงเทรา,2484,ท้องถิ่นเทศบาลตำบลเกาะขนุน,964,1099,2063,967,1101,2068,1129
2567,24,ฉะเชิงเทรา,2485,ท้องถิ่นเทศบาลตำบลบ้านโพธิ์,1347,1432,2779,1402,1479,2881,1458
2567,24,ฉะเชิงเทรา,2486,ท้องถิ่นเทศบาลตำบลเทพราช,1983,2109,4092,1988,2117,4105,1313
2567,24,ฉะเชิงเทรา,2487,ท้องถิ่นเทศบาลตำบลบางวัว,1193,1342,2535,1198,1347,2545,2031
2567,24,ฉะเชิงเทรา,2488,ท้องถิ่นเทศบาลตำบลบางปะกง,2808,3056,5864,2822,3071,5893,2959
2567,24,ฉะเชิงเทรา,2489,ท้องถิ่นเทศบาลตำบลหอมศีล,622,638,1260,622,639,1261,327
2567,24,ฉะเชิงเทรา,2490,ท้องถิ่นเทศบาลตำบลท่าสะอ้าน,1863,1988,3851,1868,1988,3856,2837
2567,24,ฉะเชิงเทรา,2491,ท้องถิ่นเทศบาลตำบลท่าข้าม,3545,3801,7346,3555,3815,7370,9606
2567,24,ฉะเชิงเทรา,2492,ท้องถิ่นเทศบาลตำบลศาลาแดง,711,759,1470,713,761,1474,566
2567,24,ฉะเชิงเทรา,2493,ท้องถิ่นเทศบาลตำบลบางน้ำเปรี้ยว,1087,1152,2239,1097,1161,2258,1238
2567,24,ฉะเชิงเทรา,2494,ท้องถิ่นเทศบาลตำบลบางขนาก,1057,1017,2074,1067,1027,2094,818
2567,24,ฉะเชิงเทรา,2495,ท้องถิ่นเทศบาลตำบลดอนฉิมพลี,745,761,1506,756,764,1520,742
2567,24,ฉะเชิงเทรา,2496,ท้องถิ่นเทศบาลตำบลปากน้ำ,2501,2733,5234,2564,2800,5364,2789
2567,24,ฉะเชิงเทรา,2497,ท้องถิ่นเทศบาลตำบลนครเนื่องเขต,616,722,1338,621,726,1347,505
2567,24,ฉะเชิงเทรา,2498,ท้องถิ่นเทศบาลตำบลบางคล้า,4535,5288,9823,4579,5334,9913,5047
2567,24,ฉะเชิงเทรา,2499,ท้องถิ่นเทศบาลเมืองฉะเชิงเทรา,16761,18722,35483,17206,19112,36318,22914
2567,25,ปราจีนบุรี,2501,อำเภอเมืองปราจีนบุรี,45132,42643,87775,45275,42736,88011,37954
2567,25,ปราจีนบุรี,2502,อำเภอกบินทร์บุรี,67257,69636,136893,67379,69718,137097,57049
2567,25,ปราจีนบุรี,2503,อำเภอนาดี,21963,22282,44245,21992,22299,44291,19209
2567,25,ปราจีนบุรี,2506,อำเภอบ้านสร้าง,13268,13839,27107,13291,13871,27162,9865
2567,25,ปราจีนบุรี,2507,อำเภอประจันตคาม,24186,25452,49638,24206,25474,49680,18499
2567,25,ปราจีนบุรี,2508,อำเภอศรีมหาโพธิ,39104,41282,80386,39177,41327,80504,60592
2567,25,ปราจีนบุรี,2509,อำเภอศรีมโหสถ,6635,6862,13497,6643,6869,13512,7003
2567,25,ปราจีนบุรี,2587,ท้องถิ่นเทศบาลตำบลโคกมะกอก,1054,1172,2226,1057,1174,2231,880
2567,25,ปราจีนบุรี,2588,ท้องถิ่นเทศบาลตำบลโคกปีบ,2682,2930,5612,2698,2937,5635,2414
2567,25,ปราจีนบุรี,2589,ท้องถิ่นเทศบาลตำบลศรีมหาโพธิ,1721,1842,3563,1724,1845,3569,2595
2567,25,ปราจีนบุรี,2590,ท้องถิ่นเทศบาลตำบลกรอกสมบูรณ์,1764,1828,3592,1764,1828,3592,1344
2567,25,ปราจีนบุรี,2591,ท้องถิ่นเทศบาลตำบลประจันตคาม,2027,2242,4269,2029,2243,4272,2433
2567,25,ปราจีนบุรี,2592,ท้องถิ่นเทศบาลตำบลบ้านสร้าง,1571,1642,3213,1581,1651,3232,1729
2567,25,ปราจีนบุรี,2593,ท้องถิ่นเทศบาลตำบลนาดี,3869,4020,7889,3879,4037,7916,3491
2567,25,ปราจีนบุรี,2594,ท้องถิ่นเทศบาลตำบลสระบัว,862,903,1765,865,908,1773,664
2567,25,ปราจีนบุรี,2595,ท้องถิ่นเทศบาลตำบลเมืองเก่า,3004,3214,6218,3241,3376,6617,4650
2567,25,ปราจีนบุรี,2596,ท้องถิ่นเทศบาลตำบลบ้านนาปรือ,1100,1129,2229,1102,1130,2232,837
2567,25,ปราจีนบุรี,2598,ท้องถิ่นเทศบาลตำบลกบินทร์,1630,1862,3492,1643,1868,3511,2216
2567,25,ปราจีนบุรี,2599,ท้องถิ่นเทศบาลเมืองปราจีนบุรี,7248,8459,15707,7289,8481,15770,9170
2567,26,นครนายก,2601,อำเภอเมืองนครนายก,42492,42590,85082,42555,42629,85184,38011
2567,26,นครนายก,2602,อำเภอปากพลี,10771,11374,22145,10779,11382,22161,9215
2567,26,นครนายก,2603,อำเภอบ้านนา,31945,32078,64023,32047,32160,64207,25935
2567,26,นครนายก,2604,อำเภอองครักษ์,30703,31713,62416,30999,31982,62981,24023
2567,26,นครนายก,2695,ท้องถิ่นเทศบาลตำบลองครักษ์,1176,1292,2468,1227,1347,2574,1394
2567,26,นครนายก,2696,ท้องถิ่นเทศบาลตำบลบ้านนา,2123,2406,4529,2144,2415,4559,2605
2567,26,นครนายก,2697,ท้องถิ่นเทศบาลตำบลเกาะหวาย,791,904,1695,795,905,1700,767
2567,26,นครนายก,2698,ท้องถิ่นเทศบาลตำบลท่าช้าง,498,529,1027,498,529,1027,317
2567,26,นครนายก,2699,ท้องถิ่นเทศบาลเมืองนครนายก,7101,7927,15028,7305,8072,15377,8979
2567,27,สระแก้ว,2701,อำเภอเมืองสระแก้ว,43717,42899,86616,43855,43035,86890,31565
2567,27,สระแก้ว,2702,อำเภอคลองหาด,19479,19469,38948,19513,19512,39025,14443
2567,27,สระแก้ว,2703,อำเภอตาพระยา,27364,27101,54465,27531,27366,54897,17397
2567,27,สระแก้ว,2704,อำเภอวังน้ำเย็น,20086,20109,40195,20169,20167,40336,15723
2567,27,สระแก้ว,2705,อำเภอวัฒนานคร,38201,37909,76110,38371,38083,76454,28513
2567,27,สระแก้ว,2706,อำเภออรัญประเทศ,36811,37790,74601,37252,38574,75826,39533
2567,27,สระแก้ว,2707,อำเภอเขาฉกรรจ์,25301,25425,50726,25387,25478,50865,17217
2567,27,สระแก้ว,2708,อำเภอโคกสูง,13362,13617,26979,13463,13784,27247,8919
2567,27,สระแก้ว,2709,อำเภอวังสมบูรณ์,12614,12457,25071,12642,12503,25145,10915
2567,27,สระแก้ว,2791,ท้องถิ่นเทศบาลตำบลวังสมบูรณ์,5148,5297,10445,5159,5316,10475,5329
2567,27,สระแก้ว,2792,ท้องถิ่นเทศบาลตำบลเขาฉกรรจ์,2291,2366,4657,2344,2412,4756,2484
2567,27,สระแก้ว,2793,ท้องถิ่นเทศบาลตำบลวัฒนานคร,2499,2965,5464,2506,2973,5479,3154
2567,27,สระแก้ว,2794,ท้องถิ่นเทศบาลเมืองวังน้ำเย็น,9814,10343,20157,9884,10404,20288,10328
2567,27,สระแก้ว,2795,ท้องถิ่นเทศบาลตำบลตาพระยา,1199,1240,2439,1220,1252,2472,1209
2567,27,สระแก้ว,2796,ท้องถิ่นเทศบาลตำบลศาลาลำดวน,1304,1365,2669,1311,1376,2687,1253
2567,27,สระแก้ว,2797,ท้องถิ่นเทศบาลตำบลท่าเกษม,2183,1864,4047,2191,1871,4062,1723
2567,27,สระแก้ว,2798,ท้องถิ่นเทศบาลเมืองอรัญญประเทศ,8335,7136,15471,9129,7941,17070,11857
2567,27,สระแก้ว,2799,ท้องถิ่นเทศบาลเมืองสระแก้ว,8563,9425,17988,8714,9554,18268,12290
2567,30,นครราชสีมา,3001,อำเภอเมืองนครราชสีมา,108038,120613,228651,108399,120739,229138,116113
2567,30,นครราชสีมา,3002,อำเภอครบุรี,39503,40638,80141,39574,40656,80230,32003
2567,30,นครราชสีมา,3003,อำเภอเสิงสาง,28015,28501,56516,28111,28556,56667,18150
2567,30,นครราชสีมา,3004,อำเภอคง,36083,37137,73220,36135,37162,73297,22682
2567,30,นครราชสีมา,3005,อำเภอบ้านเหลื่อม,8396,8612,17008,8406,8616,17022,5393
2567,30,นครราชสีมา,3006,อำเภอจักราช,33405,33938,67343,33437,33952,67389,20221
2567,30,นครราชสีมา,3007,อำเภอโชคชัย,24423,26206,50629,24460,26217,50677,20530
2567,30,นครราชสีมา,3008,อำเภอด่านขุนทด,53806,55387,109193,53845,55407,109252,36691
2567,30,นครราชสีมา,3009,อำเภอโนนไทย,26375,27671,54046,26399,27681,54080,17931
2567,30,นครราชสีมา,3010,อำเภอโนนสูง,41087,42777,83864,41140,42793,83933,26637
2567,30,นครราชสีมา,3011,อำเภอขามสะแกแสง,16412,16611,33023,16446,16614,33060,10502
2567,30,นครราชสีมา,3012,อำเภอบัวใหญ่,33249,33311,66560,33287,33337,66624,20304
2567,30,นครราชสีมา,3013,อำเภอประทาย,34637,35388,70025,34669,35404,70073,20701
2567,30,นครราชสีมา,3014,อำเภอปักธงชัย,44684,47126,91810,44724,47140,91864,34171
2567,30,นครราชสีมา,3015,อำเภอพิมาย,58035,60321,118356,58151,60356,118507,41333
2567,30,นครราชสีมา,3016,อำเภอห้วยแถลง,34813,34781,69594,34832,34796,69628,20736
2567,30,นครราชสีมา,3017,อำเภอชุมพวง,36203,36759,72962,36238,36781,73019,21234
2567,30,นครราชสีมา,3018,อำเภอสูงเนิน,35619,37425,73044,35651,37445,73096,31810
2567,30,นครราชสีมา,3019,อำเภอขามทะเลสอ,12772,13353,26125,12785,13358,26143,9239
2567,30,นครราชสีมา,3020,อำเภอสีคิ้ว,43033,43744,86777,43077,43778,86855,34142
2567,30,นครราชสีมา,3021,อำเภอปากช่อง,62659,64329,126988,62994,64563,127557,74213
2567,30,นครราชสีมา,3022,อำเภอหนองบุญมาก,29883,30586,60469,29934,30600,60534,19625
2567,30,นครราชสีมา,3023,อำเภอแก้งสนามนาง,17754,18247,36001,17766,18253,36019,11203
2567,30,นครราชสีมา,3024,อำเภอโนนแดง,10062,10397,20459,10069,10404,20473,6008
2567,30,นครราชสีมา,3025,อำเภอวังน้ำเขียว,21792,22222,44014,21848,22268,44116,21028
2567,30,นครราชสีมา,3026,อำเภอเทพารักษ์,12732,12599,25331,12742,12606,25348,9024
2567,30,นครราชสีมา,3027,อำเภอเมืองยาง,9743,9616,19359,9748,9623,19371,5785
2567,30,นครราชสีมา,3028,อำเภอพระทองคำ,18234,18473,36707,18257,18482,36739,12954
2567,30,นครราชสีมา,3029,อำเภอลำทะเมนชัย,13793,13962,27755,13805,13968,27773,7919
2567,30,นครราชสีมา,3030,อำเภอบัวลาย,10442,10688,21130,10457,10695,21152,6761
2567,30,นครราชสีมา,3031,อำเภอสีดา,9784,9901,19685,9793,9908,19701,6326
2567,30,นครราชสีมา,3032,อำเภอเฉลิมพระเกียรติ,15139,15892,31031,15158,15898,31056,9976
2567,30,นครราชสีมา,3035,ท้องถิ่นเทศบาลตำบลเมืองใหม่โคกกรวด,7807,8425,16232,7828,8435,16263,8218
2567,30,นครราชสีมา,3037,ท้องถิ่นเทศบาลตำบลเมืองยาง,3977,4051,8028,3981,4054,8035,2461
2567,30,นครราชสีมา,3038,ท้องถิ่นเทศบาลตำบลหนองน้ำใส,6616,6668,13284,6623,6672,13295,5364
2567,30,นครราชสีมา,3039,ท้องถิ่นเทศบาลตำบลด่านคล้า,4174,4334,8508,4182,4335,8517,2743
2567,30,นครราชสีมา,3040,ท้องถิ่นเทศบาลตำบลใหม่,6384,6488,12872,6402,6494,12896,3754
2567,30,นครราชสีมา,3041,ท้องถิ่นเทศบาลตำบลหนองบัวตะเกียด,4264,4499,8763,4266,4501,8767,2853
2567,30,นครราชสีมา,3042,ท้องถิ่นเทศบาลตำบลบัลลังก์,3796,3862,7658,3801,3864,7665,2574
2567,30,นครราชสีมา,3043,ท้องถิ่นเทศบาลตำบลหนองไข่น้ำ,3072,3073,6145,3075,3073,6148,1984
2567,30,นครราชสีมา,3044,ท้องถิ่นเทศบาลตำบลท่าเยี่ยม,5610,5797,11407,5617,5797,11414,5828
2567,30,นครราชสีมา,3045,ท้องถิ่นเทศบาลตำบลสีมามงคล,4559,4670,9229,4571,4675,9246,4640
2567,30,นครราชสีมา,3046,ท้องถิ่นเทศบาลตำบลลำนางแก้ว,2339,2373,4712,2340,2374,4714,1483
2567,30,นครราชสีมา,3047,ท้องถิ่นเทศบาลตำบลดอนหวาย,1739,1915,3654,1741,1916,3657,1375
2567,30,นครราชสีมา,3048,ท้องถิ่นเทศบาลตำบลหมูสี,6614,6762,13376,6661,6789,13450,12435
2567,30,นครราชสีมา,3049,ท้องถิ่นเทศบาลตำบลโพธิ์กลาง,14755,14412,29167,14775,14425,29200,14148
2567,30,นครราชสีมา,3050,ท้องถิ่นเทศบาลตำบลหัวทะเล,13186,14686,27872,13224,14713,27937,14664
2567,30,นครราชสีมา,3051,ท้องถิ่นเทศบาลตำบลวังไทร,5569,5815,11384,5586,5821,11407,5927
2567,30,นครราชสีมา,3052,ท้องถิ่นเทศบาลตำบลปรุใหญ่,4613,5104,9717,4624,5106,9730,5494
2567,30,นครราชสีมา,3053,ท้องถิ่นเทศบาลตำบลหนองไผ่ล้อม,9490,3985,13475,9494,3994,13488,11306
2567,30,นครราชสีมา,3054,ท้องถิ่นเทศบาลตำบลท่าช้าง,2428,2610,5038,2430,2611,5041,2195
2567,30,นครราชสีมา,3055,ท้องถิ่นเทศบาลตำบลสีดา,1752,1830,3582,1754,1838,3592,1559
2567,30,นครราชสีมา,3056,ท้องถิ่นเทศบาลตำบลหนองบัวลาย,1144,1192,2336,1147,1194,2341,895
2567,30,นครราชสีมา,3057,ท้องถิ่นเทศบาลตำบลหนองบัววง,2238,2309,4547,2241,2310,4551,1955
2567,30,นครราชสีมา,3058,ท้องถิ่นเทศบาลตำบลพระทองคำ,1919,2048,3967,1925,2050,3975,1694
2567,30,นครราชสีมา,3059,ท้องถิ่นเทศบาลตำบลศาลเจ้าพ่อ,883,998,1881,887,1000,1887,981
2567,30,นครราชสีมา,3060,ท้องถิ่นเทศบาลตำบลโนนแดง,2048,2176,4224,2050,2180,4230,1680
2567,30,นครราชสีมา,3061,ท้องถิ่นเทศบาลตำบลกลางดง,2416,2509,4925,2422,2515,4937,2804
2567,30,นครราชสีมา,3062,ท้องถิ่นเทศบาลเมืองสีคิ้ว,7520,8483,16003,7536,8510,16046,9816
2567,30,นครราชสีมา,3063,ท้องถิ่นเทศบาลตำบลลาดบัวขาว,1914,2104,4018,1915,2105,4020,2308
2567,30,นครราชสีมา,3064,ท้องถิ่นเทศบาลตำบลคลองไผ่,1934,1638,3572,1945,1648,3593,1774
2567,30,นครราชสีมา,3065,ท้องถิ่นเทศบาลตำบลขามทะเลสอ,2089,2259,4348,2095,2262,4357,2381
2567,30,นครราชสีมา,3066,ท้องถิ่นเทศบาลตำบลสูงเนิน,4481,5007,9488,4551,5073,9624,6482
2567,30,นครราชสีมา,3067,ท้องถิ่นเทศบาลตำบลกุดจิก,1261,1422,2683,1263,1422,2685,1545
2567,30,นครราชสีมา,3068,ท้องถิ่นเทศบาลตำบลชุมพวง,4152,4428,8580,4155,4430,8585,3953
2567,30,นครราชสีมา,3069,ท้องถิ่นเทศบาลตำบลหินดาด,1352,1372,2724,1355,1373,2728,824
2567,30,นครราชสีมา,3070,ท้องถิ่นเทศบาลตำบลห้วยแถลง,1410,1592,3002,1412,1595,3007,1722
2567,30,นครราชสีมา,3071,ท้องถิ่นเทศบาลตำบลพิมาย,3440,4036,7476,3446,4037,7483,2940
2567,30,นครราชสีมา,3072,ท้องถิ่นเทศบาลเมืองเมืองปัก,6172,7066,13238,6190,7085,13275,7210
2567,30,นครราชสีมา,3073,ท้องถิ่นเทศบาลตำบลตะขบ,2534,2642,5176,2534,2644,5178,2004
2567,30,นครราชสีมา,3074,ท้องถิ่นเทศบาลตำบลประทาย,2895,3030,5925,2899,3031,5930,3224
2567,30,นครราชสีมา,3075,ท้องถิ่นเทศบาลตำบลหนองหัวฟาน,2215,2206,4421,2220,2209,4429,1517
2567,30,นครราชสีมา,3076,ท้องถิ่นเทศบาลตำบลขามสะแกแสง,2375,2605,4980,2379,2606,4985,1981
2567,30,นครราชสีมา,3077,ท้องถิ่นเทศบาลตำบลมะค่า,941,938,1879,941,938,1879,621
2567,30,นครราชสีมา,3078,ท้องถิ่นเทศบาลตำบลตลาดแค,1503,1686,3189,1507,1689,3196,1382
2567,30,นครราชสีมา,3079,ท้องถิ่นเทศบาลตำบลโนนไทย,1362,1588,2950,1369,1590,2959,1413
2567,30,นครราชสีมา,3080,ท้องถิ่นเทศบาลตำบลโคกสวาย,2482,2631,5113,2484,2631,5115,1869
2567,30,นครราชสีมา,3081,ท้องถิ่นเทศบาลตำบลหนองกราด,1930,2086,4016,1935,2088,4023,1405
2567,30,นครราชสีมา,3082,ท้องถิ่นเทศบาลตำบลด่านขุนทด,2757,3190,5947,2765,3197,5962,4132
2567,30,นครราชสีมา,3083,ท้องถิ่นเทศบาลตำบลด่านเกวียน,4790,5104,9894,4794,5107,9901,4640
2567,30,นครราชสีมา,3084,ท้องถิ่นเทศบาลตำบลโชคชัย,5699,6319,12018,5869,6500,12369,5709
2567,30,นครราชสีมา,3085,ท้องถิ่นเทศบาลตำบลจักราช,1781,1964,3745,1785,1968,3753,1705
2567,30,นครราชสีมา,3086,ท้องถิ่นเทศบาลตำบลบ้านเหลื่อม,1559,1790,3349,1560,1790,3350,1287
2567,30,นครราชสีมา,3087,ท้องถิ่นเทศบาลตำบลเมืองคง,1019,1139,2158,1026,1140,2166,1010
2567,30,นครราชสีมา,3088,ท้องถิ่นเทศบาลตำบลเทพาลัย,1304,1379,2683,1307,1381,2688,913
2567,30,นครราชสีมา,3089,ท้องถิ่นเทศบาลตำบลเสิงสาง,3600,3847,7447,3613,3857,7470,3350
2567,30,นครราชสีมา,3090,ท้องถิ่นเทศบาลตำบลโนนสมบูรณ์,2788,2876,5664,2799,2879,5678,1869
2567,30,นครราชสีมา,3091,ท้องถิ่นเทศบาลตำบลไทรโยง-ไชยวาล,1788,1857,3645,1794,1858,3652,1207
2567,30,นครราชสีมา,3092,ท้องถิ่นเทศบาลตำบลแชะ,2615,3014,5629,2625,3016,5641,3088
2567,30,นครราชสีมา,3093,ท้องถิ่นเทศบาลตำบลจระเข้หิน,2833,3165,5998,2836,3166,6002,2511
2567,30,นครราชสีมา,3094,ท้องถิ่นเทศบาลตำบลจอหอ,8382,8772,17154,8412,8782,17194,10395
2567,30,นครราชสีมา,3095,ท้องถิ่นเทศบาลตำบลโคกกรวด,3186,3720,6906,3215,3745,6960,4784
2567,30,นครราชสีมา,3096,ท้องถิ่นเทศบาลตำบลโนนสูง,4463,4813,9276,4472,4817,9289,4176
2567,30,นครราชสีมา,3097,ท้องถิ่นเทศบาลเมืองบัวใหญ่,6186,6806,12992,6207,6813,13020,7403
2567,30,นครราชสีมา,3098,ท้องถิ่นเทศบาลเมืองปากช่อง,14766,16758,31524,15025,16995,32020,19408
2567,30,นครราชสีมา,3099,ท้องถิ่นเทศบาลนครนครราชสีมา,52134,60296,112430,52544,60640,113184,73265
2567,31,บุรีรัมย์,3101,อำเภอเมืองบุรีรัมย์,83581,86064,169645,83803,86137,169940,53568
2567,31,บุรีรัมย์,3102,อำเภอคูเมือง,29245,29247,58492,29318,29279,58597,16997
2567,31,บุรีรัมย์,3103,อำเภอกระสัง,49642,50910,100552,49754,50951,100705,27512
2567,31,บุรีรัมย์,3104,อำเภอนางรอง,45602,47112,92714,45649,47137,92786,27856
2567,31,บุรีรัมย์,3105,อำเภอหนองกี่,28625,28433,57058,28659,28443,57102,16177
2567,31,บุรีรัมย์,3106,อำเภอละหานทราย,9620,9691,19311,9654,9699,19353,6099
2567,31,บุรีรัมย์,3107,อำเภอประโคนชัย,61717,62686,124403,61874,62752,124626,38673
2567,31,บุรีรัมย์,3108,อำเภอบ้านกรวด,20210,20471,40681,20318,20503,40821,11926
2567,31,บุรีรัมย์,3109,อำเภอพุทไธสง,19957,20971,40928,19972,20979,40951,12887
2567,31,บุรีรัมย์,3110,อำเภอลำปลายมาศ,56359,56795,113154,56431,56820,113251,32571
2567,31,บุรีรัมย์,3111,อำเภอสตึก,48657,49059,97716,48724,49075,97799,28402
2567,31,บุรีรัมย์,3112,อำเภอปะคำ,19000,18942,37942,19033,18954,37987,12268
2567,31,บุรีรัมย์,3113,อำเภอนาโพธิ์,13708,14193,27901,13722,14206,27928,8289
2567,31,บุรีรัมย์,3114,อำเภอหนองหงส์,17653,17488,35141,17663,17493,35156,9778
2567,31,บุรีรัมย์,3115,อำเภอพลับพลาชัย,13984,13716,27700,14032,13722,27754,7589
2567,31,บุรีรัมย์,3116,อำเภอห้วยราช,16003,16320,32323,16032,16324,32356,8675
2567,31,บุรีรัมย์,3117,อำเภอโนนสุวรรณ,10890,10913,21803,10899,10916,21815,6706
2567,31,บุรีรัมย์,3118,อำเภอชำนิ,17427,17604,35031,17457,17614,35071,9561
2567,31,บุรีรัมย์,3119,อำเภอบ้านใหม่ไชยพจน์,10654,10990,21644,10671,10998,21669,6364
2567,31,บุรีรัมย์,3120,อำเภอโนนดินแดง,9299,9273,18572,9334,9288,18622,5981
2567,31,บุรีรัมย์,3121,อำเภอบ้านด่าน,9130,9469,18599,9147,9473,18620,4828
2567,31,บุรีรัมย์,3122,อำเภอแคนดง,13185,13428,26613,13207,13437,26644,7668
2567,31,บุรีรัมย์,3123,อำเภอเฉลิมพระเกียรติ,5988,6030,12018,5997,6036,12033,3697
2567,31,บุรีรัมย์,3162,ท้องถิ่นเทศบาลตำบลจันดุม,5128,5242,10370,5139,5248,10387,3072
2567,31,บุรีรัมย์,3163,ท้องถิ่นเทศบาลตำบลห้วยหิน,4809,4908,9717,4815,4908,9723,2828
2567,31,บุรีรัมย์,3164,ท้องถิ่นเทศบาลตำบลสำโรงใหม่,6271,6263,12534,6284,6268,12552,3912
2567,31,บุรีรัมย์,3165,ท้องถิ่นเทศบาลตำบลจันทบเพชร,3857,3949,7806,3879,3953,7832,2513
2567,31,บุรีรัมย์,3166,ท้องถิ่นเทศบาลตำบลหนองแวง,8405,8333,16738,8416,8339,16755,4408
2567,31,บุรีรัมย์,3167,ท้องถิ่นเทศบาลตำบลหนองไม้งาม,5042,5035,10077,5062,5035,10097,3041
2567,31,บุรีรัมย์,3168,ท้องถิ่นเทศบาลตำบลบ้านกรวดปัญญาวัฒน์,4658,4694,9352,4691,4696,9387,2848
2567,31,บุรีรัมย์,3169,ท้องถิ่นเทศบาลตำบลบ้านด่าน,5832,6043,11875,5857,6044,11901,3487
2567,31,บุรีรัมย์,3170,ท้องถิ่นเทศบาลตำบลถาวร,3756,3823,7579,3765,3825,7590,2274
2567,31,บุรีรัมย์,3171,ท้องถิ่นเทศบาลตำบลยายแย้มวัฒนา,4306,4250,8556,4318,4255,8573,2437
2567,31,บุรีรัมย์,3172,ท้องถิ่นเทศบาลตำบลอิสาณ,0,0,0,0,0,0,0
2567,31,บุรีรัมย์,3174,ท้องถิ่นเทศบาลตำบลศาลเจ้าพ่อขุนศรี,1676,1703,3379,1678,1704,3382,1377
2567,31,บุรีรัมย์,3175,ท้องถิ่นเทศบาลตำบลตาจง,8316,8218,16534,8337,8229,16566,4508
2567,31,บุรีรัมย์,3176,ท้องถิ่นเทศบาลตำบลพนมรุ้ง,5548,5975,11523,5560,5978,11538,4047
2567,31,บุรีรัมย์,3177,ท้องถิ่นเทศบาลตำบลแคนดง,2661,2736,5397,2668,2737,5405,2051
2567,31,บุรีรัมย์,3178,ท้องถิ่นเทศบาลตำบลโนนดินแดง,4473,4661,9134,4504,4668,9172,3727
2567,31,บุรีรัมย์,3179,ท้องถิ่นเทศบาลตำบลบ้านใหม่ไชยพจน์,2040,2152,4192,2054,2155,4209,1478
2567,31,บุรีรัมย์,3180,ท้องถิ่นเทศบาลตำบลโนนสุวรรณ,1568,1641,3209,1572,1643,3215,1111
2567,31,บุรีรัมย์,3181,ท้องถิ่นเทศบาลตำบลห้วยราช,2439,2554,4993,2445,2555,5000,1486
2567,31,บุรีรัมย์,3182,ท้องถิ่นเทศบาลตำบลพลับพลาชัย,3319,3292,6611,3329,3293,6622,2082
2567,31,บุรีรัมย์,3183,ท้องถิ่นเทศบาลตำบลหนองหงส์,2311,2353,4664,2316,2354,4670,1842
2567,31,บุรีรัมย์,3184,ท้องถิ่นเทศบาลตำบลนาโพธิ์,1712,1898,3610,1715,1899,3614,1739
2567,31,บุรีรัมย์,3185,ท้องถิ่นเทศบาลตำบลปะคำ,3469,3615,7084,3477,3621,7098,2951
2567,31,บุรีรัมย์,3186,ท้องถิ่นเทศบาลตำบลสตึก,5124,5555,10679,5152,5570,10722,5827
2567,31,บุรีรัมย์,3187,ท้องถิ่นเทศบาลเมืองลำปลายมาศ,6145,6754,12899,6159,6764,12923,6432
2567,31,บุรีรัมย์,3188,ท้องถิ่นเทศบาลตำบลทะเมนชัย,2068,2143,4211,2071,2144,4215,1294
2567,31,บุรีรัมย์,3189,ท้องถิ่นเทศบาลตำบลพุทไธสง,1914,2137,4051,1915,2138,4053,2340
2567,31,บุรีรัมย์,3190,ท้องถิ่นเทศบาลตำบลบ้านกรวด,1821,1951,3772,1841,1952,3793,2036
2567,31,บุรีรัมย์,3191,ท้องถิ่นเทศบาลตำบลตลาดนิคมปราสาท,2348,2428,4776,2372,2428,4800,1849
2567,31,บุรีรัมย์,3192,ท้องถิ่นเทศบาลเมืองประโคนชัย,4207,4731,8938,4218,4734,8952,4195
2567,31,บุรีรัมย์,3193,ท้องถิ่นเทศบาลตำบลละหานทราย,4073,4107,8180,4094,4113,8207,3647
2567,31,บุรีรัมย์,3194,ท้องถิ่นเทศบาลตำบลหนองกี่,4517,4929,9446,4526,4938,9464,4272
2567,31,บุรีรัมย์,3195,ท้องถิ่นเทศบาลตำบลกระสัง,1502,1709,3211,1516,1720,3236,1867
2567,31,บุรีรัมย์,3196,ท้องถิ่นเทศบาลตำบลหินเหล็กไฟ,2387,2513,4900,2393,2516,4909,1890
2567,31,บุรีรัมย์,3197,ท้องถิ่นเทศบาลตำบลคูเมือง,1779,1784,3563,1784,1787,3571,2087
2567,31,บุรีรัมย์,3198,ท้องถิ่นเทศบาลเมืองนางรอง,9363,10652,20015,9388,10676,20064,11785
2567,31,บุรีรัมย์,3199,ท้องถิ่นเทศบาลนครบุรีรัมย์,24426,25903,50329,24570,25955,50525,31454
2567,32,สุรินทร์,3201,อำเภอเมืองสุรินทร์,106657,109727,216384,106979,109808,216787,80692
2567,32,สุรินทร์,3202,อำเภอชุมพลบุรี,33793,33842,67635,33812,33858,67670,19556
2567,32,สุรินทร์,3203,อำเภอท่าตูม,45012,44895,89907,45042,44937,89979,24470
2567,32,สุรินทร์,3204,อำเภอจอมพระ,26840,26855,53695,26848,26867,53715,14571
2567,32,สุรินทร์,3205,อำเภอปราสาท,70430,72481,142911,70602,72527,143129,44228
2567,32,สุรินทร์,3206,อำเภอกาบเชิง,29829,29716,59545,29880,29740,59620,20001
2567,32,สุรินทร์,3207,อำเภอรัตนบุรี,42671,43074,85745,42715,43096,85811,24077
2567,32,สุรินทร์,3208,อำเภอสนม,18965,18773,37738,18980,18779,37759,11213
2567,32,สุรินทร์,3209,อำเภอศีขรภูมิ,63740,64570,128310,63779,64598,128377,33821
2567,32,สุรินทร์,3210,อำเภอสังขะ,63190,62965,126155,63268,62984,126252,36330
2567,32,สุรินทร์,3211,อำเภอลำดวน,13265,13258,26523,13282,13264,26546,7353
2567,32,สุรินทร์,3212,อำเภอสำโรงทาบ,24831,24820,49651,24836,24824,49660,12255
2567,32,สุรินทร์,3213,อำเภอบัวเชด,17694,17155,34849,17724,17164,34888,10269
2567,32,สุรินทร์,3214,อำเภอพนมดงรัก,18867,18586,37453,18927,18610,37537,12707
2567,32,สุรินทร์,3215,อำเภอศรีณรงค์,23248,23031,46279,23261,23039,46300,12103
2567,32,สุรินทร์,3216,อำเภอเขวาสินรินทร์,16580,17016,33596,16615,17030,33645,10444
2567,32,สุรินทร์,3217,อำเภอโนนนารายณ์,17128,17284,34412,17133,17286,34419,9065
2567,32,สุรินทร์,3286,ท้องถิ่นเทศบาลตำบลบัวเชด,3157,3278,6435,3159,3279,6438,2513
2567,32,สุรินทร์,3287,ท้องถิ่นเทศบาลตำบลสำโรงทาบ,1161,1150,2311,1165,1151,2316,1316
2567,32,สุรินทร์,3288,ท้องถิ่นเทศบาลตำบลลำดวนสุรพินท์,2006,2245,4251,2012,2249,4261,1941
2567,32,สุรินทร์,3289,ท้องถิ่นเทศบาลตำบลสังขะ,1630,1928,3558,1633,1933,3566,2424
2567,32,สุรินทร์,3290,ท้องถิ่นเทศบาลตำบลศีขรภูมิ,2182,2372,4554,2186,2377,4563,2931
2567,32,สุรินทร์,3291,ท้องถิ่นเทศบาลตำบลสนม,2357,2520,4877,2363,2523,4886,1699
2567,32,สุรินทร์,3292,ท้องถิ่นเทศบาลตำบลรัตนบุรี,2471,2687,5158,2475,2690,5165,2825
2567,32,สุรินทร์,3293,ท้องถิ่นเทศบาลตำบลนิคมปราสาท,1334,1323,2657,1336,1324,2660,893
2567,32,สุรินทร์,3294,ท้องถิ่นเทศบาลตำบลกังแอน,2553,2932,5485,2576,2943,5519,3515
2567,32,สุรินทร์,3295,ท้องถิ่นเทศบาลตำบลจอมพระ,1883,2101,3984,1888,2102,3990,2027
2567,32,สุรินทร์,3296,ท้องถิ่นเทศบาลตำบลท่าตูม,1850,1984,3834,1854,1987,3841,1852
2567,32,สุรินทร์,3297,ท้องถิ่นเทศบาลตำบลชุมพลบุรี,1070,1171,2241,1070,1174,2244,1147
2567,32,สุรินทร์,3298,ท้องถิ่นเทศบาลตำบลเมืองที,952,918,1870,954,919,1873,581
2567,32,สุรินทร์,3299,ท้องถิ่นเทศบาลเมืองสุรินทร์,16721,19778,36499,16914,19915,36829,17507
2567,33,ศรีสะเกษ,3301,อำเภอเมืองศรีสะเกษ,42679,44345,87024,42715,44372,87087,28641
2567,33,ศรีสะเกษ,3302,อำเภอยางชุมน้อย,14562,14528,29090,14566,14531,29097,7868
2567,33,ศรีสะเกษ,3303,อำเภอกันทรารมย์,46015,46377,92392,46036,46393,92429,25518
2567,33,ศรีสะเกษ,3304,อำเภอกันทรลักษ์,91635,91437,183072,91830,91592,183422,53433
2567,33,ศรีสะเกษ,3305,อำเภอขุขันธ์,71541,72347,143888,71639,72425,144064,36720
2567,33,ศรีสะเกษ,3306,อำเภอไพรบึง,17825,18124,35949,17830,18125,35955,9420
2567,33,ศรีสะเกษ,3307,อำเภอปรางค์กู่,31013,31485,62498,31041,31502,62543,15738
2567,33,ศรีสะเกษ,3308,อำเภอขุนหาญ,33937,34473,68410,34004,34507,68511,18826
2567,33,ศรีสะเกษ,3309,อำเภอราษีไศล,37049,37479,74528,37070,37490,74560,21004
2567,33,ศรีสะเกษ,3310,อำเภออุทุมพรพิสัย,49898,50631,100529,49943,50661,100604,27568
2567,33,ศรีสะเกษ,3311,อำเภอบึงบูรพ์,2166,2154,4320,2167,2155,4322,1140
2567,33,ศรีสะเกษ,3312,อำเภอห้วยทับทัน,19322,19248,38570,19339,19256,38595,9348
2567,33,ศรีสะเกษ,3313,อำเภอโนนคูณ,19706,19441,39147,19720,19451,39171,12562
2567,33,ศรีสะเกษ,3314,อำเภอศรีรัตนะ,23892,24160,48052,23906,24166,48072,11885
2567,33,ศรีสะเกษ,3315,อำเภอน้ำเกลี้ยง,22394,21864,44258,22413,21874,44287,11748
2567,33,ศรีสะเกษ,3316,อำเภอวังหิน,20155,20001,40156,20179,20019,40198,9938
2567,33,ศรีสะเกษ,3317,อำเภอภูสิงห์,27486,27078,54564,27506,27098,54604,16576
2567,33,ศรีสะเกษ,3318,อำเภอเมืองจันทร์,8845,8696,17541,8850,8702,17552,4620
2567,33,ศรีสะเกษ,3319,อำเภอเบญจลักษ์,17995,17783,35778,18001,17785,35786,9791
2567,33,ศรีสะเกษ,3320,อำเภอพยุห์,15177,15503,30680,15187,15508,30695,8569
2567,33,ศรีสะเกษ,3321,อำเภอโพธิ์ศรีสุวรรณ,11696,11672,23368,11700,11682,23382,5940
2567,33,ศรีสะเกษ,3322,อำเภอศิลาลาด,9760,9659,19419,9765,9663,19428,5606
2567,33,ศรีสะเกษ,3381,ท้องถิ่นเทศบาลตำบลบุสูง,5127,5013,10140,5137,5017,10154,2868
2567,33,ศรีสะเกษ,3382,ท้องถิ่นเทศบาลตำบลกันทรอม,4568,4391,8959,4570,4392,8962,2375
2567,33,ศรีสะเกษ,3383,ท้องถิ่นเทศบาลตำบลกระหวัน,4302,4436,8738,4306,4439,8745,2298
2567,33,ศรีสะเกษ,3384,ท้องถิ่นเทศบาลตำบลน้ำคำ,5160,5346,10506,5162,5348,10510,3175
2567,33,ศรีสะเกษ,3385,ท้องถิ่นเทศบาลตำบลโพธิ์กระสังข์,4537,4514,9051,4538,4519,9057,2123
2567,33,ศรีสะเกษ,3386,ท้องถิ่นเทศบาลตำบลพยุห์,1916,1951,3867,1920,1952,3872,1540
2567,33,ศรีสะเกษ,3387,ท้องถิ่นเทศบาลตำบลศรีรัตนะ,2240,2324,4564,2242,2325,4567,1503
2567,33,ศรีสะเกษ,3388,ท้องถิ่นเทศบาลตำบลห้วยทับทัน,1652,1610,3262,1656,1611,3267,1110
2567,33,ศรีสะเกษ,3389,ท้องถิ่นเทศบาลตำบลบึงบูรพ์,2901,3044,5945,2904,3045,5949,1914
2567,33,ศรีสะเกษ,3390,ท้องถิ่นเทศบาลตำบลกำแพง,1191,1309,2500,1196,1314,2510,1354
2567,33,ศรีสะเกษ,3391,ท้องถิ่นเทศบาลตำบลเมืองคง,1828,1962,3790,1831,1962,3793,2165
2567,33,ศรีสะเกษ,3392,ท้องถิ่นเทศบาลตำบลขุนหาญ,5210,5346,10556,5232,5348,10580,3936
2567,33,ศรีสะเกษ,3393,ท้องถิ่นเทศบาลตำบลปรางค์กู่,1362,1408,2770,1365,1409,2774,1382
2567,33,ศรีสะเกษ,3394,ท้องถิ่นเทศบาลตำบลไพรบึง,5364,5398,10762,5368,5399,10767,3078
2567,33,ศรีสะเกษ,3395,ท้องถิ่นเทศบาลตำบลเมืองขุขันธ์,1990,2115,4105,1994,2116,4110,2200
2567,33,ศรีสะเกษ,3396,ท้องถิ่นเทศบาลเมืองกันทรลักษ์,8141,8956,17097,8185,8975,17160,7867
2567,33,ศรีสะเกษ,3397,ท้องถิ่นเทศบาลตำบลกันทรารมย์,2825,3082,5907,2831,3086,5917,3346
2567,33,ศรีสะเกษ,3398,ท้องถิ่นเทศบาลตำบลยางชุมน้อย,3036,3167,6203,3038,3171,6209,2522
2567,33,ศรีสะเกษ,3399,ท้องถิ่นเทศบาลเมืองศรีสะเกษ,18086,20475,38561,18197,20549,38746,21761
2567,34,อุบลราชธานี,3401,อำเภอเมืองอุบลราชธานี,48044,50128,98172,48202,50196,98398,38838
2567,34,อุบลราชธานี,3402,อำเภอศรีเมืองใหม่,33469,32849,66318,33605,33061,66666,20190
2567,34,อุบลราชธานี,3403,อำเภอโขงเจียม,17948,17343,35291,18294,18033,36327,10854
2567,34,อุบลราชธานี,3404,อำเภอเขื่องใน,49782,50819,100601,49824,50848,100672,29244
2567,34,อุบลราชธานี,3405,อำเภอเขมราฐ,15819,15598,31417,15998,16012,32010,9534
2567,34,อุบลราชธานี,3407,อำเภอเดชอุดม,66304,65492,131796,66362,65513,131875,56002
2567,34,อุบลราชธานี,3408,อำเภอนาจะหลวย,26112,25466,51578,26148,25499,51647,19398
2567,34,อุบลราชธานี,3409,อำเภอน้ำยืน,31000,30093,61093,31041,30147,61188,21464
2567,34,อุบลราชธานี,3410,อำเภอบุณฑริก,39222,38073,77295,39522,38460,77982,25208
2567,34,อุบลราชธานี,3411,อำเภอตระการพืชผล,55820,55375,111195,55878,55449,111327,31122
2567,34,อุบลราชธานี,3412,อำเภอกุดข้าวปุ้น,18356,18135,36491,18365,18154,36519,9947
2567,34,อุบลราชธานี,3414,อำเภอม่วงสามสิบ,40300,40274,80574,40336,40308,80644,24063
2567,34,อุบลราชธานี,3415,อำเภอวารินชำราบ,46100,47062,93162,46196,47125,93321,32952
2567,34,อุบลราชธานี,3419,อำเภอพิบูลมังสาหาร,52274,51554,103828,52369,51691,104060,35796
2567,34,อุบลราชธานี,3420,อำเภอตาลสุม,15075,14649,29724,15089,14662,29751,9007
2567,34,อุบลราชธานี,3421,อำเภอโพธิ์ไทร,22584,21839,44423,22824,22250,45074,12629
2567,34,อุบลราชธานี,3422,อำเภอสำโรง,26947,26865,53812,26961,26871,53832,15617
2567,34,อุบลราชธานี,3424,อำเภอดอนมดแดง,13581,13450,27031,13596,13468,27064,8413
2567,34,อุบลราชธานี,3425,อำเภอสิรินธร,22247,21247,43494,22491,21756,44247,15417
2567,34,อุบลราชธานี,3426,อำเภอทุ่งศรีอุดม,14730,14375,29105,14736,14383,29119,9519
2567,34,อุบลราชธานี,3429,อำเภอนาเยีย,10918,10279,21197,10929,10288,21217,7580
2567,34,อุบลราชธานี,3430,อำเภอนาตาล,19222,19035,38257,19484,19455,38939,11938
2567,34,อุบลราชธานี,3431,อำเภอเหล่าเสือโก้ก,14045,13960,28005,14063,13966,28029,8372
2567,34,อุบลราชธานี,3432,อำเภอสว่างวีระวงศ์,15612,15499,31111,15631,15518,31149,9799
2567,34,อุบลราชธานี,3433,อำเภอน้ำขุ่น,16699,16471,33170,16716,16477,33193,11459
2567,34,อุบลราชธานี,3463,ท้องถิ่นเทศบาลตำบลกุดชมภู,5866,5807,11673,5893,5844,11737,4636
2567,34,อุบลราชธานี,3464,ท้องถิ่นเทศบาลตำบลคำน้ำแซบ,4042,4207,8249,4065,4216,8281,3472
2567,34,อุบลราชธานี,3465,ท้องถิ่นเทศบาลตำบลหัวนา,6521,6579,13100,6541,6598,13139,3751
2567,34,อุบลราชธานี,3466,ท้องถิ่นเทศบาลตำบลโพนงาม,4425,4591,9016,4430,4591,9021,3396
2567,34,อุบลราชธานี,3467,ท้องถิ่นเทศบาลตำบลเมืองศรีไค,4515,7136,11651,4521,7138,11659,3572
2567,34,อุบลราชธานี,3468,ท้องถิ่นเทศบาลตำบลหนองผือ,4889,5018,9907,4895,5029,9924,3535
2567,34,อุบลราชธานี,3469,ท้องถิ่นเทศบาลตำบลขามป้อม,4721,4653,9374,4754,4721,9475,3349
2567,34,อุบลราชธานี,3470,ท้องถิ่นเทศบาลเมืองเทพวงศา,5944,5782,11726,6164,6246,12410,4386
2567,34,อุบลราชธานี,3471,ท้องถิ่นเทศบาลตำบลปทุม,4872,5534,10406,4904,5550,10454,4360
2567,34,อุบลราชธานี,3472,ท้องถิ่นเทศบาลตำบลคอแลน,6687,6444,13131,6755,6567,13322,4193
2567,34,อุบลราชธานี,3473,ท้องถิ่น ทต.นิคมสร้างตนเองลำโดมน้อย,3881,3893,7774,3919,3961,7880,3123
2567,34,อุบลราชธานี,3474,ท้องถิ่นเทศบาลตำบลกุดประทาย,6896,6727,13623,6899,6736,13635,5374
2567,34,อุบลราชธานี,3475,ท้องถิ่นเทศบาลตำบลขามใหญ่,19543,21974,41517,19714,22013,41727,22883
2567,34,อุบลราชธานี,3476,ท้องถิ่นเทศบาลตำบลแสนสุข,13563,11303,24866,13627,11324,24951,11955
2567,34,อุบลราชธานี,3477,ท้องถิ่นเทศบาลตำบลนาเยีย,3109,3204,6313,3111,3206,6317,1951
2567,34,อุบลราชธานี,3478,ท้องถิ่นเทศบาลตำบลช่องเม็ก,1826,1810,3636,1849,1947,3796,1974
2567,34,อุบลราชธานี,3479,ท้องถิ่นเทศบาลตำบลโพธิ์ไทร,1440,1505,2945,1446,1507,2953,1234
2567,34,อุบลราชธานี,3480,ท้องถิ่นเทศบาลตำบลตาลสุม,1584,1616,3200,1584,1616,3200,1164
2567,34,อุบลราชธานี,3481,ท้องถิ่นเทศบาลตำบลอ่างศิลา,1433,1566,2999,1435,1568,3003,1058
2567,34,อุบลราชธานี,3482,ท้องถิ่นเทศบาลตำบลห้วยขะยุง,1484,1566,3050,1489,1566,3055,1012
2567,34,อุบลราชธานี,3483,ท้องถิ่นเทศบาลตำบลม่วงสามสิบ,1401,1541,2942,1407,1543,2950,1656
2567,34,อุบลราชธานี,3484,ท้องถิ่นเทศบาลตำบลกุดข้าวปุ้น,2094,2058,4152,2098,2060,4158,1552
2567,34,อุบลราชธานี,3485,ท้องถิ่นเทศบาลตำบลตระการพืชผล,4248,4509,8757,4265,4522,8787,4544
2567,34,อุบลราชธานี,3486,ท้องถิ่นเทศบาลตำบลบุณฑริก,2104,2231,4335,2108,2235,4343,2192
2567,34,อุบลราชธานี,3487,ท้องถิ่นเทศบาลตำบลน้ำยืน,4249,4371,8620,4260,4382,8642,3525
2567,34,อุบลราชธานี,3488,ท้องถิ่นเทศบาลตำบลนาจะหลวย,3381,3418,6799,3391,3423,6814,2736
2567,34,อุบลราชธานี,3489,ท้องถิ่นเทศบาลเมืองเดชอุดม,6083,6633,12716,6103,6644,12747,7011
2567,34,อุบลราชธานี,3490,ท้องถิ่นเทศบาลตำบลบัวงาม,3257,3277,6534,3259,3278,6537,1938
2567,34,อุบลราชธานี,3491,ท้องถิ่นเทศบาลตำบลนาส่วง,1498,1601,3099,1500,1603,3103,1049
2567,34,อุบลราชธานี,3492,ท้องถิ่นเทศบาลตำบลเขมราฐ,2778,3015,5793,2817,3121,5938,2640
2567,34,อุบลราชธานี,3493,ท้องถิ่นเทศบาลตำบลเขื่องใน,2114,2259,4373,2116,2261,4377,2201
2567,34,อุบลราชธานี,3494,ท้องถิ่นเทศบาลตำบลบ้านด่านโขงเจียม,1380,1319,2699,1438,1459,2897,1382
2567,34,อุบลราชธานี,3495,ท้องถิ่นเทศบาลตำบลศรีเมืองใหม่,2011,2001,4012,2016,2009,4025,2117
2567,34,อุบลราชธานี,3496,ท้องถิ่นเทศบาลตำบลอุบล,2527,2995,5522,2551,2998,5549,3214
2567,34,อุบลราชธานี,3497,ท้องถิ่นเทศบาลเมืองพิบูลมังสาหาร,4765,5047,9812,4779,5066,9845,4683
2567,34,อุบลราชธานี,3498,ท้องถิ่นเทศบาลเมืองวารินชำราบ,11434,12970,24404,11476,12990,24466,11080
2567,34,อุบลราชธานี,3499,ท้องถิ่นเทศบาลนครอุบลราชธานี,31153,36702,67855,31533,37042,68575,32743
2567,35,ยโสธร,3501,อำเภอเมืองยโสธร,52575,52960,105535,52643,52992,105635,40833
2567,35,ยโสธร,3502,อำเภอทรายมูล,12078,12065,24143,12087,12071,24158,8419
2567,35,ยโสธร,3503,อำเภอกุดชุม,30480,30177,60657,30502,30192,60694,21029
2567,35,ยโสธร,3504,อำเภอคำเขื่อนแก้ว,30249,30420,60669,30273,30438,60711,20093
2567,35,ยโสธร,3505,อำเภอป่าติ้ว,15656,15851,31507,15672,15856,31528,10634
2567,35,ยโสธร,3506,อำเภอมหาชนะชัย,25178,25204,50382,25192,25220,50412,15229
2567,35,ยโสธร,3507,อำเภอค้อวัง,10060,10273,20333,10066,10280,20346,5752
2567,35,ยโสธร,3508,อำเภอเลิงนกทา,44180,44627,88807,44216,44657,88873,31695
2567,35,ยโสธร,3509,อำเภอไทยเจริญ,14944,15158,30102,14952,15167,30119,11510
2567,35,ยโสธร,3591,ท้องถิ่นเทศบาลตำบลสามแยก,1832,1954,3786,1837,1954,3791,2389
2567,35,ยโสธร,3592,ท้องถิ่นเทศบาลตำบลเลิงนกทา,1346,1440,2786,1349,1444,2793,1131
2567,35,ยโสธร,3593,ท้องถิ่นเทศบาลตำบลค้อวัง,2135,2270,4405,2137,2271,4408,1699
2567,35,ยโสธร,3594,ท้องถิ่นเทศบาลตำบลฟ้าหยาด,2247,2296,4543,2249,2298,4547,1935
2567,35,ยโสธร,3595,ท้องถิ่นเทศบาลตำบลป่าติ้ว,1448,1485,2933,1451,1486,2937,1323
2567,35,ยโสธร,3596,ท้องถิ่นเทศบาลตำบลคำเขื่อนแก้ว,1786,1853,3639,1788,1857,3645,1590
2567,35,ยโสธร,3597,ท้องถิ่นเทศบาลตำบลกุดชุมพัฒนา,2314,2435,4749,2319,2437,4756,2322
2567,35,ยโสธร,3598,ท้องถิ่นเทศบาลตำบลทรายมูล,2969,3221,6190,2973,3223,6196,2266
2567,35,ยโสธร,3599,ท้องถิ่นเทศบาลเมืองยโสธร,9481,10264,19745,9498,10278,19776,9493
2567,36,ชัยภูมิ,3601,อำเภอเมืองชัยภูมิ,65795,69467,135262,65937,69521,135458,57980
2567,36,ชัยภูมิ,3602,อำเภอบ้านเขว้า,20518,21065,41583,20529,21078,41607,15324
2567,36,ชัยภูมิ,3603,อำเภอคอนสวรรค์,23195,23821,47016,23221,23833,47054,18679
2567,36,ชัยภูมิ,3604,อำเภอเกษตรสมบูรณ์,42021,42449,84470,42087,42474,84561,26275
2567,36,ชัยภูมิ,3605,อำเภอหนองบัวแดง,46302,46221,92523,46415,46278,92693,31368
2567,36,ชัยภูมิ,3606,อำเภอจัตุรัส,32087,34394,66481,32128,34416,66544,25942
2567,36,ชัยภูมิ,3607,อำเภอบำเหน็จณรงค์,19768,20369,40137,19790,20382,40172,14274
2567,36,ชัยภูมิ,3608,อำเภอหนองบัวระเหว,16257,16230,32487,16277,16235,32512,12131
2567,36,ชัยภูมิ,3609,อำเภอเทพสถิต,32790,32242,65032,32855,32261,65116,25075
2567,36,ชัยภูมิ,3610,อำเภอภูเขียว,52473,54497,106970,52601,54537,107138,36788
2567,36,ชัยภูมิ,3611,อำเภอบ้านแท่น,19898,20313,40211,19920,20321,40241,12139
2567,36,ชัยภูมิ,3612,อำเภอแก้งคร้อ,35928,36238,72166,35963,36250,72213,26397
2567,36,ชัยภูมิ,3613,อำเภอคอนสาร,19838,20289,40127,19865,20301,40166,14662
2567,36,ชัยภูมิ,3614,อำเภอภักดีชุมพล,15210,15053,30263,15250,15079,30329,12863
2567,36,ชัยภูมิ,3615,อำเภอเนินสง่า,12483,12892,25375,12492,12900,25392,8876
2567,36,ชัยภูมิ,3616,อำเภอซับใหญ่,7822,7669,15491,7833,7675,15508,6044
2567,36,ชัยภูมิ,3653,สาขาตำบลวังชมภู หนองบัวแดง,0,0,0,0,0,0,0
2567,36,ชัยภูมิ,3676,ท้องถิ่นเทศบาลตำบลห้วยยาง,7618,7642,15260,7630,7649,15279,4788
2567,36,ชัยภูมิ,3677,ท้องถิ่นเทศบาลตำบลบ้านเดื่อ,7652,7725,15377,7659,7726,15385,4784
2567,36,ชัยภูมิ,3680,ท้องถิ่นเทศบาลตำบลคอนสาร,1895,2137,4032,1900,2139,4039,1515
2567,36,ชัยภูมิ,3681,ท้องถิ่นเทศบาลตำบลแก้งคร้อ,3780,4312,8092,3789,4315,8104,4824
2567,36,ชัยภูมิ,3682,ท้องถิ่นเทศบาลตำบลนาหนองทุ่ม,5083,5458,10541,5090,5459,10549,3399
2567,36,ชัยภูมิ,3683,ท้องถิ่นเทศบาลตำบลบ้านแท่น,1905,2005,3910,1908,2005,3913,1697
2567,36,ชัยภูมิ,3684,ท้องถิ่นเทศบาลตำบลภูเขียว,2673,3130,5803,2691,3137,5828,3122
2567,36,ชัยภูมิ,3685,ท้องถิ่นเทศบาลตำบลบ้านเพชรภูเขียว,2681,2734,5415,2686,2735,5421,1810
2567,36,ชัยภูมิ,3686,ท้องถิ่นเทศบาลตำบลเทพสถิต,1860,1884,3744,1864,1886,3750,2384
2567,36,ชัยภูมิ,3687,ท้องถิ่นเทศบาลตำบลหนองบัวระเหว,2831,2900,5731,2838,2903,5741,2816
2567,36,ชัยภูมิ,3688,ท้องถิ่นเทศบาลตำบลบำเหน็จณรงค์,3165,3461,6626,3170,3462,6632,3139
2567,36,ชัยภูมิ,3689,ท้องถิ่นเทศบาลตำบลบ้านเพชร,2253,2423,4676,2258,2427,4685,2289
2567,36,ชัยภูมิ,3690,ท้องถิ่นเทศบาลตำบลหนองบัวโคก,913,950,1863,916,951,1867,840
2567,36,ชัยภูมิ,3691,ท้องถิ่นเทศบาลตำบลจัตุรัส,1905,2094,3999,1909,2095,4004,2285
2567,36,ชัยภูมิ,3692,ท้องถิ่นเทศบาลตำบลหนองบัวแดง,4134,4369,8503,4148,4376,8524,4600
2567,36,ชัยภูมิ,3693,ท้องถิ่นเทศบาลตำบลบ้านเป้า,3638,3847,7485,3642,3849,7491,2442
2567,36,ชัยภูมิ,3694,ท้องถิ่นเทศบาลตำบลเกษตรสมบูรณ์,1341,1490,2831,1344,1493,2837,1353
2567,36,ชัยภูมิ,3695,ท้องถิ่นเทศบาลตำบลคอนสวรรค์,1905,2125,4030,1918,2125,4043,1938
2567,36,ชัยภูมิ,3696,ท้องถิ่นเทศบาลตำบลบ้านเขว้า,3669,4062,7731,3674,4063,7737,3567
2567,36,ชัยภูมิ,3697,ท้องถิ่นเทศบาลตำบลลาดใหญ่,2082,2361,4443,2085,2361,4446,1813
2567,36,ชัยภูมิ,3698,ท้องถิ่นเทศบาลตำบลบ้านค่ายหมื่นแผ้ว,2294,2422,4716,2303,2423,4726,2001
2567,36,ชัยภูมิ,3699,ท้องถิ่นเทศบาลเมืองชัยภูมิ,16300,18306,34606,16369,18330,34699,21996
2567,37,อำนาจเจริญ,3701,อำเภอเมืองอำนาจเจริญ,48239,48436,96675,48313,48483,96796,33111
2567,37,อำนาจเจริญ,3702,อำเภอชานุมาน,19271,19095,38366,19403,19305,38708,12404
2567,37,อำนาจเจริญ,3703,อำเภอปทุมราชวงศา,22905,22664,45569,22916,22672,45588,14242
2567,37,อำนาจเจริญ,3704,อำเภอพนา,9510,9399,18909,9511,9400,18911,7079
2567,37,อำนาจเจริญ,3705,อำเภอเสนางคนิคม,17225,17582,34807,17247,17597,34844,11519
2567,37,อำนาจเจริญ,3706,อำเภอหัวตะพาน,20603,20687,41290,20612,20711,41323,11474
2567,37,อำนาจเจริญ,3707,อำเภอลืออำนาจ,16715,16912,33627,16722,16922,33644,10315
2567,37,อำนาจเจริญ,3790,ท้องถิ่นเทศบาลตำบลนายม,2553,2627,5180,2557,2630,5187,1597
2567,37,อำนาจเจริญ,3791,ท้องถิ่นเทศบาลตำบลพระเหลา,2952,2990,5942,2956,2990,5946,2341
2567,37,อำนาจเจริญ,3792,ท้องถิ่นเทศบาลตำบลอำนาจ,985,1127,2112,985,1128,2113,1063
2567,37,อำนาจเจริญ,3793,ท้องถิ่นเทศบาลตำบลหัวตะพาน,3286,3434,6720,3289,3441,6730,2329
2567,37,อำนาจเจริญ,3794,ท้องถิ่นเทศบาลตำบลเสนางคนิคม,2630,2887,5517,2637,2893,5530,2026
2567,37,อำนาจเจริญ,3795,ท้องถิ่นเทศบาลตำบลพนา,1171,1346,2517,1173,1346,2519,1176
2567,37,อำนาจเจริญ,3796,ท้องถิ่นเทศบาลตำบลปทุมราชวงศา,1628,1687,3315,1628,1688,3316,1771
2567,37,อำนาจเจริญ,3797,ท้องถิ่นเทศบาลตำบลชานุมาน,1465,1586,3051,1502,1647,3149,1521
2567,37,อำนาจเจริญ,3798,ท้องถิ่นเทศบาลตำบลน้ำปลีก,1719,1888,3607,1727,1889,3616,1272
2567,37,อำนาจเจริญ,3799,ท้องถิ่นเทศบาลเมืองอำนาจเจริญ,11562,12631,24193,11605,12658,24263,13319
2567,38,บึงกาฬ,3801,อำเภอเมืองบึงกาฬ,29130,29077,58207,29214,29166,58380,19608
2567,38,บึงกาฬ,3802,อำเภอพรเจริญ,14407,14273,28680,14421,14277,28698,8648
2567,38,บึงกาฬ,3803,อำเภอโซ่พิสัย,32406,32056,64462,32438,32079,64517,20112
2567,38,บึงกาฬ,3804,อำเภอเซกา,36558,36317,72875,36646,36361,73007,24745
2567,38,บึงกาฬ,3805,อำเภอปากคาด,14014,13938,27952,14046,13962,28008,10192
2567,38,บึงกาฬ,3806,อำเภอบึงโขงหลง,14064,13857,27921,14116,13887,28003,9521
2567,38,บึงกาฬ,3807,อำเภอศรีวิไล,14238,14097,28335,14246,14105,28351,9819
2567,38,บึงกาฬ,3808,อำเภอบุ่งคล้า,6930,6916,13846,6956,6987,13943,4455
2567,38,บึงกาฬ,3887,ท้องถิ่นเทศบาลตำบลหอคำ,3604,3616,7220,3612,3620,7232,2453
2567,38,บึงกาฬ,3888,ท้องถิ่นเทศบาลตำบลโนนสว่าง,3405,3430,6835,3409,3432,6841,2485
2567,38,บึงกาฬ,3889,ท้องถิ่นเทศบาลตำบลวิศิษฐ์,0,0,0,0,0,0,0
2567,38,บึงกาฬ,3890,ท้องถิ่นเทศบาลตำบลศรีวิไล,5389,5481,10870,5397,5484,10881,4125
2567,38,บึงกาฬ,3891,ท้องถิ่นเทศบาลตำบลบึงโขงหลง,4723,4895,9618,4749,4900,9649,3717
2567,38,บึงกาฬ,3892,ท้องถิ่นเทศบาลตำบลปากคาด,3183,3169,6352,3190,3174,6364,2800
2567,38,บึงกาฬ,3893,ท้องถิ่นเทศบาลตำบลศรีพนา,3178,3248,6426,3190,3249,6439,2815
2567,38,บึงกาฬ,3894,ท้องถิ่นเทศบาลตำบลท่าสะอาด,3305,3472,6777,3309,3480,6789,2053
2567,38,บึงกาฬ,3895,ท้องถิ่นเทศบาลตำบลโซ่พิสัย,3174,3199,6373,3187,3204,6391,2734
2567,38,บึงกาฬ,3896,ท้องถิ่นเทศบาลตำบลพรเจริญ,4922,5189,10111,4931,5201,10132,3719
2567,38,บึงกาฬ,3897,ท้องถิ่นเทศบาลตำบลดอนหญ้านาง,2463,2503,4966,2465,2504,4969,1584
2567,38,บึงกาฬ,3898,ท้องถิ่นเทศบาลเมืองบึงกาฬ,9878,10140,20018,9937,10202,20139,11874
2567,39,หนองบัวลำภู,3901,อำเภอเมืองหนองบัวลำภู,50507,50857,101364,50613,50890,101503,33364
2567,39,หนองบัวลำภู,3902,อำเภอนากลาง,33288,33039,66327,33352,33053,66405,19618
2567,39,หนองบัวลำภู,3903,อำเภอโนนสัง,26403,26866,53269,26446,26878,53324,14379
2567,39,หนองบัวลำภู,3904,อำเภอศรีบุญเรือง,45077,44614,89691,45168,44632,89800,26271
2567,39,หนองบัวลำภู,3905,อำเภอสุวรรณคูหา,26756,26722,53478,26799,26737,53536,15816
2567,39,หนองบัวลำภู,3906,อำเภอนาวัง,14969,14978,29947,15008,14988,29996,9081
2567,39,หนองบัวลำภู,3986,ท้องถิ่นเทศบาลตำบลยางหล่อ,4562,4684,9246,4566,4688,9254,2700
2567,39,หนองบัวลำภู,3987,ท้องถิ่นเทศบาลตำบลนาเหล่า,3307,3511,6818,3319,3513,6832,2504
2567,39,หนองบัวลำภู,3988,ท้องถิ่นเทศบาลตำบลสุวรรณคูหา,3724,3927,7651,3742,3929,7671,2999
2567,39,หนองบัวลำภู,3989,ท้องถิ่นเทศบาลตำบลบ้านโคก,2921,3223,6144,2928,3226,6154,1958
2567,39,หนองบัวลำภู,3990,ท้องถิ่นเทศบาลตำบลโนนสูงเปลือย,2133,2378,4511,2141,2382,4523,2721
2567,39,หนองบัวลำภู,3991,ท้องถิ่นเทศบาลตำบลจอมทอง,2495,2419,4914,2500,2421,4921,1551
2567,39,หนองบัวลำภู,3992,ท้องถิ่นเทศบาลตำบลโนนสัง,4021,4188,8209,4038,4193,8231,3030
2567,39,หนองบัวลำภู,3993,ท้องถิ่นเทศบาลตำบลกุดดู่,1352,1367,2719,1358,1367,2725,783
2567,39,หนองบัวลำภู,3994,ท้องถิ่นเทศบาลตำบลนากลาง,9512,10046,19558,9540,10055,19595,6896
2567,39,หนองบัวลำภู,3995,ท้องถิ่นเทศบาลตำบลกุดดินจี่,2684,2837,5521,2693,2837,5530,1895
2567,39,หนองบัวลำภู,3996,ท้องถิ่นเทศบาลตำบลหัวนา,1774,1758,3532,1779,1758,3537,1090
2567,39,หนองบัวลำภู,3997,ท้องถิ่นเทศบาลตำบลนามะเฟือง,2004,2144,4148,2010,2145,4155,1135
2567,39,หนองบัวลำภู,3998,ท้องถิ่นเทศบาลตำบลนาคำไฮ,2399,2462,4861,2408,2464,4872,1466
2567,39,หนองบัวลำภู,3999,ท้องถิ่นเทศบาลเมืองหนองบัวลำภู,10384,11324,21708,10454,11361,21815,12732
2567,40,ขอนแก่น,4001,อำเภอเมืองขอนแก่น,47842,51433,99275,48020,51475,99495,43676
2567,40,ขอนแก่น,4002,อำเภอบ้านฝาง,24694,25038,49732,24745,25046,49791,18297
2567,40,ขอนแก่น,4003,อำเภอพระยืน,12021,12538,24559,12046,12540,24586,8286
2567,40,ขอนแก่น,4004,อำเภอหนองเรือ,40647,41808,82455,40685,41824,82509,24212
2567,40,ขอนแก่น,4005,อำเภอชุมแพ,40911,41466,82377,41023,41484,82507,27365
2567,40,ขอนแก่น,4006,อำเภอสีชมพู,36069,36704,72773,36148,36720,72868,23437
2567,40,ขอนแก่น,4007,อำเภอน้ำพอง,35400,36245,71645,35444,36275,71719,23023
2567,40,ขอนแก่น,4008,อำเภออุบลรัตน์,15301,15712,31013,15322,15719,31041,8723
2567,40,ขอนแก่น,4009,อำเภอกระนวน,33653,34214,67867,33727,34219,67946,21248
2567,40,ขอนแก่น,4010,อำเภอบ้านไผ่,35221,36278,71499,35278,36289,71567,24663
2567,40,ขอนแก่น,4011,อำเภอเปือยน้อย,7136,7034,14170,7139,7037,14176,4165
2567,40,ขอนแก่น,4012,อำเภอพล,36894,37929,74823,36928,37946,74874,24469
2567,40,ขอนแก่น,4013,อำเภอแวงใหญ่,11710,12044,23754,11718,12054,23772,6685
2567,40,ขอนแก่น,4014,อำเภอแวงน้อย,18972,19092,38064,18986,19101,38087,11903
2567,40,ขอนแก่น,4015,อำเภอหนองสองห้อง,34976,35487,70463,35017,35506,70523,21915
2567,40,ขอนแก่น,4016,อำเภอภูเวียง,33816,34316,68132,33867,34334,68201,21470
2567,40,ขอนแก่น,4017,อำเภอมัญจาคีรี,32405,33143,65548,32441,33152,65593,22831
2567,40,ขอนแก่น,4018,อำเภอชนบท,19087,19898,38985,19112,19905,39017,12191
2567,40,ขอนแก่น,4019,อำเภอเขาสวนกวาง,10545,10679,21224,10572,10681,21253,6661
2567,40,ขอนแก่น,4020,อำเภอภูผาม่าน,9715,9706,19421,9728,9710,19438,6098
2567,40,ขอนแก่น,4021,อำเภอซำสูง,8814,9115,17929,8819,9120,17939,5504
2567,40,ขอนแก่น,4022,อำเภอโคกโพธิ์ไชย,10375,10428,20803,10382,10437,20819,6935
2567,40,ขอนแก่น,4023,อำเภอหนองนาคำ,11598,11778,23376,11613,11782,23395,7104
2567,40,ขอนแก่น,4024,อำเภอบ้านแฮด,12821,13144,25965,12829,13151,25980,8738
2567,40,ขอนแก่น,4025,อำเภอโนนศิลา,10382,10500,20882,10387,10504,20891,6801
2567,40,ขอนแก่น,4029,อำเภอเวียงเก่า,9743,9953,19696,9750,9954,19704,5977
2567,40,ขอนแก่น,4054,ท้องถิ่นเทศบาลเมืองศิลา,27116,28041,55157,27265,28075,55340,32137
2567,40,ขอนแก่น,4055,ท้องถิ่นเทศบาลตำบลโคกสูง,4380,4326,8706,4409,4330,8739,2606
2567,40,ขอนแก่น,4056,ท้องถิ่นเทศบาลตำบลสะอาด,4886,4962,9848,4892,4965,9857,2803
2567,40,ขอนแก่น,4057,ท้องถิ่นเทศบาลเมืองบ้านทุ่ม,9292,10035,19327,9333,10049,19382,9638
2567,40,ขอนแก่น,4058,ท้องถิ่นเทศบาลตำบลโนนสมบูรณ์,2909,2928,5837,2914,2929,5843,1863
2567,40,ขอนแก่น,4060,ท้องถิ่นเทศบาลตำบลม่วงหวาน,4915,5153,10068,4924,5158,10082,3684
2567,40,ขอนแก่น,4061,ท้องถิ่นเทศบาลตำบลหนองตูม,3616,3962,7578,3624,3964,7588,2339
2567,40,ขอนแก่น,4062,ท้องถิ่นเทศบาลตำบลเมืองเก่า,15089,17669,32758,15303,17691,32994,19056
2567,40,ขอนแก่น,4063,ท้องถิ่นเทศบาลตำบลโนนท่อน,4759,4961,9720,4762,4965,9727,3351
2567,40,ขอนแก่น,4064,ท้องถิ่นเทศบาลตำบลบ้านค้อ,8518,8939,17457,8536,8944,17480,7548
2567,40,ขอนแก่น,4065,ท้องถิ่นเทศบาลตำบลกุดน้ำใส,4136,4325,8461,4149,4334,8483,2848
2567,40,ขอนแก่น,4067,ท้องถิ่นเทศบาลตำบลสาวะถี,8828,9035,17863,8857,9046,17903,6137
2567,40,ขอนแก่น,4068,ท้องถิ่นเทศบาลเมืองบ้านเป็ด,22139,26171,48310,22409,26213,48622,30471
2567,40,ขอนแก่น,4069,ท้องถิ่นเทศบาลตำบลโนนศิลา,2723,2766,5489,2724,2768,5492,1965
2567,40,ขอนแก่น,4070,ท้องถิ่นเทศบาลตำบลบ้านแฮด,3246,3338,6584,3249,3340,6589,2369
2567,40,ขอนแก่น,4071,ท้องถิ่นเทศบาลตำบลบ้านโคก,1923,2098,4021,1926,2099,4025,1568
2567,40,ขอนแก่น,4072,ท้องถิ่นเทศบาลตำบลซำสูง,2528,2647,5175,2531,2648,5179,2044
2567,40,ขอนแก่น,4073,ท้องถิ่นเทศบาลตำบลภูผาม่าน,1642,1748,3390,1644,1750,3394,1352
2567,40,ขอนแก่น,4074,ท้องถิ่นเทศบาลตำบลเขาสวนกวาง,5176,5327,10503,5200,5336,10536,3952
2567,40,ขอนแก่น,4075,ท้องถิ่นเทศบาลตำบลชนบท,3561,4015,7576,3566,4017,7583,3461
2567,40,ขอนแก่น,4076,ท้องถิ่นเทศบาลตำบลมัญจาคีรี,1596,1769,3365,1600,1771,3371,2003
2567,40,ขอนแก่น,4077,ท้องถิ่นเทศบาลตำบลภูเวียง,1282,1458,2740,1287,1459,2746,1780
2567,40,ขอนแก่น,4078,ท้องถิ่นเทศบาลตำบลหนองสองห้อง,2636,2810,5446,2648,2814,5462,2849
2567,40,ขอนแก่น,4079,ท้องถิ่นเทศบาลตำบลแวงน้อย,1412,1569,2981,1412,1570,2982,1393
2567,40,ขอนแก่น,4080,ท้องถิ่นเทศบาลตำบลแวงใหญ่,2434,2626,5060,2441,2627,5068,1874
2567,40,ขอนแก่น,4081,ท้องถิ่นเทศบาลตำบลเปือยน้อย,2818,2950,5768,2827,2951,5778,2089
2567,40,ขอนแก่น,4082,ท้องถิ่นเทศบาลเมืองกระนวน,4520,5014,9534,4555,5022,9577,4677
2567,40,ขอนแก่น,4083,ท้องถิ่นเทศบาลตำบลเขื่อนอุบลรัตน์,1849,1965,3814,1860,1966,3826,2138
2567,40,ขอนแก่น,4084,ท้องถิ่นเทศบาลตำบลวังชัย,2988,3252,6240,2994,3253,6247,3029
2567,40,ขอนแก่น,4085,ท้องถิ่นเทศบาลตำบลน้ำพอง,2218,2453,4671,2225,2456,4681,2489
2567,40,ขอนแก่น,4086,ท้องถิ่นเทศบาลตำบลสีชมพู,1597,1659,3256,1609,1660,3269,1603
2567,40,ขอนแก่น,4087,ท้องถิ่นเทศบาลตำบลโนนหัน,2124,2360,4484,2133,2362,4495,1571
2567,40,ขอนแก่น,4088,ท้องถิ่นเทศบาลตำบลโคกสูงสัมพันธ์,2044,2273,4317,2059,2274,4333,1370
2567,40,ขอนแก่น,4089,ท้องถิ่นเทศบาลตำบลหนองเรือ,2081,2053,4134,2090,2057,4147,2287
2567,40,ขอนแก่น,4090,ท้องถิ่นเทศบาลตำบลหนองแก,679,674,1353,680,675,1355,723
2567,40,ขอนแก่น,4091,ท้องถิ่นเทศบาลตำบลดอนโมง,1615,1717,3332,1622,1720,3342,1959
2567,40,ขอนแก่น,4092,ท้องถิ่นเทศบาลตำบลพระยืน,1548,1737,3285,1549,1739,3288,1574
2567,40,ขอนแก่น,4093,ท้องถิ่นเทศบาลตำบลบ้านโต้น,3060,3311,6371,3075,3311,6386,2142
2567,40,ขอนแก่น,4094,ท้องถิ่นเทศบาลตำบลบ้านฝาง,2160,2326,4486,2170,2333,4503,1970
2567,40,ขอนแก่น,4095,ท้องถิ่นเทศบาลตำบลท่าพระ,4030,4474,8504,4062,4478,8540,4257
2567,40,ขอนแก่น,4096,ท้องถิ่นเทศบาลเมืองชุมแพ,14462,15766,30228,14642,15810,30452,16479
2567,40,ขอนแก่น,4097,ท้องถิ่นเทศบาลเมืองบ้านไผ่,12323,13658,25981,12454,13734,26188,13198
2567,40,ขอนแก่น,4098,ท้องถิ่นเทศบาลเมืองเมืองพล,4675,5203,9878,4689,5210,9899,5505
2567,40,ขอนแก่น,4099,ท้องถิ่นเทศบาลนครขอนแก่น,47041,51839,98880,47673,52244,99917,69560
2567,41,อุดรธานี,4101,อำเภอเมืองอุดรธานี,90353,95904,186257,90893,96008,186901,78300
2567,41,อุดรธานี,4102,อำเภอกุดจับ,21542,21613,43155,21646,21642,43288,13871
2567,41,อุดรธานี,4103,อำเภอหนองวัวซอ,22204,22318,44522,22276,22333,44609,12386
2567,41,อุดรธานี,4104,อำเภอกุมภวาปี,36000,36936,72936,36089,36963,73052,22764
2567,41,อุดรธานี,4105,อำเภอโนนสะอาด,22186,22458,44644,22230,22477,44707,12530
2567,41,อุดรธานี,4106,อำเภอหนองหาน,43801,44172,87973,43918,44211,88129,29081
2567,41,อุดรธานี,4107,อำเภอทุ่งฝน,12453,12373,24826,12500,12383,24883,7636
2567,41,อุดรธานี,4108,อำเภอไชยวาน,11918,11648,23566,11937,11652,23589,6573
2567,41,อุดรธานี,4109,อำเภอศรีธาตุ,11663,11765,23428,11671,11769,23440,6905
2567,41,อุดรธานี,4110,อำเภอวังสามหมอ,15502,15394,30896,15513,15405,30918,9183
2567,41,อุดรธานี,4111,อำเภอบ้านดุง,55088,55619,110707,55234,55660,110894,33997
2567,41,อุดรธานี,4117,อำเภอบ้านผือ,50575,50680,101255,50636,50711,101347,32736
2567,41,อุดรธานี,4118,อำเภอน้ำโสม,20629,20317,40946,20680,20347,41027,14033
2567,41,อุดรธานี,4119,อำเภอเพ็ญ,48034,48185,96219,48140,48216,96356,31107
2567,41,อุดรธานี,4120,อำเภอสร้างคอม,10916,10907,21823,10935,10916,21851,7010
2567,41,อุดรธานี,4121,อำเภอหนองแสง,11426,11456,22882,11471,11463,22934,7203
2567,41,อุดรธานี,4122,อำเภอนายูง,14329,14041,28370,14344,14049,28393,10205
2567,41,อุดรธานี,4123,อำเภอพิบูลย์รักษ์,12129,12435,24564,12155,12443,24598,8991
2567,41,อุดรธานี,4124,อำเภอกู่แก้ว,10943,10912,21855,10963,10929,21892,7293
2567,41,อุดรธานี,4125,อำเภอประจักษ์ศิลปาคม,12552,12625,25177,12596,12638,25234,7710
2567,41,อุดรธานี,4158,ท้องถิ่นเทศบาลตำบลหนองหว้า,4087,4114,8201,4097,4116,8213,2112
2567,41,อุดรธานี,4159,ท้องถิ่นเทศบาลตำบลหัวนาคำ,5662,5542,11204,5663,5546,11209,3311
2567,41,อุดรธานี,4160,ท้องถิ่นเทศบาลตำบลผาสุก,7882,7718,15600,7894,7724,15618,4926
2567,41,อุดรธานี,4161,ท้องถิ่นเทศบาลตำบลโพนสูง,3755,3721,7476,3757,3722,7479,2002
2567,41,อุดรธานี,4162,ท้องถิ่นเทศบาลตำบลจำปี,4071,4014,8085,4074,4018,8092,2235
2567,41,อุดรธานี,4163,ท้องถิ่นเทศบาลตำบลสร้างคอม,3503,3670,7173,3514,3673,7187,2842
2567,41,อุดรธานี,4164,ท้องถิ่นเทศบาลตำบลบ้านธาตุ,8165,8545,16710,8201,8566,16767,5405
2567,41,อุดรธานี,4165,ท้องถิ่นเทศบาลตำบลเวียงคำ,5149,5288,10437,5157,5290,10447,3361
2567,41,อุดรธานี,4166,ท้องถิ่นเทศบาลตำบลลำพันชาด,2794,2814,5608,2798,2814,5612,2173
2567,41,อุดรธานี,4167,ท้องถิ่นเทศบาลตำบลหนองไผ่,4586,4778,9364,4602,4785,9387,2879
2567,41,อุดรธานี,4168,ท้องถิ่นเทศบาลตำบลหนองไผ่,4013,4808,8821,4034,4812,8846,2909
2567,41,อุดรธานี,4169,ท้องถิ่นเทศบาลตำบลปะโค,5419,5581,11000,5431,5583,11014,3558
2567,41,อุดรธานี,4170,ท้องถิ่นเทศบาลตำบลแสงสว่าง,1961,1981,3942,1973,1981,3954,1007
2567,41,อุดรธานี,4171,ท้องถิ่นเทศบาลตำบลเพ็ญ,1290,1340,2630,1292,1340,2632,1674
2567,41,อุดรธานี,4172,ท้องถิ่นเทศบาลตำบลน้ำโสม,4195,4405,8600,4198,4406,8604,2673
2567,41,อุดรธานี,4173,ท้องถิ่นเทศบาลตำบลนางัว,4315,4406,8721,4338,4415,8753,3569
2567,41,อุดรธานี,4174,ท้องถิ่นเทศบาลตำบลบ้านผือ,3599,3892,7491,3615,3910,7525,4343
2567,41,อุดรธานี,4175,ท้องถิ่นเทศบาลเมืองบ้านดุง,7044,7654,14698,7114,7678,14792,6671
2567,41,อุดรธานี,4176,ท้องถิ่นเทศบาลตำบลวังสามหมอ,2812,2991,5803,2814,2993,5807,2958
2567,41,อุดรธานี,4177,ท้องถิ่นเทศบาลตำบลศรีธาตุ,2621,2711,5332,2624,2711,5335,1970
2567,41,อุดรธานี,4178,ท้องถิ่นเทศบาลตำบลไชยวาน,3905,4144,8049,3913,4146,8059,2575
2567,41,อุดรธานี,4179,ท้องถิ่นเทศบาลตำบลทุ่งฝน,3317,3624,6941,3332,3628,6960,2308
2567,41,อุดรธานี,4180,ท้องถิ่นเทศบาลตำบลหนองหาน,1875,2103,3978,1888,2108,3996,1926
2567,41,อุดรธานี,4181,ท้องถิ่นเทศบาลตำบลหนองเม็ก,3991,4016,8007,4010,4020,8030,2371
2567,41,อุดรธานี,4182,ท้องถิ่นเทศบาลตำบลบ้านเชียง,2756,2819,5575,2779,2823,5602,2047
2567,41,อุดรธานี,4183,ท้องถิ่นเทศบาลตำบลโนนสะอาด,2058,2196,4254,2065,2198,4263,1801
2567,41,อุดรธานี,4184,ท้องถิ่นเทศบาลตำบลห้วยเกิ้ง,2455,2578,5033,2468,2578,5046,1760
2567,41,อุดรธานี,4185,ท้องถิ่นเทศบาลตำบลพันดอน,2504,2773,5277,2517,2787,5304,2752
2567,41,อุดรธานี,4186,ท้องถิ่นเทศบาลตำบลกุมภวาปี,3667,4010,7677,3703,4026,7729,4609
2567,41,อุดรธานี,4187,ท้องถิ่นเทศบาลตำบลภูผาแดง,3685,3938,7623,3713,3942,7655,2421
2567,41,อุดรธานี,4188,ท้องถิ่นเทศบาลตำบลหนองวัวซอ,4540,4799,9339,4569,4803,9372,3045
2567,41,อุดรธานี,4189,ท้องถิ่นเทศบาลตำบลสร้างก่อ,1917,1944,3861,1918,1944,3862,1121
2567,41,อุดรธานี,4190,ท้องถิ่นเทศบาลตำบลตาลเลียน,1815,1840,3655,1819,1843,3662,917
2567,41,อุดรธานี,4191,ท้องถิ่นเทศบาลตำบลเชียงเพ็ง,1967,2013,3980,1968,2013,3981,1235
2567,41,อุดรธานี,4192,ท้องถิ่นเทศบาลตำบลกุดจับ,4766,5131,9897,4797,5135,9932,4132
2567,41,อุดรธานี,4193,ท้องถิ่นเทศบาลตำบลหนองบัว,15326,17581,32907,15766,17646,33412,17663
2567,41,อุดรธานี,4194,ท้องถิ่นเทศบาลเมืองหนองสำโรง,14345,15871,30216,14551,15928,30479,16400
2567,41,อุดรธานี,4195,ท้องถิ่นเทศบาลตำบลบ้านจั่น,3191,3892,7083,3245,3901,7146,3719
2567,41,อุดรธานี,4196,ท้องถิ่นเทศบาลเมืองโนนสูง-น้ำคำ,4494,3859,8353,4521,3866,8387,3678
2567,41,อุดรธานี,4197,ท้องถิ่นเทศบาลตำบลนิคมสงเคราะห์,1747,1893,3640,1762,1895,3657,1382
2567,41,อุดรธานี,4198,ท้องถิ่นเทศบาลตำบลนาข่า,3046,3268,6314,3055,3271,6326,2759
2567,41,อุดรธานี,4199,ท้องถิ่นเทศบาลนครอุดรธานี,51437,57757,109194,54099,59861,113960,63163
2567,42,เลย,4201,อำเภอเมืองเลย,29874,29264,59138,29973,29366,59339,25177
2567,42,เลย,4202,อำเภอนาด้วง,4906,4829,9735,4940,4864,9804,3846
2567,42,เลย,4203,อำเภอเชียงคาน,18550,18510,37060,18803,19059,37862,14890
2567,42,เลย,4204,อำเภอปากชม,16838,16256,33094,17023,16527,33550,11815
2567,42,เลย,4205,อำเภอด่านซ้าย,24259,23716,47975,24326,23797,48123,16959
2567,42,เลย,4206,อำเภอนาแห้ว,4822,4768,9590,4847,4802,9649,3255
2567,42,เลย,4207,อำเภอภูเรือ,9947,9548,19495,10028,9674,19702,7713
2567,42,เลย,4208,อำเภอท่าลี่,12425,12157,24582,12829,12861,25690,10443
2567,42,เลย,4209,อำเภอวังสะพุง,49177,49870,99047,49244,49928,99172,35939
2567,42,เลย,4210,อำเภอภูกระดึง,13618,13515,27133,13638,13526,27164,9273
2567,42,เลย,4211,อำเภอภูหลวง,12500,12273,24773,12513,12285,24798,8147
2567,42,เลย,4212,อำเภอผาขาว,15294,15273,30567,15313,15285,30598,8801
2567,42,เลย,4213,อำเภอเอราวัณ,16733,16861,33594,16771,16881,33652,11926
2567,42,เลย,4214,อำเภอหนองหิน,10328,10168,20496,10352,10192,20544,6434
2567,42,เลย,4279,ท้องถิ่นเทศบาลตำบลโนนปอแดง,5480,5484,10964,5495,5486,10981,3630
2567,42,เลย,4280,ท้องถิ่นเทศบาลตำบลนาดอกคำ,4949,4806,9755,4976,4841,9817,3041
2567,42,เลย,4281,ท้องถิ่นเทศบาลตำบลธาตุ,4699,4778,9477,4723,4830,9553,3557
2567,42,เลย,4282,ท้องถิ่นเทศบาลตำบลนาดินดำ,5335,5290,10625,5346,5312,10658,3846
2567,42,เลย,4283,ท้องถิ่นเทศบาลตำบลนาโป่ง,5103,5177,10280,5107,5185,10292,3679
2567,42,เลย,4284,ท้องถิ่นเทศบาลตำบลนาอาน,6467,6772,13239,6494,6787,13281,6516
2567,42,เลย,4285,ท้องถิ่นเทศบาลตำบลเขาแก้ว,3852,3822,7674,3859,3835,7694,2250
2567,42,เลย,4286,ท้องถิ่นเทศบาลตำบลหนองหิน,2093,2228,4321,2099,2229,4328,2163
2567,42,เลย,4287,ท้องถิ่นเทศบาลตำบลภูกระดึง,3409,3508,6917,3416,3508,6924,2834
2567,42,เลย,4288,ท้องถิ่นเทศบาลเมืองวังสะพุง,4927,5393,10320,4937,5401,10338,4736
2567,42,เลย,4289,ท้องถิ่นเทศบาลตำบลท่าลี่,822,892,1714,825,901,1726,836
2567,42,เลย,4290,ท้องถิ่นเทศบาลตำบลภูเรือ,1322,1368,2690,1337,1377,2714,1627
2567,42,เลย,4291,ท้องถิ่นเทศบาลตำบลนาแห้ว,1028,979,2007,1035,1002,2037,965
2567,42,เลย,4292,ท้องถิ่นเทศบาลตำบลด่านซ้าย,1567,1656,3223,1569,1657,3226,2048
2567,42,เลย,4293,ท้องถิ่นเทศบาลตำบลปากชม,1615,1682,3297,1637,1729,3366,1637
2567,42,เลย,4294,ท้องถิ่นเทศบาลตำบลเชียงกลม,2513,2559,5072,2525,2584,5109,1715
2567,42,เลย,4295,ท้องถิ่นเทศบาลตำบลเชียงคาน,2338,2530,4868,2360,2559,4919,2895
2567,42,เลย,4296,ท้องถิ่นเทศบาลตำบลนาด้วง,3177,3215,6392,3188,3228,6416,2461
2567,42,เลย,4297,ท้องถิ่นเทศบาลตำบลน้ำสวย,1743,1800,3543,1746,1804,3550,1274
2567,42,เลย,4298,ท้องถิ่นเทศบาลตำบลนาอ้อ,2930,3049,5979,2938,3054,5992,2416
2567,42,เลย,4299,ท้องถิ่นเทศบาลเมืองเลย,9612,9889,19501,9659,9960,19619,11638
2567,43,หนองคาย,4301,อำเภอเมืองหนองคาย,36810,37476,74286,37043,37750,74793,26094
2567,43,หนองคาย,4302,อำเภอท่าบ่อ,29870,30689,60559,29989,30856,60845,19666
2567,43,หนองคาย,4305,อำเภอโพนพิสัย,46905,47441,94346,47087,47704,94791,33367
2567,43,หนองคาย,4307,อำเภอศรีเชียงใหม่,11280,11620,22900,11402,11770,23172,7800
2567,43,หนองคาย,4308,อำเภอสังคม,11182,10947,22129,11212,10995,22207,7631
2567,43,หนองคาย,4314,อำเภอสระใคร,13272,13164,26436,13296,13192,26488,8997
2567,43,หนองคาย,4315,อำเภอเฝ้าไร่,19736,19790,39526,19768,19801,39569,11852
2567,43,หนองคาย,4316,อำเภอรัตนวาปี,18745,18735,37480,18767,18760,37527,13604
2567,43,หนองคาย,4317,อำเภอโพธิ์ตาก,7479,7520,14999,7503,7572,15075,5369
2567,43,หนองคาย,4378,ท้องถิ่นเทศบาลตำบลเฝ้าไร่,5429,5497,10926,5437,5500,10937,4222
2567,43,หนองคาย,4381,ท้องถิ่นเทศบาลตำบลโพธิ์ชัย,3932,4207,8139,3959,4229,8188,4106
2567,43,หนองคาย,4382,ท้องถิ่นเทศบาลตำบลหาดคำ,4569,4680,9249,4691,4883,9574,3177
2567,43,หนองคาย,4388,ท้องถิ่นเทศบาลตำบลสังคม,1577,1656,3233,1581,1661,3242,1531
2567,43,หนองคาย,4389,ท้องถิ่นเทศบาลตำบลศรีเชียงใหม่,2922,3068,5990,2961,3110,6071,2964
2567,43,หนองคาย,4391,ท้องถิ่นเทศบาลตำบลโพนพิสัย,1253,1234,2487,1260,1246,2506,1258
2567,43,หนองคาย,4395,ท้องถิ่นเทศบาลตำบลโพนสา,1693,1914,3607,1702,1933,3635,1178
2567,43,หนองคาย,4396,ท้องถิ่นเทศบาลเมืองท่าบ่อ,8075,8529,16604,8168,8626,16794,7626
2567,43,หนองคาย,4397,ท้องถิ่นเทศบาลตำบลหนองสองห้อง,2492,2561,5053,2531,2573,5104,2168
2567,43,หนองคาย,4398,ท้องถิ่นเทศบาลตำบลเวียงคุก,2725,2998,5723,2737,3011,5748,1960
2567,43,หนองคาย,4399,ท้องถิ่นเทศบาลเมืองหนองคาย,20834,22183,43017,22100,23340,45440,25455
2567,44,มหาสารคาม,4401,อำเภอเมืองมหาสารคาม,49727,52212,101939,49819,52236,102055,38380
2567,44,มหาสารคาม,4402,อำเภอแกดำ,12129,12099,24228,12138,12101,24239,6792
2567,44,มหาสารคาม,4403,อำเภอโกสุมพิสัย,53077,54903,107980,53150,54933,108083,32897
2567,44,มหาสารคาม,4404,อำเภอกันทรวิชัย,26753,27973,54726,26783,27982,54765,17194
2567,44,มหาสารคาม,4405,อำเภอเชียงยืน,26929,27991,54920,26966,28004,54970,18898
2567,44,มหาสารคาม,4406,อำเภอบรบือ,49926,50311,100237,49969,50334,100303,35471
2567,44,มหาสารคาม,4407,อำเภอนาเชือก,28092,28495,56587,28114,28508,56622,18164
2567,44,มหาสารคาม,4408,อำเภอพยัคฆภูมิพิสัย,38989,39618,78607,39005,39632,78637,23095
2567,44,มหาสารคาม,4409,อำเภอวาปีปทุม,52676,53592,106268,52713,53615,106328,31602
2567,44,มหาสารคาม,4410,อำเภอนาดูน,16023,16256,32279,16036,16271,32307,8999
2567,44,มหาสารคาม,4411,อำเภอยางสีสุราช,17106,17291,34397,17114,17301,34415,10234
2567,44,มหาสารคาม,4412,อำเภอกุดรัง,18411,18283,36694,18434,18291,36725,11062
2567,44,มหาสารคาม,4413,อำเภอชื่นชม,11892,12383,24275,11903,12394,24297,7263
2567,44,มหาสารคาม,4487,ท้องถิ่นเทศบาลตำบลขามเรียง,5163,6468,11631,5185,6473,11658,6032
2567,44,มหาสารคาม,4488,ท้องถิ่นเทศบาลตำบลท่าขอนยาง,4266,4590,8856,4277,4595,8872,6995
2567,44,มหาสารคาม,4489,ท้องถิ่นเทศบาลตำบลนาดูน,2355,2317,4672,2358,2319,4677,1932
2567,44,มหาสารคาม,4490,ท้องถิ่นเทศบาลตำบลวาปีปทุม,2135,2370,4505,2142,2375,4517,2474
2567,44,มหาสารคาม,4491,ท้องถิ่นเทศบาลตำบลพยัคฆภูมิพิสัย,3733,4180,7913,3748,4187,7935,4471
2567,44,มหาสารคาม,4492,ท้องถิ่นเทศบาลตำบลนาเชือก,1768,1893,3661,1771,1893,3664,2210
2567,44,มหาสารคาม,4493,ท้องถิ่นเทศบาลตำบลบรบือ,2381,2888,5269,2389,2890,5279,2431
2567,44,มหาสารคาม,4494,ท้องถิ่นเทศบาลตำบลเชียงยืน,2147,2327,4474,2152,2329,4481,2483
2567,44,มหาสารคาม,4495,ท้องถิ่นเทศบาลตำบลกันทรวิชัย,1518,1752,3270,1525,1753,3278,1551
2567,44,มหาสารคาม,4496,ท้องถิ่นเทศบาลตำบลโกสุมพิสัย,4191,4620,8811,4210,4624,8834,4491
2567,44,มหาสารคาม,4497,ท้องถิ่นเทศบาลตำบลแกดำ,2619,2621,5240,2621,2621,5242,1751
2567,44,มหาสารคาม,4498,ท้องถิ่นเทศบาลตำบลแวงน่าง,2730,2917,5647,2738,2917,5655,2350
2567,44,มหาสารคาม,4499,ท้องถิ่นเทศบาลเมืองมหาสารคาม,18904,23066,41970,18986,23128,42114,22144
2567,45,ร้อยเอ็ด,4501,อำเภอเมืองร้อยเอ็ด,53719,56647,110366,53908,56696,110604,44294
2567,45,ร้อยเอ็ด,4502,อำเภอเกษตรวิสัย,36243,36350,72593,36269,36362,72631,21979
2567,45,ร้อยเอ็ด,4503,อำเภอปทุมรัตต์,23083,23637,46720,23097,23642,46739,13458
2567,45,ร้อยเอ็ด,4504,อำเภอจตุรพักตรพิมาน,24843,25289,50132,24867,25302,50169,14400
2567,45,ร้อยเอ็ด,4505,อำเภอธวัชบุรี,18425,18487,36912,18446,18495,36941,11878
2567,45,ร้อยเอ็ด,4506,อำเภอพนมไพร,29210,29537,58747,29234,29554,58788,18626
2567,45,ร้อยเอ็ด,4507,อำเภอโพนทอง,47538,48185,95723,47594,48209,95803,30249
2567,45,ร้อยเอ็ด,4508,อำเภอโพธิ์ชัย,13312,13551,26863,13319,13555,26874,8007
2567,45,ร้อยเอ็ด,4509,อำเภอหนองพอก,29749,29688,59437,29781,29705,59486,17321
2567,45,ร้อยเอ็ด,4510,อำเภอเสลภูมิ,43876,44765,88641,43910,44789,88699,26076
2567,45,ร้อยเอ็ด,4511,อำเภอสุวรรณภูมิ,51272,52233,103505,51319,52259,103578,31239
2567,45,ร้อยเอ็ด,4512,อำเภอเมืองสรวง,6675,6748,13423,6686,6755,13441,3927
2567,45,ร้อยเอ็ด,4513,อำเภอโพนทราย,10929,11032,21961,10938,11037,21975,5374
2567,45,ร้อยเอ็ด,4514,อำเภออาจสามารถ,34120,34383,68503,34157,34400,68557,19783
2567,45,ร้อยเอ็ด,4515,อำเภอเมยวดี,11249,11542,22791,11254,11550,22804,7235
2567,45,ร้อยเอ็ด,4516,อำเภอศรีสมเด็จ,18085,17241,35326,18110,17255,35365,11609
2567,45,ร้อยเอ็ด,4517,อำเภอจังหาร,18622,19422,38044,18647,19432,38079,12698
2567,45,ร้อยเอ็ด,4518,อำเภอเชียงขวัญ,13111,13669,26780,13133,13678,26811,8624
2567,45,ร้อยเอ็ด,4519,อำเภอหนองฮี,11814,11973,23787,11825,11983,23808,6788
2567,45,ร้อยเอ็ด,4520,อำเภอทุ่งเขาหลวง,11235,11532,22767,11253,11537,22790,6745
2567,45,ร้อยเอ็ด,4565,ท้องถิ่นเทศบาลตำบลนิเวศน์,3373,3439,6812,3384,3443,6827,3349
2567,45,ร้อยเอ็ด,4566,ท้องถิ่นเทศบาลตำบลมะอึ,2568,2739,5307,2578,2740,5318,2223
2567,45,ร้อยเอ็ด,4569,ท้องถิ่นเทศบาลตำบลโพธิ์ชัย,3224,3268,6492,3225,3270,6495,1815
2567,45,ร้อยเอ็ด,4570,ท้องถิ่นเทศบาลตำบลดินดำ,3262,3412,6674,3266,3414,6680,2073
2567,45,ร้อยเอ็ด,4571,ท้องถิ่นเทศบาลตำบลเมืองไพร,3130,3030,6160,3134,3031,6165,1659
2567,45,ร้อยเอ็ด,4572,ท้องถิ่นเทศบาลตำบลขวาว,4219,4460,8679,4222,4463,8685,2269
2567,45,ร้อยเอ็ด,4573,ท้องถิ่นเทศบาลตำบลดงแดง,4206,4414,8620,4208,4419,8627,2515
2567,45,ร้อยเอ็ด,4574,ท้องถิ่นเทศบาลตำบลโคกล่าม,3563,3677,7240,3566,3682,7248,2178
2567,45,ร้อยเอ็ด,4575,ท้องถิ่นเทศบาลตำบลหัวช้าง,3927,4178,8105,3935,4182,8117,2842
2567,45,ร้อยเอ็ด,4576,ท้องถิ่นเทศบาลตำบลอุ่มเม้า,3520,3660,7180,3528,3664,7192,2124
2567,45,ร้อยเอ็ด,4577,ท้องถิ่นเทศบาลตำบลปอภาร,3418,3756,7174,3426,3758,7184,2547
2567,45,ร้อยเอ็ด,4578,ท้องถิ่นเทศบาลตำบลเมืองบัว,4037,4221,8258,4048,4225,8273,2917
2567,45,ร้อยเอ็ด,4579,ท้องถิ่นเทศบาลตำบลคำพอุง,4610,4520,9130,4625,4521,9146,2770
2567,45,ร้อยเอ็ด,4580,ท้องถิ่นเทศบาลตำบลอัคคะคำ,4065,4075,8140,4067,4076,8143,2209
2567,45,ร้อยเอ็ด,4581,ท้องถิ่นเทศบาลตำบลโนนตาล,2632,2659,5291,2633,2660,5293,1553
2567,45,ร้อยเอ็ด,4583,ท้องถิ่นเทศบาลตำบลอาจสามารถ,1891,2017,3908,1893,2020,3913,1868
2567,45,ร้อยเอ็ด,4584,ท้องถิ่นเทศบาลตำบลโพนทราย,2725,2818,5543,2727,2819,5546,2159
2567,45,ร้อยเอ็ด,4585,ท้องถิ่นเทศบาลตำบลเมืองสรวง,4618,4786,9404,4633,4787,9420,3049
2567,45,ร้อยเอ็ด,4586,ท้องถิ่นเทศบาลตำบลสุวรรณภูมิ,4086,4600,8686,4091,4605,8696,4399
2567,45,ร้อยเอ็ด,4587,ท้องถิ่นเทศบาลตำบลเสลภูมิ,6097,6560,12657,6113,6569,12682,5289
2567,45,ร้อยเอ็ด,4588,ท้องถิ่นเทศบาลตำบลหนองพอก,3053,3221,6274,3064,3221,6285,2841
2567,45,ร้อยเอ็ด,4589,ท้องถิ่นเทศบาลตำบลเชียงใหม่,3977,4139,8116,3980,4141,8121,2587
2567,45,ร้อยเอ็ด,4590,ท้องถิ่นเทศบาลตำบลชัยวารี,2536,2640,5176,2541,2640,5181,1634
2567,45,ร้อยเอ็ด,4591,ท้องถิ่นเทศบาลตำบลโพนทอง,5406,5682,11088,5427,5688,11115,5430
2567,45,ร้อยเอ็ด,4592,ท้องถิ่นเทศบาลตำบลพนมไพร,1900,2052,3952,1905,2055,3960,1851
2567,45,ร้อยเอ็ด,4593,ท้องถิ่นเทศบาลตำบลบ้านนิเวศน์,1162,1310,2472,1164,1310,2474,1215
2567,45,ร้อยเอ็ด,4594,ท้องถิ่นเทศบาลตำบลธงธานี,3634,3914,7548,3652,3916,7568,2652
2567,45,ร้อยเอ็ด,4595,ท้องถิ่นเทศบาลตำบลจตุรพักตรพิมาน,1745,1968,3713,1752,1973,3725,1654
2567,45,ร้อยเอ็ด,4596,ท้องถิ่นเทศบาลตำบลปทุมรัตต์,3032,3219,6251,3040,3221,6261,2230
2567,45,ร้อยเอ็ด,4597,ท้องถิ่นเทศบาลตำบลเกษตรวิสัย,5036,5474,10510,5039,5481,10520,5011
2567,45,ร้อยเอ็ด,4598,ท้องถิ่นเทศบาลตำบลกู่กาสิงห์,2173,2288,4461,2174,2289,4463,1666
2567,45,ร้อยเอ็ด,4599,ท้องถิ่นเทศบาลเมืองร้อยเอ็ด,14925,17161,32086,15038,17216,32254,16977
2567,46,กาฬสินธุ์,4601,อำเภอเมืองกาฬสินธุ์,39422,41010,80432,39537,41042,80579,27572
2567,46,กาฬสินธุ์,4602,อำเภอนามน,14467,14765,29232,14490,14768,29258,9963
2567,46,กาฬสินธุ์,4603,อำเภอกมลาไสย,21805,22893,44698,21825,22899,44724,12994
2567,46,กาฬสินธุ์,4604,อำเภอร่องคำ,5084,5258,10342,5089,5258,10347,3432
2567,46,กาฬสินธุ์,4605,อำเภอกุฉินารายณ์,30555,30596,61151,30590,30623,61213,22454
2567,46,กาฬสินธุ์,4606,อำเภอเขาวง,10254,10481,20735,10265,10490,20755,9138
2567,46,กาฬสินธุ์,4607,อำเภอยางตลาด,39345,41071,80416,39400,41087,80487,25343
2567,46,กาฬสินธุ์,4608,อำเภอห้วยเม็ก,19926,19839,39765,19955,19845,39800,12831
2567,46,กาฬสินธุ์,4609,อำเภอสหัสขันธ์,18473,18573,37046,18506,18584,37090,11850
2567,46,กาฬสินธุ์,4610,อำเภอคำม่วง,13278,13313,26591,13287,13314,26601,7737
2567,46,กาฬสินธุ์,4611,อำเภอท่าคันโท,14160,14306,28466,14181,14311,28492,8493
2567,46,กาฬสินธุ์,4612,อำเภอหนองกุงศรี,25363,25508,50871,25391,25520,50911,16104
2567,46,กาฬสินธุ์,4613,อำเภอสมเด็จ,26936,27614,54550,26992,27629,54621,19156
2567,46,กาฬสินธุ์,4614,อำเภอห้วยผึ้ง,6838,7046,13884,6853,7048,13901,4189
2567,46,กาฬสินธุ์,4615,อำเภอสามชัย,12701,12378,25079,12711,12387,25098,8084
2567,46,กาฬสินธุ์,4616,อำเภอนาคู,12641,12617,25258,12647,12621,25268,8694
2567,46,กาฬสินธุ์,4617,อำเภอดอนจาน,12813,13046,25859,12832,13054,25886,8587
2567,46,กาฬสินธุ์,4618,อำเภอฆ้องชัย,12951,13264,26215,12962,13270,26232,7936
2567,46,กาฬสินธุ์,4651,สาขาตำบลคำใหญ่ อำเภอห้วยเม็ก,0,0,0,0,0,0,0
2567,46,กาฬสินธุ์,4665,ท้องถิ่นเทศบาลตำบลจุมจัง,4714,4747,9461,4715,4747,9462,2628
2567,46,กาฬสินธุ์,4666,ท้องถิ่นเทศบาลตำบลนาทัน,7138,6991,14129,7138,6992,14130,3851
2567,46,กาฬสินธุ์,4667,ท้องถิ่นเทศบาลตำบลอิตื้อ,4160,4370,8530,4162,4374,8536,2606
2567,46,กาฬสินธุ์,4668,ท้องถิ่นเทศบาลตำบลภูสิงห์,0,0,0,0,0,0,0
2567,46,กาฬสินธุ์,4669,ท้องถิ่นเทศบาลตำบลหัวนาคำ,5962,6269,12231,5966,6272,12238,3899
2567,46,กาฬสินธุ์,4670,ท้องถิ่นเทศบาลตำบลบัวบาน,6172,6541,12713,6182,6546,12728,4621
2567,46,กาฬสินธุ์,4671,ท้องถิ่นเทศบาลตำบลนาขาม,6411,6521,12932,6413,6523,12936,3554
2567,46,กาฬสินธุ์,4672,ท้องถิ่นเทศบาลตำบลลำคลอง,2037,2189,4226,2040,2190,4230,1388
2567,46,กาฬสินธุ์,4673,ท้องถิ่นเทศบาลตำบลคำบง,5147,5128,10275,5151,5132,10283,3131
2567,46,กาฬสินธุ์,4674,ท้องถิ่นเทศบาลตำบลสระพังทอง,1347,1358,2705,1350,1359,2709,1043
2567,46,กาฬสินธุ์,4675,ท้องถิ่นเทศบาลตำบลห้วยโพธิ์,5711,5892,11603,5730,5895,11625,3554
2567,46,กาฬสินธุ์,4676,ท้องถิ่นเทศบาลตำบลนาคู,2426,2672,5098,2430,2675,5105,1995
2567,46,กาฬสินธุ์,4677,ท้องถิ่นเทศบาลตำบลห้วยผึ้ง,2710,2859,5569,2716,2862,5578,2352
2567,46,กาฬสินธุ์,4678,ท้องถิ่นเทศบาลตำบลสมเด็จ,3128,3387,6515,3138,3393,6531,3490
2567,46,กาฬสินธุ์,4679,ท้องถิ่นเทศบาลตำบลหนองหิน,2604,2665,5269,2607,2666,5273,1697
2567,46,กาฬสินธุ์,4680,ท้องถิ่นเทศบาลตำบลหนองกุงศรี,4278,4446,8724,4288,4449,8737,3586
2567,46,กาฬสินธุ์,4681,ท้องถิ่นเทศบาลตำบลท่าคันโท,4408,4583,8991,4414,4586,9000,3096
2567,46,กาฬสินธุ์,4682,ท้องถิ่นเทศบาลตำบลโพน,1847,1875,3722,1847,1875,3722,1145
2567,46,กาฬสินธุ์,4683,ท้องถิ่นเทศบาลตำบลคำม่วง,1911,1961,3872,1915,1962,3877,1798
2567,46,กาฬสินธุ์,4684,ท้องถิ่นเทศบาลตำบลโนนบุรี,2391,2652,5043,2401,2652,5053,2130
2567,46,กาฬสินธุ์,4685,ท้องถิ่นเทศบาลตำบลห้วยเม็ก,2704,2850,5554,2711,2852,5563,2352
2567,46,กาฬสินธุ์,4686,ท้องถิ่นเทศบาลตำบลคำใหญ่,2422,2489,4911,2426,2491,4917,1695
2567,46,กาฬสินธุ์,4687,ท้องถิ่นเทศบาลตำบลยางตลาด,3789,4305,8094,3800,4311,8111,3962
2567,46,กาฬสินธุ์,4688,ท้องถิ่นเทศบาลตำบลโคกศรี,1507,1623,3130,1509,1624,3133,1341
2567,46,กาฬสินธุ์,4689,ท้องถิ่นเทศบาลตำบลกุดสิม,4753,4990,9743,4768,4998,9766,4661
2567,46,กาฬสินธุ์,4690,ท้องถิ่นเทศบาลเมืองกุฉินารายณ์,5397,5657,11054,5407,5662,11069,5147
2567,46,กาฬสินธุ์,4691,ท้องถิ่นเทศบาลตำบลกุดหว้า,2453,2685,5138,2457,2686,5143,2132
2567,46,กาฬสินธุ์,4692,ท้องถิ่นเทศบาลตำบลร่องคำ,2891,3057,5948,2893,3059,5952,2340
2567,46,กาฬสินธุ์,4693,ท้องถิ่นเทศบาลตำบลหนองแปน,3205,3518,6723,3212,3518,6730,2294
2567,46,กาฬสินธุ์,4694,ท้องถิ่นเทศบาลตำบลธัญญา,3051,3152,6203,3059,3155,6214,1767
2567,46,กาฬสินธุ์,4695,ท้องถิ่นเทศบาลตำบลกมลาไสย,4475,5046,9521,4496,5049,9545,3826
2567,46,กาฬสินธุ์,4696,ท้องถิ่นเทศบาลตำบลนามน,3364,3413,6777,3366,3414,6780,2473
2567,46,กาฬสินธุ์,4697,ท้องถิ่นเทศบาลตำบลหนองสอ,3449,3754,7203,3459,3756,7215,2412
2567,46,กาฬสินธุ์,4698,ท้องถิ่นเทศบาลตำบลนาจารย์,4154,4164,8318,4160,4170,8330,2626
2567,46,กาฬสินธุ์,4699,ท้องถิ่นเทศบาลเมืองกาฬสินธุ์,14615,16239,30854,14694,16266,30960,16742
2567,47,สกลนคร,4701,อำเภอเมืองสกลนคร,56524,58318,114842,56605,58341,114946,45179
2567,47,สกลนคร,4702,อำเภอกุสุมาลย์,21692,21895,43587,21714,21904,43618,14689
2567,47,สกลนคร,4703,อำเภอกุดบาก,13810,13574,27384,13816,13576,27392,9629
2567,47,สกลนคร,4704,อำเภอพรรณานิคม,38163,38845,77008,38210,38876,77086,28270
2567,47,สกลนคร,4705,อำเภอพังโคน,22419,23140,45559,22483,23170,45653,18386
2567,47,สกลนคร,4706,อำเภอวาริชภูมิ,17513,18091,35604,17538,18103,35641,12935
2567,47,สกลนคร,4707,อำเภอนิคมน้ำอูน,7358,7361,14719,7361,7365,14726,4786
2567,47,สกลนคร,4708,อำเภอวานรนิวาส,59748,60461,120209,59827,60504,120331,36508
2567,47,สกลนคร,4709,อำเภอคำตากล้า,16238,16475,32713,16255,16485,32740,12145
2567,47,สกลนคร,4710,อำเภอบ้านม่วง,33606,33204,66810,33664,33223,66887,21145
2567,47,สกลนคร,4711,อำเภออากาศอำนวย,26993,26827,53820,27010,26846,53856,20277
2567,47,สกลนคร,4712,อำเภอสว่างแดนดิน,62845,63910,126755,62920,63953,126873,39010
2567,47,สกลนคร,4713,อำเภอส่องดาว,14965,14569,29534,14980,14580,29560,7993
2567,47,สกลนคร,4714,อำเภอเต่างอย,12035,11992,24027,12045,11997,24042,9216
2567,47,สกลนคร,4715,อำเภอโคกศรีสุพรรณ,10721,10877,21598,10730,10882,21612,7997
2567,47,สกลนคร,4716,อำเภอเจริญศิลป์,19154,19029,38183,19173,19036,38209,11178
2567,47,สกลนคร,4717,อำเภอโพนนาแก้ว,18395,18388,36783,18407,18398,36805,12397
2567,47,สกลนคร,4718,อำเภอภูพาน,17987,17698,35685,18012,17707,35719,11003
2567,47,สกลนคร,4751,สาขาตำบลกุดเรือคำ อำเภอวานรนิวาส,0,0,0,0,0,0,0
2567,47,สกลนคร,4779,ท้องถิ่นเทศบาลตำบลคำบ่อ,6714,6911,13625,6720,6914,13634,4320
2567,47,สกลนคร,4780,ท้องถิ่นเทศบาลตำบลตองโขบ,6214,6417,12631,6224,6419,12643,6006
2567,47,สกลนคร,4781,ท้องถิ่นเทศบาลตำบลบงใต้,5086,5030,10116,5090,5031,10121,3151
2567,47,สกลนคร,4782,ท้องถิ่นเทศบาลตำบลสามัคคีพัฒนา,4455,4512,8967,4457,4512,8969,2531
2567,47,สกลนคร,4783,ท้องถิ่นเทศบาลตำบลเชียงเครือ,7888,8154,16042,7893,8157,16050,6418
2567,47,สกลนคร,4784,ท้องถิ่นเทศบาลตำบลเจริญศิลป์,3275,3432,6707,3275,3433,6708,2427
2567,47,สกลนคร,4785,ท้องถิ่นเทศบาลตำบลส่องดาว,2429,2442,4871,2431,2443,4874,1702
2567,47,สกลนคร,4786,ท้องถิ่นเทศบาลตำบลสว่างแดนดิน,3807,4158,7965,3819,4177,7996,5077
2567,47,สกลนคร,4787,ท้องถิ่นเทศบาลตำบลดอนเขือง,2005,2073,4078,2006,2074,4080,1339
2567,47,สกลนคร,4788,ท้องถิ่นเทศบาลตำบลอากาศอำนวย,4257,4485,8742,4260,4488,8748,3147
2567,47,สกลนคร,4789,ท้องถิ่นเทศบาลตำบลบ้านม่วง,1666,1812,3478,1671,1815,3486,1573
2567,47,สกลนคร,4790,ท้องถิ่นเทศบาลตำบลคำตากล้า,3450,3568,7018,3459,3572,7031,2406
2567,47,สกลนคร,4791,ท้องถิ่นเทศบาลตำบลวานรนิวาส,2607,2885,5492,2611,2887,5498,2421
2567,47,สกลนคร,4792,ท้องถิ่นเทศบาลตำบลวาริชภูมิ,1285,1338,2623,1286,1339,2625,1416
2567,47,สกลนคร,4793,ท้องถิ่นเทศบาลตำบลพังโคน,3062,3232,6294,3087,3240,6327,4187
2567,47,สกลนคร,4794,ท้องถิ่นเทศบาลตำบลพรรณานิคม,1114,1249,2363,1117,1256,2373,1499
2567,47,สกลนคร,4795,ท้องถิ่นเทศบาลตำบลกุดบาก,2463,2587,5050,2465,2589,5054,1995
2567,47,สกลนคร,4796,ท้องถิ่นเทศบาลตำบลกุสุมาลย์,1913,2061,3974,1921,2062,3983,1791
2567,47,สกลนคร,4797,ท้องถิ่นเทศบาลตำบลท่าแร่,3029,3317,6346,3039,3321,6360,2368
2567,47,สกลนคร,4798,ท้องถิ่นเทศบาลตำบลดงมะไฟ,2711,3047,5758,2714,3050,5764,2344
2567,47,สกลนคร,4799,ท้องถิ่นเทศบาลนครสกลนคร,23774,25732,49506,23910,25842,49752,30255
2567,48,นครพนม,4801,อำเภอเมืองนครพนม,58080,57903,115983,58238,58085,116323,38292
2567,48,นครพนม,4802,อำเภอปลาปาก,25287,24953,50240,25314,24974,50288,16998
2567,48,นครพนม,4803,อำเภอท่าอุเทน,27299,26977,54276,27372,27076,54448,16593
2567,48,นครพนม,4804,อำเภอบ้านแพง,13226,13094,26320,13259,13154,26413,8719
2567,48,นครพนม,4805,อำเภอธาตุพนม,35163,35772,70935,35289,35882,71171,23042
2567,48,นครพนม,4806,อำเภอเรณูนคร,20489,20525,41014,20526,20541,41067,13624
2567,48,นครพนม,4807,อำเภอนาแก,35554,36101,71655,35610,36127,71737,22679
2567,48,นครพนม,4808,อำเภอศรีสงคราม,31864,32253,64117,31907,32302,64209,20234
2567,48,นครพนม,4809,อำเภอนาหว้า,19823,19799,39622,19847,19810,39657,14034
2567,48,นครพนม,4810,อำเภอโพนสวรรค์,26233,26332,52565,26255,26346,52601,17720
2567,48,นครพนม,4811,อำเภอนาทม,11791,11785,23576,11815,11793,23608,7983
2567,48,นครพนม,4812,อำเภอวังยาง,7924,7731,15655,7932,7732,15664,5021
2567,48,นครพนม,4890,ท้องถิ่นเทศบาลตำบลปลาปาก,1869,1998,3867,1871,2000,3871,1674
2567,48,นครพนม,4891,ท้องถิ่นเทศบาลตำบลโพนสวรรค์,2626,2673,5299,2631,2674,5305,1945
2567,48,นครพนม,4892,ท้องถิ่นเทศบาลตำบลนาหว้า,5890,6096,11986,5915,6101,12016,4452
2567,48,นครพนม,4893,ท้องถิ่นเทศบาลตำบลศรีสงคราม,2395,2502,4897,2403,2513,4916,2713
2567,48,นครพนม,4894,ท้องถิ่นเทศบาลตำบลนาแก,1954,2195,4149,1959,2195,4154,2396
2567,48,นครพนม,4895,ท้องถิ่นเทศบาลตำบลเรณูนคร,2023,2272,4295,2031,2280,4311,1753
2567,48,นครพนม,4896,ท้องถิ่นเทศบาลตำบลธาตุพนม,4660,4951,9611,4675,4961,9636,4236
2567,48,นครพนม,4897,ท้องถิ่นเทศบาลตำบลบ้านแพง,4209,4329,8538,4232,4379,8611,3866
2567,48,นครพนม,4898,ท้องถิ่นเทศบาลตำบลท่าอุเทน,2257,2362,4619,2278,2409,4687,2057
2567,48,นครพนม,4899,ท้องถิ่นเทศบาลเมืองนครพนม,12025,13709,25734,12172,13875,26047,16152
2567,49,มุกดาหาร,4901,อำเภอเมืองมุกดาหาร,40152,39646,79798,40311,39830,80141,28489
2567,49,มุกดาหาร,4902,อำเภอนิคมคำสร้อย,16892,17026,33918,16930,17041,33971,10666
2567,49,มุกดาหาร,4903,อำเภอดอนตาล,19398,19133,38531,19484,19276,38760,12387
2567,49,มุกดาหาร,4904,อำเภอดงหลวง,19711,19350,39061,19725,19361,39086,12797
2567,49,มุกดาหาร,4905,อำเภอคำชะอี,21890,21970,43860,21920,21985,43905,15234
2567,49,มุกดาหาร,4906,อำเภอหว้านใหญ่,9977,9928,19905,10068,10146,20214,6806
2567,49,มุกดาหาร,4907,อำเภอหนองสูง,10207,10284,20491,10214,10290,20504,7795
2567,49,มุกดาหาร,4989,ท้องถิ่นเทศบาลตำบลร่มเกล้า,1696,1621,3317,1699,1622,3321,1114
2567,49,มุกดาหาร,4993,ท้องถิ่นเทศบาลตำบลบ้านแก้ง,1500,1514,3014,1530,1553,3083,1041
2567,49,มุกดาหาร,4994,ท้องถิ่นเทศบาลตำบลคำอาฮวน,6525,6439,12964,6547,6449,12996,5108
2567,49,มุกดาหาร,4995,ท้องถิ่นเทศบาลตำบลดงเย็น,5480,5261,10741,5488,5273,10761,3202
2567,49,มุกดาหาร,4996,ท้องถิ่นเทศบาลตำบลคำชะอี,1129,1143,2272,1131,1146,2277,1156
2567,49,มุกดาหาร,4997,ท้องถิ่นเทศบาลตำบลดอนตาล,1104,1269,2373,1128,1295,2423,1003
2567,49,มุกดาหาร,4998,ท้องถิ่นเทศบาลตำบลนิคมคำสร้อย,2937,3123,6060,2948,3125,6073,2465
2567,49,มุกดาหาร,4999,ท้องถิ่นเทศบาลเมืองมุกดาหาร,14763,16020,30783,15854,17141,32995,17063
2567,50,เชียงใหม่,5001,อำเภอเมืองเชียงใหม่,6837,7834,14671,7069,8007,15076,12110
2567,50,เชียงใหม่,5002,อำเภอจอมทอง,27449,28732,56181,27631,28893,56524,21254
2567,50,เชียงใหม่,5003,อำเภอแม่แจ่ม,29050,28224,57274,29447,28544,57991,19448
2567,50,เชียงใหม่,5004,อำเภอเชียงดาว,10870,11478,22348,13835,14392,28227,12238
2567,50,เชียงใหม่,5005,อำเภอดอยสะเก็ด,22243,25038,47281,22787,25424,48211,25360
2567,50,เชียงใหม่,5006,อำเภอแม่แตง,24685,25365,50050,29530,30077,59607,25979
2567,50,เชียงใหม่,5007,อำเภอแม่ริม,37735,40434,78169,41106,43422,84528,40928
2567,50,เชียงใหม่,5008,อำเภอสะเมิง,9109,8819,17928,9263,8966,18229,6406
2567,50,เชียงใหม่,5009,อำเภอฝาง,40328,42172,82500,55758,56854,112612,43035
2567,50,เชียงใหม่,5010,อำเภอแม่อาย,28268,28802,57070,34192,34339,68531,27309
2567,50,เชียงใหม่,5011,อำเภอพร้าว,17457,18020,35477,17755,18316,36071,16185
2567,50,เชียงใหม่,5012,อำเภอสันป่าตอง,27027,30949,57976,27246,31155,58401,26903
2567,50,เชียงใหม่,5013,อำเภอสันกำแพง,20383,23399,43782,20708,23586,44294,24814
2567,50,เชียงใหม่,5014,อำเภอสันทราย,9788,11122,20910,10571,11916,22487,11713
2567,50,เชียงใหม่,5015,อำเภอหางดง,36127,41993,78120,37284,42668,79952,48482
2567,50,เชียงใหม่,5016,อำเภอฮอด,12280,12583,24863,12330,12633,24963,9985
2567,50,เชียงใหม่,5017,อำเภอดอยเต่า,11078,11268,22346,11095,11293,22388,8998
2567,50,เชียงใหม่,5018,อำเภออมก๋อย,31248,30839,62087,31381,30976,62357,24185
2567,50,เชียงใหม่,5019,อำเภอสารภี,22805,26522,49327,23372,27021,50393,26501
2567,50,เชียงใหม่,5020,อำเภอเวียงแหง,10282,9714,19996,27433,26776,54209,10301
2567,50,เชียงใหม่,5021,อำเภอไชยปราการ,11907,11908,23815,17706,17770,35476,12323
2567,50,เชียงใหม่,5022,อำเภอแม่วาง,13361,13597,26958,13613,13833,27446,10423
2567,50,เชียงใหม่,5023,อำเภอแม่ออน,10032,10367,20399,10211,10519,20730,10094
2567,50,เชียงใหม่,5024,อำเภอดอยหล่อ,11482,12386,23868,11752,12633,24385,12068
2567,50,เชียงใหม่,5025,อำเภอกัลยาณิวัฒนา,6689,6370,13059,6709,6384,13093,4736
2567,50,เชียงใหม่,5040,ท้องถิ่นเทศบาลตำบลบวกค้าง,4083,4582,8665,4144,4631,8775,4322
2567,50,เชียงใหม่,5041,ท้องถิ่นเทศบาลตำบลบ่อหลวง,5911,5950,11861,5939,5977,11916,3997
2567,50,เชียงใหม่,5042,ท้องถิ่นเทศบาลตำบลป่าไผ่,7268,8212,15480,7491,8447,15938,7348
2567,50,เชียงใหม่,5043,ท้องถิ่นเทศบาลตำบลสันนาเม็ง,6077,7387,13464,6367,7601,13968,8993
2567,50,เชียงใหม่,5044,ท้องถิ่นเทศบาลตำบลสันพระเนตร,2828,3409,6237,2895,3462,6357,3683
2567,50,เชียงใหม่,5046,ท้องถิ่นเทศบาลตำบลสันปูเลย,8389,9939,18328,8623,10088,18711,10814
2567,50,เชียงใหม่,5049,ท้องถิ่นเทศบาลตำบลเชิงดอย,3721,4096,7817,3856,4201,8057,4053
2567,50,เชียงใหม่,5050,ท้องถิ่นเทศบาลตำบลเมืองนะ,11966,11747,23713,18888,19505,38393,10171
2567,50,เชียงใหม่,5054,ท้องถิ่นเทศบาลตำบลทุ่งข้าวพวง,3334,3288,6622,5607,5498,11105,3195
2567,50,เชียงใหม่,5055,ท้องถิ่นเทศบาลตำบลปิงโค้ง,6587,5696,12283,7631,6708,14339,4775
2567,50,เชียงใหม่,5056,ท้องถิ่นเทศบาลตำบลพระธาตุปู่ก่ำ,981,1040,2021,1148,1213,2361,1213
2567,50,เชียงใหม่,5057,ท้องถิ่นเทศบาลเมืองแม่เหียะ,8651,10868,19519,8924,11043,19967,14290
2567,50,เชียงใหม่,5058,ท้องถิ่นเทศบาลตำบลสารภี,2851,3343,6194,3036,3518,6554,2911
2567,50,เชียงใหม่,5059,ท้องถิ่นเทศบาลตำบลฟ้าฮ่าม,3151,3815,6966,3269,3909,7178,9881
2567,50,เชียงใหม่,5060,ท้องถิ่นเทศบาลตำบลหนองจ๊อม,7641,9372,17013,7980,9626,17606,9887
2567,50,เชียงใหม่,5061,ท้องถิ่นเทศบาลตำบลหนองหอย,3475,4320,7795,3578,4385,7963,5764
2567,50,เชียงใหม่,5062,ท้องถิ่นเทศบาลตำบลแม่แฝก,4106,4758,8864,4164,4819,8983,4104
2567,50,เชียงใหม่,5063,ท้องถิ่นเทศบาลตำบลท่าศาลา,3208,3849,7057,3361,3936,7297,5723
2567,50,เชียงใหม่,5064,ท้องถิ่นเทศบาลตำบลหนองผึ้ง,7376,8781,16157,7576,8926,16502,9418
2567,50,เชียงใหม่,5065,ท้องถิ่นเทศบาลตำบลเจดีย์แม่ครัว,3939,4403,8342,4059,4506,8565,4390
2567,50,เชียงใหม่,5066,ท้องถิ่นเทศบาลตำบลแม่ปั๋ง,2866,2991,5857,2907,3032,5939,2749
2567,50,เชียงใหม่,5067,ท้องถิ่นเทศบาลตำบลชมภู,3717,4089,7806,3791,4173,7964,3517
2567,50,เชียงใหม่,5068,ท้องถิ่นเทศบาลตำบลป่าแดด,8046,9684,17730,8260,9858,18118,11719
2567,50,เชียงใหม่,5069,ท้องถิ่นเทศบาลเมืองสุเทพ,8039,8398,16437,8281,8592,16873,11842
2567,50,เชียงใหม่,5070,ท้องถิ่นเทศบาลตำบลหนองป่าครั่ง,3182,3687,6869,3459,3911,7370,6486
2567,50,เชียงใหม่,5071,ท้องถิ่นเทศบาลตำบลแม่วาง,2082,2336,4418,2125,2374,4499,2331
2567,50,เชียงใหม่,5072,ท้องถิ่นเทศบาลตำบลไชยปราการ,6796,7610,14406,7257,8055,15312,6763
2567,50,เชียงใหม่,5073,ท้องถิ่นเทศบาลตำบลยางเนิ้ง,5019,6057,11076,5079,6100,11179,6319
2567,50,เชียงใหม่,5074,ท้องถิ่นเทศบาลตำบลอมก๋อย,540,504,1044,546,507,1053,858
2567,50,เชียงใหม่,5075,ท้องถิ่นเทศบาลตำบลท่าเดื่อ-มืดกา,1990,2130,4120,2003,2139,4142,1916
2567,50,เชียงใหม่,5076,ท้องถิ่นเทศบาลตำบลท่าข้าม,2651,2886,5537,2665,2894,5559,3679
2567,50,เชียงใหม่,5077,ท้องถิ่นเทศบาลตำบลหางดง,2628,3314,5942,2902,3539,6441,4099
2567,50,เชียงใหม่,5078,ท้องถิ่นเทศบาลตำบลหนองตองพัฒนา,3721,4380,8101,3746,4396,8142,3698
2567,50,เชียงใหม่,5079,ท้องถิ่นเทศบาลตำบลสันทรายหลวง,12905,15839,28744,13385,16149,29534,17318
2567,50,เชียงใหม่,5080,ท้องถิ่นเทศบาลเมืองแม่โจ้,9829,12052,21881,10540,12648,23188,15532
2567,50,เชียงใหม่,5081,ท้องถิ่นเทศบาลตำบลสันกำแพง,7885,9333,17218,8044,9406,17450,9638
2567,50,เชียงใหม่,5082,ท้องถิ่นเทศบาลเมืองต้นเปา,9145,11156,20301,9345,11337,20682,14372
2567,50,เชียงใหม่,5083,ท้องถิ่นเทศบาลตำบลสันป่าตอง,1914,2299,4213,1926,2305,4231,2849
2567,50,เชียงใหม่,5084,ท้องถิ่นเทศบาลตำบลบ้านกลาง,4750,5423,10173,4788,5461,10249,5652
2567,50,เชียงใหม่,5085,ท้องถิ่นเทศบาลตำบลเวียงพร้าว,1999,2376,4375,2035,2415,4450,2908
2567,50,เชียงใหม่,5086,ท้องถิ่นเทศบาลตำบลแม่อาย,4207,4661,8868,4953,5420,10373,4579
2567,50,เชียงใหม่,5087,ท้องถิ่นเทศบาลตำบลเวียงฝาง,2639,3055,5694,3945,4271,8216,4065
2567,50,เชียงใหม่,5088,ท้องถิ่นเทศบาลตำบลบ้านแม่ข่า,861,912,1773,891,938,1829,874
2567,50,เชียงใหม่,5089,ท้องถิ่นเทศบาลตำบลสะเมิงใต้,2468,2519,4987,2612,2654,5266,2807
2567,50,เชียงใหม่,5090,ท้องถิ่นเทศบาลตำบลแม่ริม,4159,4837,8996,4238,4887,9125,6000
2567,50,เชียงใหม่,5091,ท้องถิ่นเทศบาลตำบลสันมหาพน,3640,4165,7805,3814,4348,8162,5282
2567,50,เชียงใหม่,5092,ท้องถิ่นเทศบาลเมืองเมืองแกนพัฒนา,5572,6179,11751,5648,6256,11904,5904
2567,50,เชียงใหม่,5093,ท้องถิ่นเทศบาลตำบลดอยสะเก็ด,1754,2062,3816,1836,2131,3967,2212
2567,50,เชียงใหม่,5094,ท้องถิ่นเทศบาลตำบลเมืองงาย,1641,1916,3557,1725,1983,3708,2068
2567,50,เชียงใหม่,5095,ท้องถิ่นเทศบาลตำบลเชียงดาว,1693,1947,3640,1717,1970,3687,2421
2567,50,เชียงใหม่,5096,ท้องถิ่นเทศบาลตำบลแม่แจ่ม,1215,1272,2487,1233,1293,2526,1697
2567,50,เชียงใหม่,5097,ท้องถิ่นเทศบาลตำบลจอมทอง,4059,4798,8857,4083,4818,8901,4662
2567,50,เชียงใหม่,5098,ท้องถิ่นเทศบาลตำบลช้างเผือก,3906,4521,8427,4097,4638,8735,9515
2567,50,เชียงใหม่,5099,ท้องถิ่นเทศบาลนครเชียงใหม่,50452,57772,108224,53290,60239,113529,93443
2567,51,ลำพูน,5101,อำเภอเมืองลำพูน,27959,31563,59522,28343,31894,60237,30277
2567,51,ลำพูน,5102,อำเภอแม่ทา,11858,12355,24213,11892,12374,24266,11016
2567,51,ลำพูน,5103,อำเภอบ้านโฮ่ง,12138,12834,24972,12199,12882,25081,10660
2567,51,ลำพูน,5104,อำเภอลี้,30171,29983,60154,30251,30099,60350,22195
2567,51,ลำพูน,5105,อำเภอทุ่งหัวช้าง,8705,8726,17431,8706,8728,17434,6684
2567,51,ลำพูน,5106,อำเภอป่าซาง,13180,14131,27311,13391,14354,27745,13244
2567,51,ลำพูน,5107,อำเภอบ้านธิ,3674,4104,7778,3768,4173,7941,3525
2567,51,ลำพูน,5108,อำเภอเวียงหนองล่อง,0,0,0,0,0,0,0
2567,51,ลำพูน,5176,ท้องถิ่นเทศบาลตำบลศรีเตี้ย,2504,2728,5232,2512,2741,5253,2311
2567,51,ลำพูน,5177,ท้องถิ่นเทศบาลตำบลทาสบชัย,2351,2474,4825,2380,2502,4882,2374
2567,51,ลำพูน,5178,ท้องถิ่นเทศบาลตำบลหนองล่อง,2565,2786,5351,2576,2792,5368,2622
2567,51,ลำพูน,5179,ท้องถิ่นเทศบาลตำบลหนองยวง,1646,1814,3460,1671,1831,3502,1832
2567,51,ลำพูน,5180,ท้องถิ่นเทศบาลตำบลมะกอก,2337,2679,5016,2348,2682,5030,2449
2567,51,ลำพูน,5181,ท้องถิ่นเทศบาลตำบลมะเขือแจ้,7745,8561,16306,7849,8654,16503,9548
2567,51,ลำพูน,5182,ท้องถิ่นเทศบาลตำบลเวียงยอง,3364,3971,7335,3413,4008,7421,4146
2567,51,ลำพูน,5183,ท้องถิ่นเทศบาลตำบลบ้านกลาง,5451,6436,11887,5506,6478,11984,11743
2567,51,ลำพูน,5184,ท้องถิ่นเทศบาลตำบลเหมืองง่า,7309,8885,16194,7364,8932,16296,8903
2567,51,ลำพูน,5185,ท้องถิ่นเทศบาลตำบลแม่แรง,3228,3576,6804,3242,3583,6825,2794
2567,51,ลำพูน,5186,ท้องถิ่นเทศบาลตำบลบ้านธิ,4305,4784,9089,4438,4908,9346,4615
2567,51,ลำพูน,5187,ท้องถิ่นเทศบาลตำบลวังผาง,3458,3871,7329,3470,3877,7347,3334
2567,51,ลำพูน,5188,ท้องถิ่นเทศบาลตำบลม่วงน้อย,1857,2191,4048,1868,2192,4060,2029
2567,51,ลำพูน,5189,ท้องถิ่นเทศบาลตำบลป่าซาง,3647,4379,8026,3674,4398,8072,4306
2567,51,ลำพูน,5190,ท้องถิ่นเทศบาลตำบลทุ่งหัวช้าง,1261,1269,2530,1262,1271,2533,1315
2567,51,ลำพูน,5191,ท้องถิ่นเทศบาลตำบลวังดิน,2008,2152,4160,2015,2168,4183,2843
2567,51,ลำพูน,5192,ท้องถิ่นเทศบาลตำบลแม่ตืน,1540,1716,3256,1575,1751,3326,1378
2567,51,ลำพูน,5193,ท้องถิ่นเทศบาลตำบลบ้านโฮ่ง,3280,3955,7235,3301,3971,7272,3728
2567,51,ลำพูน,5194,ท้องถิ่นเทศบาลตำบลทาสบเส้า,2474,2633,5107,2505,2659,5164,2607
2567,51,ลำพูน,5195,ท้องถิ่นเทศบาลตำบลทากาศ,1347,1503,2850,1353,1508,2861,1424
2567,51,ลำพูน,5196,ท้องถิ่นเทศบาลตำบลอุโมงค์,5786,6694,12480,5875,6767,12642,6261
2567,51,ลำพูน,5197,ท้องถิ่นเทศบาลตำบลริมปิง,3057,3550,6607,3075,3573,6648,3029
2567,51,ลำพูน,5198,ท้องถิ่นเทศบาลตำบลบ้านแป้น,2853,3315,6168,2881,3340,6221,3018
2567,51,ลำพูน,5199,ท้องถิ่นเทศบาลเมืองลำพูน,4902,5990,10892,4944,6016,10960,7282
2567,52,ลำปาง,5201,อำเภอเมืองลำปาง,43313,45488,88801,43427,45584,89011,40170
2567,52,ลำปาง,5202,อำเภอแม่เมาะ,11830,11721,23551,11858,11751,23609,9557
2567,52,ลำปาง,5203,อำเภอเกาะคา,16749,18081,34830,16776,18105,34881,13670
2567,52,ลำปาง,5204,อำเภอเสริมงาม,10780,10798,21578,10803,10820,21623,7887
2567,52,ลำปาง,5205,อำเภองาว,23378,23471,46849,23538,23659,47197,18643
2567,52,ลำปาง,5206,อำเภอแจ้ห่ม,16431,17004,33435,16508,17069,33577,13441
2567,52,ลำปาง,5207,อำเภอวังเหนือ,17538,17382,34920,17981,17869,35850,13756
2567,52,ลำปาง,5208,อำเภอเถิน,15827,16390,32217,15845,16423,32268,11762
2567,52,ลำปาง,5209,อำเภอแม่พริก,4405,4553,8958,4405,4561,8966,3302
2567,52,ลำปาง,5210,อำเภอแม่ทะ,13227,13647,26874,13239,13656,26895,11044
2567,52,ลำปาง,5211,อำเภอสบปราบ,10089,10451,20540,10098,10464,20562,6794
2567,52,ลำปาง,5212,อำเภอห้างฉัตร,22237,23212,45449,22314,23265,45579,20049
2567,52,ลำปาง,5213,อำเภอเมืองปาน,15797,15904,31701,15810,15926,31736,12619
2567,52,ลำปาง,5275,ท้องถิ่นเทศบาลตำบลน้ำโจ้,4507,4742,9249,4518,4750,9268,3589
2567,52,ลำปาง,5276,ท้องถิ่นเทศบาลตำบลแม่ทะ,3057,3207,6264,3063,3211,6274,3058
2567,52,ลำปาง,5279,ท้องถิ่นเทศบาลตำบลนาแก้ว,4193,4440,8633,4197,4444,8641,3248
2567,52,ลำปาง,5280,ท้องถิ่นเทศบาลตำบลลำปางหลวง,4207,4669,8876,4215,4676,8891,3432
2567,52,ลำปาง,5281,ท้องถิ่นเทศบาลตำบลสิริราช,2284,2189,4473,2287,2191,4478,1639
2567,52,ลำปาง,5282,ท้องถิ่นเทศบาลตำบลแม่เมาะ,7192,7594,14786,7206,7605,14811,8891
2567,52,ลำปาง,5283,ท้องถิ่นเทศบาลตำบลเวียงมอก,4974,5024,9998,4980,5032,10012,3645
2567,52,ลำปาง,5284,ท้องถิ่นเทศบาลตำบลห้างฉัตร,1195,1476,2671,1196,1478,2674,1339
2567,52,ลำปาง,5285,ท้องถิ่นเทศบาลตำบลสบปราบ,2514,2797,5311,2516,2798,5314,2141
2567,52,ลำปาง,5286,ท้องถิ่นเทศบาลตำบลป่าตันนาครัว,3634,3887,7521,3637,3887,7524,3053
2567,52,ลำปาง,5287,ท้องถิ่นเทศบาลตำบลแม่พริก,1148,1283,2431,1148,1283,2431,1164
2567,52,ลำปาง,5288,ท้องถิ่นเทศบาลตำบลแม่ปุ,1716,1927,3643,1721,1928,3649,1372
2567,52,ลำปาง,5289,ท้องถิ่นเทศบาลเมืองล้อมแรด,6199,7237,13436,6226,7266,13492,7321
2567,52,ลำปาง,5290,ท้องถิ่นเทศบาลตำบลวังเหนือ,1913,1936,3849,1924,1943,3867,2027
2567,52,ลำปาง,5291,ท้องถิ่นเทศบาลตำบลบ้านใหม่,1202,1237,2439,1203,1239,2442,903
2567,52,ลำปาง,5292,ท้องถิ่นเทศบาลตำบลแจ้ห่ม,1537,1723,3260,1539,1723,3262,1710
2567,52,ลำปาง,5293,ท้องถิ่นเทศบาลตำบลเสริมงาม,3930,4040,7970,3934,4043,7977,3138
2567,52,ลำปาง,5294,ท้องถิ่นเทศบาลตำบลหลวงเหนือ,1840,2095,3935,1846,2098,3944,2411
2567,52,ลำปาง,5295,ท้องถิ่นเทศบาลตำบลเกาะคา,1990,2329,4319,2014,2344,4358,2438
2567,52,ลำปาง,5296,ท้องถิ่นเทศบาลเมืองพิชัย,6103,7057,13160,6130,7063,13193,6707
2567,52,ลำปาง,5297,ท้องถิ่นเทศบาลตำบลบ่อแฮ้ว,4483,5017,9500,4499,5033,9532,4619
2567,52,ลำปาง,5298,ท้องถิ่นเทศบาลเมืองเขลางค์นคร,27612,30837,58449,27691,30883,58574,27329
2567,52,ลำปาง,5299,ท้องถิ่นเทศบาลนครลำปาง,21150,26219,47369,21371,26393,47764,30101
2567,53,อุตรดิตถ์,5301,อำเภอเมืองอุตรดิตถ์,21946,23200,45146,21966,23217,45183,18462
2567,53,อุตรดิตถ์,5302,อำเภอตรอน,14034,14929,28963,14046,14939,28985,10370
2567,53,อุตรดิตถ์,5303,อำเภอท่าปลา,14044,14263,28307,14059,14283,28342,10207
2567,53,อุตรดิตถ์,5304,อำเภอน้ำปาด,16171,16212,32383,16210,16299,32509,12376
2567,53,อุตรดิตถ์,5305,อำเภอฟากท่า,6220,6610,12830,6226,6629,12855,5273
2567,53,อุตรดิตถ์,5306,อำเภอบ้านโคก,5082,4859,9941,5199,5082,10281,4683
2567,53,อุตรดิตถ์,5307,อำเภอพิชัย,33933,36014,69947,33965,36035,70000,26684
2567,53,อุตรดิตถ์,5308,อำเภอลับแล,17718,18180,35898,17729,18187,35916,15646
2567,53,อุตรดิตถ์,5309,อำเภอทองแสนขัน,12733,13073,25806,12740,13076,25816,9842
2567,53,อุตรดิตถ์,5377,ท้องถิ่นเทศบาลตำบลท่าเสา,7518,7351,14869,7531,7357,14888,7999
2567,53,อุตรดิตถ์,5378,ท้องถิ่นเทศบาลตำบลน้ำริด,3324,3506,6830,3326,3507,6833,2681
2567,53,อุตรดิตถ์,5379,ท้องถิ่นเทศบาลตำบลหาดกรวด,3568,3892,7460,3582,3896,7478,2736
2567,53,อุตรดิตถ์,5380,ท้องถิ่นเทศบาลตำบลจริม,4225,4081,8306,4227,4082,8309,2371
2567,53,อุตรดิตถ์,5381,ท้องถิ่นเทศบาลตำบลคุ้งตะเภา,4208,4517,8725,4214,4521,8735,3612
2567,53,อุตรดิตถ์,5382,ท้องถิ่นเทศบาลตำบลผาจุก,3793,4113,7906,3796,4116,7912,3163
2567,53,อุตรดิตถ์,5383,ท้องถิ่นเทศบาลตำบลบ้านเกาะ,4354,5081,9435,4369,5087,9456,4033
2567,53,อุตรดิตถ์,5384,ท้องถิ่นเทศบาลตำบลทองแสนขัน,2125,2311,4436,2127,2313,4440,1870
2567,53,อุตรดิตถ์,5385,ท้องถิ่นเทศบาลตำบลหัวดง,2612,2784,5396,2613,2784,5397,2230
2567,53,อุตรดิตถ์,5386,ท้องถิ่นเทศบาลตำบลทุ่งยั้ง,4478,5192,9670,4488,5194,9682,4296
2567,53,อุตรดิตถ์,5387,ท้องถิ่นเทศบาลตำบลในเมือง,783,950,1733,790,951,1741,1018
2567,53,อุตรดิตถ์,5388,ท้องถิ่นเทศบาลตำบลท่าสัก,544,621,1165,545,623,1168,592
2567,53,อุตรดิตถ์,5389,ท้องถิ่นเทศบาลตำบลบ้านโคก,1843,1732,3575,1920,1910,3830,1976
2567,53,อุตรดิตถ์,5390,ท้องถิ่นเทศบาลตำบลฟากท่า,429,397,826,429,397,826,433
2567,53,อุตรดิตถ์,5391,ท้องถิ่นเทศบาลตำบลน้ำปาด,1323,1444,2767,1325,1450,2775,1618
2567,53,อุตรดิตถ์,5392,ท้องถิ่นเทศบาลตำบลร่วมจิต,1559,1748,3307,1560,1750,3310,1242
2567,53,อุตรดิตถ์,5393,ท้องถิ่นเทศบาลตำบลท่าปลา,1035,1141,2176,1039,1141,2180,993
2567,53,อุตรดิตถ์,5394,ท้องถิ่นเทศบาลตำบลบ้านแก่ง,995,1065,2060,996,1066,2062,904
2567,53,อุตรดิตถ์,5395,ท้องถิ่นเทศบาลตำบลตรอน,794,872,1666,796,872,1668,706
2567,53,อุตรดิตถ์,5396,ท้องถิ่นเทศบาลตำบลวังกะพี้,4397,4992,9389,4403,4996,9399,3511
2567,53,อุตรดิตถ์,5397,ท้องถิ่นเทศบาลตำบลบ้านด่านนาขาม,1808,1928,3736,1809,1929,3738,1414
2567,53,อุตรดิตถ์,5398,ท้องถิ่นเทศบาลตำบลศรีพนมมาศ,1261,1492,2753,1262,1492,2754,1217
2567,53,อุตรดิตถ์,5399,ท้องถิ่นเทศบาลเมืองอุตรดิตถ์,12662,15052,27714,12718,15097,27815,15150
2567,54,แพร่,5401,อำเภอเมืองแพร่,28642,32592,61234,28699,32615,61314,28617
2567,54,แพร่,5402,อำเภอร้องกวาง,16473,17799,34272,16518,17855,34373,13142
2567,54,แพร่,5403,อำเภอลอง,14692,14985,29677,14713,14999,29712,11762
2567,54,แพร่,5404,อำเภอสูงเม่น,31464,34942,66406,31494,34969,66463,28710
2567,54,แพร่,5405,อำเภอเด่นชัย,9904,9438,19342,9912,9446,19358,8691
2567,54,แพร่,5406,อำเภอสอง,19884,20862,40746,19928,20891,40819,16762
2567,54,แพร่,5407,อำเภอวังชิ้น,20548,20736,41284,20605,20790,41395,15835
2567,54,แพร่,5408,อำเภอหนองม่วงไข่,5649,6510,12159,5656,6514,12170,5136
2567,54,แพร่,5482,ท้องถิ่นเทศบาลตำบลแม่ลานนา,3113,3273,6386,3117,3277,6394,2771
2567,54,แพร่,5483,ท้องถิ่นเทศบาลตำบลแม่ปาน,1403,1399,2802,1403,1400,2803,1173
2567,54,แพร่,5484,ท้องถิ่นเทศบาลตำบลเวียงต้า,3064,3033,6097,3066,3034,6100,2509
2567,54,แพร่,5485,ท้องถิ่นเทศบาลตำบลป่าแมต,5515,6345,11860,5522,6348,11870,5180
2567,54,แพร่,5486,ท้องถิ่นเทศบาลตำบลแม่คำมี,3375,3568,6943,3376,3568,6944,2781
2567,54,แพร่,5487,ท้องถิ่นเทศบาลตำบลหนองม่วงไข่,1953,2278,4231,1954,2280,4234,1934
2567,54,แพร่,5488,ท้องถิ่นเทศบาลตำบลวังชิ้น,1334,1418,2752,1339,1418,2757,1475
2567,54,แพร่,5489,ท้องถิ่นเทศบาลตำบลสอง,2831,3389,6220,2840,3394,6234,3181
2567,54,แพร่,5490,ท้องถิ่นเทศบาลตำบลแม่จั๊วะ,1718,1888,3606,1725,1890,3615,1605
2567,54,แพร่,5491,ท้องถิ่นเทศบาลตำบลเด่นชัย,4938,5503,10441,4950,5509,10459,5316
2567,54,แพร่,5492,ท้องถิ่นเทศบาลตำบลสูงเม่น,1648,1893,3541,1650,1896,3546,1967
2567,54,แพร่,5493,ท้องถิ่นเทศบาลตำบลห้วยอ้อ,2148,2440,4588,2156,2440,4596,2259
2567,54,แพร่,5494,ท้องถิ่นเทศบาลตำบลบ้านปิน,973,1158,2131,978,1159,2137,834
2567,54,แพร่,5495,ท้องถิ่นเทศบาลตำบลร้องกวาง,5607,6304,11911,5619,6310,11929,6164
2567,54,แพร่,5496,ท้องถิ่นเทศบาลตำบลแม่หล่าย,1934,2288,4222,1940,2299,4239,2062
2567,54,แพร่,5497,ท้องถิ่นเทศบาลตำบลทุ่งโฮ้ง,2807,3249,6056,2812,3255,6067,3322
2567,54,แพร่,5498,ท้องถิ่นเทศบาลตำบลช่อแฮ,4103,4394,8497,4105,4396,8501,3812
2567,54,แพร่,5499,ท้องถิ่นเทศบาลเมืองแพร่,6254,7380,13634,6301,7415,13716,8874
2567,55,น่าน,5501,อำเภอเมืองน่าน,31250,31652,62902,31351,31760,63111,26511
2567,55,น่าน,5502,อำเภอแม่จริม,8372,8001,16373,8397,8025,16422,5048
2567,55,น่าน,5503,อำเภอบ้านหลวง,5624,5545,11169,5628,5552,11180,4054
2567,55,น่าน,5504,อำเภอนาน้อย,14728,14631,29359,14745,14650,29395,10803
2567,55,น่าน,5505,อำเภอปัว,26403,26793,53196,26457,26887,53344,16887
2567,55,น่าน,5506,อำเภอท่าวังผา,22189,22361,44550,22256,22457,44713,15254
2567,55,น่าน,5507,อำเภอเวียงสา,32664,32611,65275,32759,32720,65479,25695
2567,55,น่าน,5508,อำเภอทุ่งช้าง,7793,7626,15419,7884,7774,15658,5349
2567,55,น่าน,5509,อำเภอเชียงกลาง,8424,8636,17060,8446,8656,17102,6043
2567,55,น่าน,5510,อำเภอนาหมื่น,6945,6897,13842,6950,6904,13854,4652
2567,55,น่าน,5511,อำเภอสันติสุข,7916,7531,15447,7927,7544,15471,5373
2567,55,น่าน,5512,อำเภอบ่อเกลือ,7848,7489,15337,7877,7518,15395,5357
2567,55,น่าน,5513,อำเภอสองแคว,6314,5883,12197,6390,6002,12392,4034
2567,55,น่าน,5514,อำเภอภูเพียง,17532,18100,35632,17567,18134,35701,14578
2567,55,น่าน,5515,อำเภอเฉลิมพระเกียรติ,4960,4703,9663,5018,4752,9770,3497
2567,55,น่าน,5592,ท้องถิ่นเทศบาลตำบลเชียงกลาง,4615,4776,9391,4627,4785,9412,4104
2567,55,น่าน,5593,ท้องถิ่นเทศบาลตำบลทุ่งช้าง,1614,1593,3207,1625,1610,3235,1469
2567,55,น่าน,5594,ท้องถิ่นเทศบาลตำบลเวียงสา,1229,1433,2662,1229,1434,2663,1344
2567,55,น่าน,5595,ท้องถิ่นเทศบาลตำบลท่าวังผา,2431,2677,5108,2438,2696,5134,2852
2567,55,น่าน,5596,ท้องถิ่นเทศบาลตำบลปัว,4963,5320,10283,5003,5370,10373,5223
2567,55,น่าน,5597,ท้องถิ่นเทศบาลตำบลนาน้อย,1065,1216,2281,1067,1219,2286,1285
2567,55,น่าน,5598,ท้องถิ่นเทศบาลตำบลหนองแดง,0,0,0,0,0,0,0
2567,55,น่าน,5599,ท้องถิ่นเทศบาลเมืองน่าน,8959,9358,18317,9006,9411,18417,11049
2567,56,พะเยา,5601,อำเภอเมืองพะเยา,20387,21873,42260,20441,21923,42364,18085
2567,56,พะเยา,5602,อำเภอจุน,8268,9212,17480,8316,9244,17560,7567
2567,56,พะเยา,5603,อำเภอเชียงคำ,26831,27164,53995,27310,27690,55000,22331
2567,56,พะเยา,5604,อำเภอเชียงม่วน,4619,4715,9334,4644,4753,9397,4060
2567,56,พะเยา,5605,อำเภอดอกคำใต้,17979,19009,36988,18026,19064,37090,15365
2567,56,พะเยา,5606,อำเภอปง,19417,19334,38751,19516,19440,38956,12990
2567,56,พะเยา,5607,อำเภอแม่ใจ,9489,10160,19649,9510,10179,19689,9722
2567,56,พะเยา,5608,อำเภอภูซาง,11749,11991,23740,11866,12197,24063,9964
2567,56,พะเยา,5609,อำเภอภูกามยาว,5877,6441,12318,5899,6454,12353,5229
2567,56,พะเยา,5677,ท้องถิ่นเทศบาลตำบลบ้านต๋อม,5624,6720,12344,5725,6798,12523,7678
2567,56,พะเยา,5678,ท้องถิ่นเทศบาลตำบลห้วยลาน,4048,4432,8480,4062,4446,8508,3426
2567,56,พะเยา,5679,ท้องถิ่นเทศบาลตำบลฝายกวาง,4189,4440,8629,4206,4464,8670,3844
2567,56,พะเยา,5680,ท้องถิ่นเทศบาลตำบลเวียงลอ,2835,3067,5902,2842,3077,5919,2742
2567,56,พะเยา,5681,ท้องถิ่นเทศบาลตำบลหงส์หิน,3103,3365,6468,3112,3372,6484,2883
2567,56,พะเยา,5682,ท้องถิ่นเทศบาลตำบลจุน,4239,4537,8776,4258,4547,8805,4109
2567,56,พะเยา,5683,ท้องถิ่นเทศบาลตำบลบ้านเหล่า,3646,3869,7515,3653,3875,7528,3059
2567,56,พะเยา,5684,ท้องถิ่นเทศบาลตำบลแม่กา,6021,6557,12578,6053,6589,12642,7344
2567,56,พะเยา,5685,ท้องถิ่นเทศบาลตำบลแม่ปืม,4278,4490,8768,4281,4500,8781,3552
2567,56,พะเยา,5686,ท้องถิ่นเทศบาลตำบลบ้านต๊ำ,3343,3583,6926,3352,3590,6942,3373
2567,56,พะเยา,5687,ท้องถิ่นเทศบาลตำบลท่าวังทอง,7898,7759,15657,7926,7772,15698,10113
2567,56,พะเยา,5688,ท้องถิ่นเทศบาลตำบลดงเจน,3691,4252,7943,3703,4262,7965,3711
2567,56,พะเยา,5689,ท้องถิ่นเทศบาลตำบลสบบง,3946,4264,8210,3970,4310,8280,3669
2567,56,พะเยา,5690,ท้องถิ่นเทศบาลตำบลแม่ใจ,2281,2486,4767,2286,2488,4774,2242
2567,56,พะเยา,5691,ท้องถิ่นเทศบาลตำบลปง,2503,2788,5291,2514,2794,5308,2883
2567,56,พะเยา,5692,ท้องถิ่นเทศบาลตำบลงิม,3194,3238,6432,3198,3244,6442,2543
2567,56,พะเยา,5693,ท้องถิ่นเทศบาลเมืองดอกคำใต้,5499,6467,11966,5513,6479,11992,5484
2567,56,พะเยา,5694,ท้องถิ่นเทศบาลตำบลบ้านถ้ำ,3976,3983,7959,3978,3985,7963,3442
2567,56,พะเยา,5695,ท้องถิ่นเทศบาลตำบลเชียงม่วน,4097,4278,8375,4105,4287,8392,3970
2567,56,พะเยา,5696,ท้องถิ่นเทศบาลตำบลเวียง,2569,2721,5290,2572,2727,5299,2344
2567,56,พะเยา,5697,ท้องถิ่นเทศบาลตำบลเชียงคำ,2660,3274,5934,2670,3295,5965,3778
2567,56,พะเยา,5698,ท้องถิ่นเทศบาลตำบลห้วยข้าวก่ำ,3795,4174,7969,3804,4189,7993,4473
2567,56,พะเยา,5699,ท้องถิ่นเทศบาลเมืองพะเยา,7031,8329,15360,7067,8352,15419,8412
2567,57,เชียงราย,5701,อำเภอเมืองเชียงราย,49454,54015,103469,52453,57164,109617,56840
2567,57,เชียงราย,5702,อำเภอเวียงชัย,18576,19844,38420,18740,19961,38701,16544
2567,57,เชียงราย,5703,อำเภอเชียงของ,11873,12008,23881,12246,12689,24935,11028
2567,57,เชียงราย,5704,อำเภอเทิง,35772,36609,72381,36422,37372,73794,30067
2567,57,เชียงราย,5705,อำเภอพาน,51788,55282,107070,52555,56088,108643,49947
2567,57,เชียงราย,5706,อำเภอป่าแดด,5698,5861,11559,5714,5872,11586,4239
2567,57,เชียงราย,5707,อำเภอแม่จัน,29041,31021,60062,33649,36232,69881,29779
2567,57,เชียงราย,5708,อำเภอเชียงแสน,20961,21541,42502,24047,25293,49340,19727
2567,57,เชียงราย,5709,อำเภอแม่สาย,22586,24411,46997,36163,40677,76840,31758
2567,57,เชียงราย,5710,อำเภอแม่สรวย,36558,36187,72745,39608,39315,78923,30764
2567,57,เชียงราย,5711,อำเภอเวียงป่าเป้า,28375,29196,57571,29852,30607,60459,25740
2567,57,เชียงราย,5712,อำเภอพญาเม็งราย,13295,13573,26868,13476,13772,27248,10280
2567,57,เชียงราย,5713,อำเภอเวียงแก่น,17625,16927,34552,19264,18975,38239,14422
2567,57,เชียงราย,5714,อำเภอขุนตาล,6744,7069,13813,6781,7100,13881,5798
2567,57,เชียงราย,5715,อำเภอแม่ฟ้าหลวง,29171,28290,57461,38716,39069,77785,26656
2567,57,เชียงราย,5716,อำเภอแม่ลาว,11596,12511,24107,11707,12625,24332,11620
2567,57,เชียงราย,5717,อำเภอเวียงเชียงรุ้ง,11563,11976,23539,11623,12023,23646,9772
2567,57,เชียงราย,5718,อำเภอดอยหลวง,9110,9081,18191,9236,9253,18489,9029
2567,57,เชียงราย,5764,ท้องถิ่นเทศบาลตำบลแม่ยาว,8847,9003,17850,10906,11186,22092,9727
2567,57,เชียงราย,5765,ท้องถิ่นเทศบาลตำบลห้วยซ้อ,5877,5826,11703,6002,6063,12065,5411
2567,57,เชียงราย,5766,ท้องถิ่นเทศบาลตำบลไม้ยา,5142,5175,10317,5150,5184,10334,3954
2567,57,เชียงราย,5767,ท้องถิ่นเทศบาลตำบลครึ่ง,3032,3074,6106,3049,3090,6139,2774
2567,57,เชียงราย,5768,ท้องถิ่นเทศบาลตำบลป่าอ้อดอนชัย,5325,5964,11289,5475,6115,11590,5935
2567,57,เชียงราย,5769,ท้องถิ่นเทศบาลตำบลยางฮอม,5129,5413,10542,5176,5458,10634,4138
2567,57,เชียงราย,5770,ท้องถิ่นเทศบาลตำบลเวียง,4638,4678,9316,4870,5016,9886,4565
2567,57,เชียงราย,5771,ท้องถิ่นเทศบาลตำบลนางแล,5389,6054,11443,6077,6715,12792,6968
2567,57,เชียงราย,5772,ท้องถิ่นเทศบาลตำบลป่าซาง,4807,5425,10232,5410,6124,11534,5909
2567,57,เชียงราย,5773,ท้องถิ่นเทศบาลตำบลเวียงพางคำ,5213,5448,10661,10792,12390,23182,10620
2567,57,เชียงราย,5774,ท้องถิ่นเทศบาลตำบลบ้านดู่,9276,10935,20211,10403,12091,22494,15768
2567,57,เชียงราย,5775,ท้องถิ่นเทศบาลตำบลบ้านเหล่า,1913,1952,3865,1914,1955,3869,1835
2567,57,เชียงราย,5776,ท้องถิ่นเทศบาลตำบลแม่ลาว,824,912,1736,828,917,1745,838
2567,57,เชียงราย,5777,ท้องถิ่นเทศบาลตำบลป่าก่อดำ,1936,2188,4124,1960,2199,4159,2089
2567,57,เชียงราย,5778,ท้องถิ่นเทศบาลตำบลบ้านต้า,2781,3031,5812,2791,3038,5829,2321
2567,57,เชียงราย,5779,ท้องถิ่นเทศบาลตำบลพญาเม็งราย,1881,2065,3946,1939,2100,4039,2328
2567,57,เชียงราย,5780,ท้องถิ่นเทศบาลตำบลเวียงป่าเป้า,1841,2196,4037,1875,2237,4112,2431
2567,57,เชียงราย,5781,ท้องถิ่นเทศบาลตำบลแม่ขะจาน,1294,1479,2773,1301,1487,2788,1656
2567,57,เชียงราย,5782,ท้องถิ่นเทศบาลตำบลเจดีย์หลวง,2233,2322,4555,2252,2344,4596,2209
2567,57,เชียงราย,5783,ท้องถิ่นเทศบาลตำบลแม่สรวย,650,704,1354,695,743,1438,1162
2567,57,เชียงราย,5784,ท้องถิ่นเทศบาลตำบลห้วยไคร้,2030,2303,4333,2256,2631,4887,2584
2567,57,เชียงราย,5785,ท้องถิ่นเทศบาลตำบลแม่สาย,8396,8845,17241,12943,14824,27767,13969
2567,57,เชียงราย,5786,ท้องถิ่นเทศบาลตำบลเวียงเชียงแสน,2181,2469,4650,2885,3225,6110,3420
2567,57,เชียงราย,5787,ท้องถิ่นเทศบาลตำบลสันทราย,1191,1368,2559,1263,1425,2688,1312
2567,57,เชียงราย,5788,ท้องถิ่นเทศบาลตำบลแม่จัน,1375,1591,2966,1627,1867,3494,2475
2567,57,เชียงราย,5789,ท้องถิ่นเทศบาลตำบลแม่คำ,2007,2268,4275,2034,2296,4330,2218
2567,57,เชียงราย,5790,ท้องถิ่นเทศบาลตำบลจันจว้า,6449,7173,13622,6550,7299,13849,6399
2567,57,เชียงราย,5791,ท้องถิ่นเทศบาลตำบลป่าแดด,2980,3156,6136,2990,3172,6162,2579
2567,57,เชียงราย,5792,ท้องถิ่นเทศบาลตำบลป่าแงะ,3611,3713,7324,3619,3725,7344,3266
2567,57,เชียงราย,5793,ท้องถิ่นเทศบาลตำบลเมืองพาน,2797,3282,6079,2823,3306,6129,3628
2567,57,เชียงราย,5794,ท้องถิ่นเทศบาลตำบลเวียงเทิง,2235,2586,4821,2280,2631,4911,2907
2567,57,เชียงราย,5795,ท้องถิ่นเทศบาลตำบลบ้านปล้อง,1825,1984,3809,1827,1987,3814,1627
2567,57,เชียงราย,5796,ท้องถิ่นเทศบาลตำบลเวียงเชียงของ,1635,1901,3536,1647,1938,3585,2389
2567,57,เชียงราย,5797,ท้องถิ่นเทศบาลตำบลบุญเรือง,2764,2924,5688,2774,2940,5714,2579
2567,57,เชียงราย,5798,ท้องถิ่นเทศบาลตำบลเวียงชัย,3103,3570,6673,3138,3591,6729,3317
2567,57,เชียงราย,5799,ท้องถิ่นเทศบาลนครเชียงราย,33228,38004,71232,37038,41450,78488,53491
2567,58,แม่ฮ่องสอน,5801,อำเภอเมืองแม่ฮ่องสอน,19932,19334,39266,28508,28103,56611,24753
2567,58,แม่ฮ่องสอน,5802,อำเภอขุนยวม,9682,9259,18941,10455,9921,20376,8236
2567,58,แม่ฮ่องสอน,5803,อำเภอปาย,15453,14625,30078,18255,17189,35444,16289
2567,58,แม่ฮ่องสอน,5804,อำเภอแม่สะเรียง,25055,25030,50085,26495,26360,52855,22922
2567,58,แม่ฮ่องสอน,5805,อำเภอแม่ลาน้อย,16052,15917,31969,16153,15985,32138,11385
2567,58,แม่ฮ่องสอน,5806,อำเภอสบเมย,18667,18204,36871,24583,23890,48473,18261
2567,58,แม่ฮ่องสอน,5807,อำเภอปางมะผ้า,9108,8691,17799,11535,10819,22354,9415
2567,58,แม่ฮ่องสอน,5895,ท้องถิ่นเทศบาลตำบลแม่ลาน้อย,1679,1736,3415,1707,1757,3464,1865
2567,58,แม่ฮ่องสอน,5896,ท้องถิ่นเทศบาลตำบลแม่สะเรียง,1115,1287,2402,1277,1421,2698,2057
2567,58,แม่ฮ่องสอน,5897,ท้องถิ่นเทศบาลตำบลปาย,1037,1149,2186,1636,1699,3335,1963
2567,58,แม่ฮ่องสอน,5898,ท้องถิ่นเทศบาลตำบลขุนยวม,1574,1663,3237,1724,1789,3513,1859
2567,58,แม่ฮ่องสอน,5899,ท้องถิ่นเทศบาลเมืองแม่ฮ่องสอน,3016,3141,6157,3395,3426,6821,4821
2567,60,นครสวรรค์,6001,อำเภอเมืองนครสวรรค์,77399,84050,161449,77626,84161,161787,75749
2567,60,นครสวรรค์,6002,อำเภอโกรกพระ,12731,13478,26209,12750,13488,26238,10080
2567,60,นครสวรรค์,6003,อำเภอชุมแสง,25117,26747,51864,25148,26765,51913,19025
2567,60,นครสวรรค์,6004,อำเภอหนองบัว,26331,26836,53167,26352,26847,53199,24157
2567,60,นครสวรรค์,6005,อำเภอบรรพตพิสัย,38632,40293,78925,38702,40327,79029,29473
2567,60,นครสวรรค์,6006,อำเภอเก้าเลี้ยว,13631,14382,28013,13652,14395,28047,11018
2567,60,นครสวรรค์,6007,อำเภอตาคลี,37274,38274,75548,37323,38318,75641,31157
2567,60,นครสวรรค์,6008,อำเภอท่าตะโก,28625,30082,58707,28667,30097,58764,24302
2567,60,นครสวรรค์,6009,อำเภอไพศาลี,29087,29719,58806,29102,29738,58840,22125
2567,60,นครสวรรค์,6010,อำเภอพยุหะคีรี,23814,25352,49166,23856,25370,49226,21914
2567,60,นครสวรรค์,6011,อำเภอลาดยาว,35136,36601,71737,35173,36633,71806,27862
2567,60,นครสวรรค์,6012,อำเภอตากฟ้า,16401,16978,33379,16410,16986,33396,13183
2567,60,นครสวรรค์,6013,อำเภอแม่วงก์,24341,24575,48916,24370,24587,48957,19342
2567,60,นครสวรรค์,6014,อำเภอแม่เปิน,10296,10284,20580,10302,10286,20588,6444
2567,60,นครสวรรค์,6015,อำเภอชุมตาบง,8781,8858,17639,8785,8860,17645,6675
2567,60,นครสวรรค์,6082,ท้องถิ่นเทศบาลตำบลตากฟ้า,2470,2681,5151,2477,2685,5162,2872
2567,60,นครสวรรค์,6083,ท้องถิ่นเทศบาลตำบลลาดยาว,2630,2993,5623,2641,3002,5643,3529
2567,60,นครสวรรค์,6084,ท้องถิ่นเทศบาลตำบลศาลเจ้าไก่ต่อ,1492,1712,3204,1493,1715,3208,1510
2567,60,นครสวรรค์,6085,ท้องถิ่นเทศบาลตำบลพยุหะ,2472,2895,5367,2485,2903,5388,3056
2567,60,นครสวรรค์,6086,ท้องถิ่นเทศบาลตำบลท่าน้ำอ้อยม่วงหัก,2306,2557,4863,2314,2560,4874,2815
2567,60,นครสวรรค์,6087,ท้องถิ่นเทศบาลตำบลไพศาลี,4654,5200,9854,4665,5204,9869,5150
2567,60,นครสวรรค์,6088,ท้องถิ่นเทศบาลตำบลท่าตะโก,2461,2816,5277,2472,2830,5302,2960
2567,60,นครสวรรค์,6089,ท้องถิ่นเทศบาลตำบลช่องแค,1375,1513,2888,1377,1513,2890,1101
2567,60,นครสวรรค์,6090,ท้องถิ่นเทศบาลตำบลเก้าเลี้ยว,2644,2902,5546,2659,2908,5567,2395
2567,60,นครสวรรค์,6091,ท้องถิ่นเทศบาลตำบลบรรพตพิสัย,1686,1860,3546,1691,1860,3551,1904
2567,60,นครสวรรค์,6092,ท้องถิ่นเทศบาลเมืองหนองบัว,5318,5919,11237,5322,5931,11253,5235
2567,60,นครสวรรค์,6093,ท้องถิ่นเทศบาลตำบลทับกฤช,990,1061,2051,992,1062,2054,843
2567,60,นครสวรรค์,6094,ท้องถิ่นเทศบาลตำบลบางประมุง,2409,2517,4926,2416,2518,4934,1653
2567,60,นครสวรรค์,6095,ท้องถิ่นเทศบาลตำบลโกรกพระ,1029,1118,2147,1030,1120,2150,1014
2567,60,นครสวรรค์,6096,ท้องถิ่นเทศบาลตำบลหนองเบน,1271,1558,2829,1274,1564,2838,1549
2567,60,นครสวรรค์,6097,ท้องถิ่นเทศบาลเมืองตาคลี,10417,11502,21919,10464,11529,21993,10222
2567,60,นครสวรรค์,6098,ท้องถิ่นเทศบาลเมืองชุมแสง,3365,3768,7133,3372,3775,7147,3659
2567,60,นครสวรรค์,6099,ท้องถิ่นเทศบาลนครนครสวรรค์,35493,39220,74713,35919,39583,75502,43397
2567,61,อุทัยธานี,6101,อำเภอเมืองอุทัยธานี,16756,18279,35035,16774,18295,35069,14621
2567,61,อุทัยธานี,6102,อำเภอทัพทัน,7658,8043,15701,7665,8048,15713,5691
2567,61,อุทัยธานี,6103,อำเภอสว่างอารมณ์,14685,14759,29444,14694,14778,29472,10339
2567,61,อุทัยธานี,6104,อำเภอหนองฉาง,16197,17226,33423,16210,17240,33450,12418
2567,61,อุทัยธานี,6105,อำเภอหนองขาหย่าง,7090,7969,15059,7094,7970,15064,6232
2567,61,อุทัยธานี,6106,อำเภอบ้านไร่,31160,31690,62850,31238,31766,63004,26148
2567,61,อุทัยธานี,6107,อำเภอลานสัก,27137,27624,54761,27178,27676,54854,19905
2567,61,อุทัยธานี,6108,อำเภอห้วยคต,9907,10182,20089,9933,10192,20125,7862
2567,61,อุทัยธานี,6189,ท้องถิ่นเทศบาลตำบลหนองสระ,993,1121,2114,993,1121,2114,702
2567,61,อุทัยธานี,6190,ท้องถิ่นเทศบาลตำบลลานสัก,1610,1656,3266,1614,1659,3273,2279
2567,61,อุทัยธานี,6191,ท้องถิ่นเทศบาลตำบลเมืองการุ้ง,999,1100,2099,1001,1102,2103,1096
2567,61,อุทัยธานี,6192,ท้องถิ่นเทศบาลตำบลบ้านไร่,1175,1236,2411,1178,1238,2416,1450
2567,61,อุทัยธานี,6193,ท้องถิ่นเทศบาลตำบลหนองขาหย่าง,263,305,568,263,305,568,354
2567,61,อุทัยธานี,6194,ท้องถิ่นเทศบาลตำบลหนองฉาง,1244,1412,2656,1245,1414,2659,1994
2567,61,อุทัยธานี,6195,ท้องถิ่นเทศบาลตำบลเขาบางแกรก,2884,3166,6050,2889,3167,6056,2484
2567,61,อุทัยธานี,6196,ท้องถิ่นเทศบาลตำบลสว่างอารมณ์,744,819,1563,748,820,1568,1028
2567,61,อุทัยธานี,6197,ท้องถิ่นเทศบาลตำบลทัพทัน,4115,4488,8603,4122,4494,8616,3836
2567,61,อุทัยธานี,6198,ท้องถิ่นเทศบาลตำบลตลุกดู่,5382,5653,11035,5386,5659,11045,3795
2567,61,อุทัยธานี,6199,ท้องถิ่นเทศบาลเมืองอุทัยธานี,6050,7163,13213,6086,7190,13276,9816
2567,62,กำแพงเพชร,6201,อำเภอเมืองกำแพงเพชร,65983,68614,134597,66087,68691,134778,55772
2567,62,กำแพงเพชร,6202,อำเภอไทรงาม,21987,22396,44383,22013,22412,44425,15521
2567,62,กำแพงเพชร,6203,อำเภอคลองลาน,19843,19420,39263,19903,19460,39363,15701
2567,62,กำแพงเพชร,6204,อำเภอขาณุวรลักษบุรี,33360,33952,67312,33394,33970,67364,26662
2567,62,กำแพงเพชร,6205,อำเภอคลองขลุง,26720,27862,54582,26805,27926,54731,24394
2567,62,กำแพงเพชร,6206,อำเภอพรานกระต่าย,24010,24185,48195,24025,24196,48221,16841
2567,62,กำแพงเพชร,6207,อำเภอลานกระบือ,16058,16133,32191,16073,16156,32229,11655
2567,62,กำแพงเพชร,6208,อำเภอทรายทองวัฒนา,6809,6860,13669,6819,6866,13685,4314
2567,62,กำแพงเพชร,6209,อำเภอปางศิลาทอง,14846,14884,29730,14877,14905,29782,11693
2567,62,กำแพงเพชร,6210,อำเภอบึงสามัคคี,8941,9016,17957,8958,9030,17988,7609
2567,62,กำแพงเพชร,6211,อำเภอโกสัมพีนคร,13755,13755,27510,13768,13764,27532,11187
2567,62,กำแพงเพชร,6278,ท้องถิ่นเทศบาลเมืองปางมะค่า,8604,8699,17303,8616,8709,17325,6982
2567,62,กำแพงเพชร,6279,ท้องถิ่นเทศบาลตำบลบ้านพราน,3517,3518,7035,3535,3535,7070,3056
2567,62,กำแพงเพชร,6280,ท้องถิ่นเทศบาลตำบลระหาน,3468,3617,7085,3497,3647,7144,3720
2567,62,กำแพงเพชร,6281,ท้องถิ่นเทศบาลตำบลคลองพิไกร,2797,2943,5740,2802,2947,5749,2322
2567,62,กำแพงเพชร,6282,ท้องถิ่นเทศบาลตำบลนิคมทุ่งโพธิ์ทะเล,4407,4578,8985,4416,4585,9001,3758
2567,62,กำแพงเพชร,6283,ท้องถิ่นเทศบาลตำบลวังยาง,2614,2720,5334,2622,2730,5352,2170
2567,62,กำแพงเพชร,6284,ท้องถิ่นเทศบาลตำบลทุ่งทราย,4123,4331,8454,4133,4337,8470,3379
2567,62,กำแพงเพชร,6285,ท้องถิ่นเทศบาลตำบลเทพนคร,9759,10334,20093,9772,10350,20122,8895
2567,62,กำแพงเพชร,6286,ท้องถิ่นเทศบาลตำบลคลองลานพัฒนา,10772,11219,21991,10809,11268,22077,8793
2567,62,กำแพงเพชร,6287,ท้องถิ่นเทศบาลตำบลช่องลม,2839,2852,5691,2841,2854,5695,1837
2567,62,กำแพงเพชร,6288,ท้องถิ่นเทศบาลตำบลลานกระบือ,2104,2175,4279,2119,2191,4310,2649
2567,62,กำแพงเพชร,6289,ท้องถิ่นเทศบาลตำบลพรานกระต่าย,3934,4303,8237,3938,4307,8245,3782
2567,62,กำแพงเพชร,6290,ท้องถิ่นเทศบาลตำบลท่ามะเขือ,1756,1894,3650,1769,1901,3670,2081
2567,62,กำแพงเพชร,6291,ท้องถิ่นเทศบาลตำบลท่าพุทรา,716,748,1464,718,749,1467,660
2567,62,กำแพงเพชร,6292,ท้องถิ่นเทศบาลตำบลคลองขลุง,911,947,1858,935,960,1895,1040
2567,62,กำแพงเพชร,6293,ท้องถิ่นเทศบาลตำบลสลกบาตร,3706,4067,7773,3729,4097,7826,4552
2567,62,กำแพงเพชร,6294,ท้องถิ่นเทศบาลตำบลขาณุวรลักษบุรี,3675,3947,7622,3733,4004,7737,3539
2567,62,กำแพงเพชร,6295,ท้องถิ่นเทศบาลตำบลไทรงาม,2314,2544,4858,2319,2555,4874,2583
2567,62,กำแพงเพชร,6296,ท้องถิ่นเทศบาลตำบลปากดง,1476,1617,3093,1478,1619,3097,1365
2567,62,กำแพงเพชร,6297,ท้องถิ่นเทศบาลตำบลนครชุม,3095,3515,6610,3106,3518,6624,3593
2567,62,กำแพงเพชร,6298,ท้องถิ่นเทศบาลตำบลคลองแม่ลาย,2768,2916,5684,2776,2923,5699,2533
2567,62,กำแพงเพชร,6299,ท้องถิ่นเทศบาลเมืองกำแพงเพชร,12636,14412,27048,12781,14534,27315,16911
2567,63,ตาก,6301,อำเภอเมืองตาก,36642,37359,74001,36761,37458,74219,29973
2567,63,ตาก,6302,อำเภอบ้านตาก,15142,15524,30666,15192,15558,30750,11386
2567,63,ตาก,6303,อำเภอสามเงา,12311,12645,24956,12327,12661,24988,9820
2567,63,ตาก,6304,อำเภอแม่ระมาด,21550,20945,42495,26265,24932,51197,17900
2567,63,ตาก,6305,อำเภอท่าสองยาง,36577,35068,71645,49437,46717,96154,25740
2567,63,ตาก,6306,อำเภอแม่สอด,39179,39597,78776,53030,51965,104995,40494
2567,63,ตาก,6307,อำเภอพบพระ,31639,30920,62559,47042,45272,92314,22051
2567,63,ตาก,6308,อำเภออุ้มผาง,16766,15728,32494,24541,22687,47228,12341
2567,63,ตาก,6309,อำเภอวังเจ้า,14772,14660,29432,15328,15221,30549,9746
2567,63,ตาก,6386,ท้องถิ่นเทศบาลตำบลไม้งาม,6240,5173,11413,6259,5190,11449,6594
2567,63,ตาก,6387,ท้องถิ่นเทศบาลตำบลวังเจ้า,2087,2082,4169,2090,2086,4176,2012
2567,63,ตาก,6388,ท้องถิ่นเทศบาลตำบลอุ้มผาง,816,809,1625,2573,2405,4978,950
2567,63,ตาก,6389,ท้องถิ่นเทศบาลตำบลพบพระ,2453,2355,4808,3668,3468,7136,3002
2567,63,ตาก,6390,ท้องถิ่นเทศบาลตำบลแม่กุ,3118,3278,6396,3244,3399,6643,3269
2567,63,ตาก,6391,ท้องถิ่นเทศบาลตำบลท่าสายลวด,3108,3105,6213,12320,11635,23955,5075
2567,63,ตาก,6392,ท้องถิ่นเทศบาลตำบลแม่ต้าน,1302,1355,2657,2276,2333,4609,1467
2567,63,ตาก,6393,ท้องถิ่นเทศบาลตำบลแม่ระมาด,1752,1790,3542,1896,1928,3824,1912
2567,63,ตาก,6394,ท้องถิ่นเทศบาลตำบลแม่จะเรา,2385,2538,4923,2442,2596,5038,2206
2567,63,ตาก,6395,ท้องถิ่นเทศบาลตำบลสามเงา,2057,2290,4347,2067,2292,4359,2223
2567,63,ตาก,6396,ท้องถิ่นเทศบาลตำบลบ้านตาก,2837,3362,6199,2859,3379,6238,2772
2567,63,ตาก,6397,ท้องถิ่นเทศบาลตำบลทุ่งกระเชาะ,2899,2957,5856,2902,2964,5866,2183
2567,63,ตาก,6398,ท้องถิ่นเทศบาลนครแม่สอด,12437,13532,25969,21349,21525,42874,20802
2567,63,ตาก,6399,ท้องถิ่นเทศบาลเมืองตาก,6897,7850,14747,7065,7993,15058,7599
2567,64,สุโขทัย,6401,อำเภอเมืองสุโขทัย,28798,31117,59915,28840,31136,59976,23787
2567,64,สุโขทัย,6402,อำเภอบ้านด่านลานหอย,21757,22075,43832,21876,22173,44049,15097
2567,64,สุโขทัย,6403,อำเภอคีรีมาศ,22474,23055,45529,22494,23070,45564,14916
2567,64,สุโขทัย,6404,อำเภอกงไกรลาศ,28241,29812,58053,28261,29822,58083,21194
2567,64,สุโขทัย,6405,อำเภอศรีสัชนาลัย,33708,35053,68761,33764,35097,68861,27910
2567,64,สุโขทัย,6406,อำเภอศรีสำโรง,28696,31184,59880,28734,31204,59938,23244
2567,64,สุโขทัย,6407,อำเภอสวรรคโลก,23503,25640,49143,23522,25651,49173,20740
2567,64,สุโขทัย,6408,อำเภอศรีนคร,10582,11298,21880,10601,11306,21907,8404
2567,64,สุโขทัย,6409,อำเภอทุ่งเสลี่ยม,20130,20775,40905,20175,20797,40972,15441
2567,64,สุโขทัย,6484,ท้องถิ่นเทศบาลตำบลในเมือง,3942,4133,8075,3946,4136,8082,3514
2567,64,สุโขทัย,6485,ท้องถิ่นเทศบาลตำบลป่ากุมเกาะ,3625,3899,7524,3627,3902,7529,2861
2567,64,สุโขทัย,6486,ท้องถิ่นเทศบาลตำบลบ้านกล้วย,7385,8331,15716,7396,8346,15742,7465
2567,64,สุโขทัย,6487,ท้องถิ่นเทศบาลตำบลทุ่งเสลี่ยม,3325,3679,7004,3334,3687,7021,3106
2567,64,สุโขทัย,6488,ท้องถิ่นเทศบาลตำบลศรีนคร,1378,1587,2965,1383,1591,2974,1724
2567,64,สุโขทัย,6489,ท้องถิ่นเทศบาลตำบลศรีสำโรง,3271,3797,7068,3280,3802,7082,3614
2567,64,สุโขทัย,6490,ท้องถิ่นเทศบาลตำบลหาดเสี้ยว,2952,3330,6282,2955,3335,6290,3722
2567,64,สุโขทัย,6491,ท้องถิ่นเทศบาลเมืองศรีสัชนาลัย,6960,7617,14577,6961,7619,14580,5984
2567,64,สุโขทัย,6492,ท้องถิ่นเทศบาลตำบลกงไกรลาศ,1876,2087,3963,1877,2088,3965,2090
2567,64,สุโขทัย,6493,ท้องถิ่นเทศบาลตำบลบ้านโตนด,1371,1551,2922,1375,1551,2926,1685
2567,64,สุโขทัย,6494,ท้องถิ่นเทศบาลตำบลทุ่งหลวง,3275,3626,6901,3277,3626,6903,2472
2567,64,สุโขทัย,6495,ท้องถิ่นเทศบาลตำบลลานหอย,1638,1790,3428,1645,1792,3437,1761
2567,64,สุโขทัย,6496,ท้องถิ่นเทศบาลตำบลเมืองเก่า,3232,3783,7015,3238,3783,7021,2721
2567,64,สุโขทัย,6497,ท้องถิ่นเทศบาลตำบลบ้านสวน,1925,2148,4073,1927,2151,4078,1735
2567,64,สุโขทัย,6498,ท้องถิ่นเทศบาลเมืองสวรรคโลก,6485,7385,13870,6506,7398,13904,6855
2567,64,สุโขทัย,6499,ท้องถิ่นเทศบาลเมืองสุโขทัยธานี,6157,7137,13294,6185,7146,13331,7193
2567,65,พิษณุโลก,6501,อำเภอเมืองพิษณุโลก,87543,94255,181798,87748,94344,182092,92279
2567,65,พิษณุโลก,6502,อำเภอนครไทย,32727,33240,65967,32799,33301,66100,24693
2567,65,พิษณุโลก,6503,อำเภอชาติตระการ,18249,17941,36190,18303,17984,36287,12891
2567,65,พิษณุโลก,6504,อำเภอบางระกำ,36032,37370,73402,36094,37438,73532,27265
2567,65,พิษณุโลก,6505,อำเภอบางกระทุ่ม,15490,16415,31905,15503,16434,31937,12352
2567,65,พิษณุโลก,6506,อำเภอพรหมพิราม,38549,40713,79262,38585,40733,79318,31721
2567,65,พิษณุโลก,6507,อำเภอวัดโบสถ์,14329,14671,29000,14342,14685,29027,11675
2567,65,พิษณุโลก,6508,อำเภอวังทอง,55641,57352,112993,55920,57530,113450,45986
2567,65,พิษณุโลก,6509,อำเภอเนินมะปราง,18835,19066,37901,18860,19082,37942,15431
2567,65,พิษณุโลก,6580,ท้องถิ่นเทศบาลเมืองอรัญญิก,15872,13338,29210,15918,13364,29282,14707
2567,65,พิษณุโลก,6581,ท้องถิ่นเทศบาลตำบลบ้านมุง,3385,3442,6827,3395,3447,6842,2773
2567,65,พิษณุโลก,6582,ท้องถิ่นเทศบาลตำบลบึงระมาณ,2112,2255,4367,2115,2259,4374,1733
2567,65,พิษณุโลก,6583,ท้องถิ่นเทศบาลตำบลพลายชุมพล,3785,4272,8057,3796,4276,8072,4608
2567,65,พิษณุโลก,6584,ท้องถิ่นเทศบาลตำบลพันเสา,2950,3020,5970,2955,3023,5978,2159
2567,65,พิษณุโลก,6585,ท้องถิ่นเทศบาลตำบลไทรย้อย,4081,4212,8293,4089,4213,8302,3282
2567,65,พิษณุโลก,6586,ท้องถิ่นเทศบาลตำบลบ้านแยง,5100,4977,10077,5130,5002,10132,4971
2567,65,พิษณุโลก,6587,ท้องถิ่นเทศบาลตำบลเนินมะปราง,1610,1777,3387,1620,1778,3398,1704
2567,65,พิษณุโลก,6588,ท้องถิ่นเทศบาลตำบลวังทอง,1847,2136,3983,1852,2139,3991,1751
2567,65,พิษณุโลก,6589,ท้องถิ่นเทศบาลตำบลวัดโบสถ์,3680,4135,7815,3688,4138,7826,4216
2567,65,พิษณุโลก,6590,ท้องถิ่นเทศบาลตำบลวงฆ้อง,1468,1533,3001,1472,1534,3006,1600
2567,65,พิษณุโลก,6591,ท้องถิ่นเทศบาลตำบลพรหมพิราม,494,600,1094,500,603,1103,556
2567,65,พิษณุโลก,6592,ท้องถิ่นเทศบาลตำบลบางกระทุ่ม,744,769,1513,747,770,1517,625
2567,65,พิษณุโลก,6593,ท้องถิ่นเทศบาลตำบลเนินกุ่ม,5580,5876,11456,5591,5878,11469,4699
2567,65,พิษณุโลก,6594,ท้องถิ่นเทศบาลตำบลปลักแรด,1650,1812,3462,1653,1813,3466,1361
2567,65,พิษณุโลก,6595,ท้องถิ่นเทศบาลตำบลบางระกำ,1887,2114,4001,1891,2117,4008,2041
2567,65,พิษณุโลก,6596,ท้องถิ่นเทศบาลตำบลป่าแดง,2542,2708,5250,2546,2712,5258,2690
2567,65,พิษณุโลก,6597,ท้องถิ่นเทศบาลตำบลนครไทย,4180,4496,8676,4195,4501,8696,4202
2567,65,พิษณุโลก,6598,ท้องถิ่นเทศบาลตำบลบ้านใหม่,892,988,1880,894,990,1884,827
2567,65,พิษณุโลก,6599,ท้องถิ่นเทศบาลนครพิษณุโลก,27206,33301,60507,27395,33432,60827,37942
2567,66,พิจิตร,6601,อำเภอเมืองพิจิตร,34833,37216,72049,34873,37236,72109,27851
2567,66,พิจิตร,6602,อำเภอวังทรายพูน,8355,8626,16981,8362,8635,16997,6110
2567,66,พิจิตร,6603,อำเภอโพธิ์ประทับช้าง,16580,17047,33627,16603,17065,33668,12035
2567,66,พิจิตร,6604,อำเภอตะพานหิน,21170,22424,43594,21200,22435,43635,16534
2567,66,พิจิตร,6605,อำเภอบางมูลนาก,9551,10259,19810,9561,10267,19828,8198
2567,66,พิจิตร,6606,อำเภอโพทะเล,26090,27275,53365,26120,27296,53416,19461
2567,66,พิจิตร,6607,อำเภอสามง่าม,12431,12752,25183,12436,12757,25193,9050
2567,66,พิจิตร,6608,อำเภอทับคล้อ,16141,16761,32902,16149,16770,32919,13175
2567,66,พิจิตร,6609,อำเภอสากเหล็ก,8716,8843,17559,8724,8850,17574,6349
2567,66,พิจิตร,6610,อำเภอบึงนาราง,13955,14570,28525,13972,14588,28560,11128
2567,66,พิจิตร,6611,อำเภอดงเจริญ,8231,8515,16746,8248,8524,16772,6604
2567,66,พิจิตร,6612,อำเภอวชิรบารมี,15129,15511,30640,15139,15524,30663,11520
2567,66,พิจิตร,6676,ท้องถิ่นเทศบาลตำบลหนองพยอม,3278,3442,6720,3280,3442,6722,2419
2567,66,พิจิตร,6677,ท้องถิ่นเทศบาลตำบลหนองปล้อง,1641,1694,3335,1641,1694,3335,1192
2567,66,พิจิตร,6678,ท้องถิ่นเทศบาลตำบลเนินมะกอก,3166,3470,6636,3173,3486,6659,3145
2567,66,พิจิตร,6679,ท้องถิ่นเทศบาลตำบลหอไกร,2802,2979,5781,2811,2991,5802,2787
2567,66,พิจิตร,6680,ท้องถิ่นเทศบาลตำบลดงป่าคำ,2280,2372,4652,2281,2372,4653,1656
2567,66,พิจิตร,6681,ท้องถิ่นเทศบาลตำบลเนินปอ,4457,4519,8976,4458,4521,8979,3230
2567,66,พิจิตร,6682,ท้องถิ่นเทศบาลตำบลสำนักขุนเณร,1055,1064,2119,1057,1069,2126,934
2567,66,พิจิตร,6683,ท้องถิ่นเทศบาลตำบลสากเหล็ก,2447,2697,5144,2450,2700,5150,2464
2567,66,พิจิตร,6684,ท้องถิ่นเทศบาลตำบลทับคล้อ,1926,2100,4026,1931,2103,4034,1810
2567,66,พิจิตร,6685,ท้องถิ่นเทศบาลตำบลเขาทราย,2018,2070,4088,2019,2072,4091,1945
2567,66,พิจิตร,6686,ท้องถิ่นเทศบาลตำบลสามง่าม,2114,2443,4557,2115,2444,4559,2293
2567,66,พิจิตร,6687,ท้องถิ่นเทศบาลตำบลกำแพงดิน,1009,1095,2104,1010,1097,2107,833
2567,66,พิจิตร,6688,ท้องถิ่นเทศบาลตำบลโพทะเล,1115,1199,2314,1118,1200,2318,1041
2567,66,พิจิตร,6689,ท้องถิ่นเทศบาลตำบลท่าเสา,739,719,1458,739,719,1458,538
2567,66,พิจิตร,6690,ท้องถิ่นเทศบาลตำบลวังตะกู,771,769,1540,778,771,1549,660
2567,66,พิจิตร,6691,ท้องถิ่นเทศบาลตำบลบางไผ่,696,758,1454,696,761,1457,651
2567,66,พิจิตร,6692,ท้องถิ่นเทศบาลตำบลโพธิ์ประทับช้าง,4276,4542,8818,4288,4553,8841,3671
2567,66,พิจิตร,6693,ท้องถิ่นเทศบาลตำบลวังทรายพูน,1572,1627,3199,1573,1629,3202,1303
2567,66,พิจิตร,6694,ท้องถิ่นเทศบาลตำบลหัวดง,1423,1531,2954,1432,1535,2967,1220
2567,66,พิจิตร,6695,ท้องถิ่นเทศบาลตำบลวังกรด,1417,1459,2876,1419,1462,2881,1077
2567,66,พิจิตร,6696,ท้องถิ่นเทศบาลตำบลท่าฬ่อ,1487,1621,3108,1489,1625,3114,1232
2567,66,พิจิตร,6697,ท้องถิ่นเทศบาลเมืองบางมูลนาก,3482,3920,7402,3495,3924,7419,3736
2567,66,พิจิตร,6698,ท้องถิ่นเทศบาลเมืองตะพานหิน,5738,6651,12389,5767,6674,12441,6387
2567,66,พิจิตร,6699,ท้องถิ่นเทศบาลเมืองพิจิตร,9325,10697,20022,9380,10730,20110,12727
2567,67,เพชรบูรณ์,6701,อำเภอเมืองเพชรบูรณ์,78070,78873,156943,78298,78940,157238,65186
2567,67,เพชรบูรณ์,6702,อำเภอชนแดน,33153,33420,66573,33181,33447,66628,28853
2567,67,เพชรบูรณ์,6703,อำเภอหล่มสัก,68762,72827,141589,68898,72868,141766,51250
2567,67,เพชรบูรณ์,6704,อำเภอหล่มเก่า,28516,30047,58563,28559,30087,58646,19775
2567,67,เพชรบูรณ์,6705,อำเภอวิเชียรบุรี,48476,49876,98352,48551,49903,98454,34906
2567,67,เพชรบูรณ์,6706,อำเภอศรีเทพ,27659,28193,55852,27699,28225,55924,20467
2567,67,เพชรบูรณ์,6707,อำเภอหนองไผ่,36826,37488,74314,36867,37520,74387,26138
2567,67,เพชรบูรณ์,6708,อำเภอบึงสามพัน,30527,31267,61794,30585,31299,61884,26852
2567,67,เพชรบูรณ์,6709,อำเภอน้ำหนาว,9461,9131,18592,9472,9136,18608,7610
2567,67,เพชรบูรณ์,6710,อำเภอวังโป่ง,13713,14031,27744,13723,14042,27765,9636
2567,67,เพชรบูรณ์,6711,อำเภอเขาค้อ,17996,17927,35923,18245,18203,36448,13251
2567,67,เพชรบูรณ์,6778,ท้องถิ่นเทศบาลตำบลแคมป์สน,2552,2789,5341,2565,2792,5357,3336
2567,67,เพชรบูรณ์,6779,ท้องถิ่นเทศบาลตำบลโคกสะอาด,3170,3219,6389,3172,3222,6394,2250
2567,67,เพชรบูรณ์,6780,ท้องถิ่นเทศบาลตำบลบัววัฒนา,2873,2867,5740,2874,2867,5741,1955
2567,67,เพชรบูรณ์,6781,ท้องถิ่นเทศบาลตำบลบ่อไทย,4601,4779,9380,4614,4798,9412,3126
2567,67,เพชรบูรณ์,6782,ท้องถิ่นเทศบาลตำบลนางั่ว,5897,6707,12604,5971,6711,12682,5901
2567,67,เพชรบูรณ์,6783,ท้องถิ่นเทศบาลตำบลเฉลียงทอง,3628,3690,7318,3636,3693,7329,2659
2567,67,เพชรบูรณ์,6784,ท้องถิ่นเทศบาลตำบลวังโป่ง,1767,1989,3756,1769,1992,3761,1570
2567,67,เพชรบูรณ์,6785,ท้องถิ่นเทศบาลตำบลท้ายดง,1564,1695,3259,1565,1698,3263,1108
2567,67,เพชรบูรณ์,6786,ท้องถิ่นเทศบาลตำบลซับสมอทอด,3955,4201,8156,3996,4242,8238,5186
2567,67,เพชรบูรณ์,6787,ท้องถิ่นเทศบาลตำบลหนองไผ่,3275,3649,6924,3284,3656,6940,3906
2567,67,เพชรบูรณ์,6788,ท้องถิ่นเทศบาลตำบลนาเฉลียง,1891,2135,4026,1897,2137,4034,1781
2567,67,เพชรบูรณ์,6789,ท้องถิ่นเทศบาลตำบลสว่างวัฒนา,3009,3330,6339,3016,3331,6347,3004
2567,67,เพชรบูรณ์,6790,ท้องถิ่นเทศบาลเมืองวิเชียรบุรี,10151,11307,21458,10253,11339,21592,9093
2567,67,เพชรบูรณ์,6791,ท้องถิ่นเทศบาลตำบลพุเตย,3415,3579,6994,3426,3580,7006,3080
2567,67,เพชรบูรณ์,6792,ท้องถิ่นเทศบาลตำบลหล่มเก่า,2584,2919,5503,2589,2919,5508,2697
2567,67,เพชรบูรณ์,6793,ท้องถิ่นเทศบาลตำบลท่าข้าม,1190,1186,2376,1192,1188,2380,1001
2567,67,เพชรบูรณ์,6794,ท้องถิ่นเทศบาลตำบลดงขุย,1144,1288,2432,1146,1288,2434,1087
2567,67,เพชรบูรณ์,6795,ท้องถิ่นเทศบาลตำบลชนแดน,1720,1647,3367,1727,1649,3376,1867
2567,67,เพชรบูรณ์,6796,ท้องถิ่นเทศบาลตำบลวังชมภู,1527,1756,3283,1536,1760,3296,1355
2567,67,เพชรบูรณ์,6797,ท้องถิ่นเทศบาลตำบลท่าพล,3486,3850,7336,3501,3858,7359,2653
2567,67,เพชรบูรณ์,6798,ท้องถิ่นเทศบาลเมืองหล่มสัก,5127,5767,10894,5153,5783,10936,6740
2567,67,เพชรบูรณ์,6799,ท้องถิ่นเทศบาลเมืองเพชรบูรณ์,9066,10460,19526,9107,10478,19585,12945
2567,70,ราชบุรี,7001,อำเภอเมืองราชบุรี,59431,63331,122762,60153,63962,124115,52162
2567,70,ราชบุรี,7002,อำเภอจอมบึง,28443,29421,57864,28696,29645,58341,20865
2567,70,ราชบุรี,7003,อำเภอสวนผึ้ง,15498,14899,30397,25022,23126,48148,15578
2567,70,ราชบุรี,7004,อำเภอดำเนินสะดวก,34588,37095,71683,34870,37345,72215,24547
2567,70,ราชบุรี,7005,อำเภอบ้านโป่ง,46053,50175,96228,46318,50415,96733,39680
2567,70,ราชบุรี,7006,อำเภอบางแพ,8387,9176,17563,8438,9222,17660,6927
2567,70,ราชบุรี,7007,อำเภอโพธาราม,34285,36614,70899,34461,36798,71259,27161
2567,70,ราชบุรี,7008,อำเภอปากท่อ,25000,25620,50620,25565,26158,51723,19939
2567,70,ราชบุรี,7009,อำเภอวัดเพลง,5060,5586,10646,5071,5598,10669,3836
2567,70,ราชบุรี,7010,อำเภอบ้านคา,12092,11781,23873,12777,12288,25065,10157
2567,70,ราชบุรี,7070,ท้องถิ่นเทศบาลตำบลดอนทราย,3266,3667,6933,3322,3706,7028,3366
2567,70,ราชบุรี,7071,ท้องถิ่นเทศบาลตำบลหลุมดิน,2516,2659,5175,2534,2675,5209,2007
2567,70,ราชบุรี,7072,ท้องถิ่นเทศบาลตำบลเบิกไพร,7627,8689,16316,7654,8712,16366,7156
2567,70,ราชบุรี,7073,ท้องถิ่นเทศบาลตำบลทุ่งหลวง,6840,6995,13835,6903,7043,13946,4712
2567,70,ราชบุรี,7074,ท้องถิ่นเทศบาลตำบลบ้านฆ้อง,4086,4611,8697,4122,4646,8768,3860
2567,70,ราชบุรี,7075,ท้องถิ่นเทศบาลตำบลกรับใหญ่,6120,6691,12811,6154,6710,12864,4138
2567,70,ราชบุรี,7076,ท้องถิ่นเทศบาลตำบลบ้านสิงห์,5651,6267,11918,5694,6309,12003,4825
2567,70,ราชบุรี,7077,ท้องถิ่นเทศบาลตำบลวัดเพลง,625,694,1319,633,704,1337,569
2567,70,ราชบุรี,7078,ท้องถิ่นเทศบาลตำบลปากท่อ,1296,1392,2688,1305,1394,2699,1449
2567,70,ราชบุรี,7079,ท้องถิ่นเทศบาลตำบลหนองโพ,1734,2015,3749,1740,2025,3765,2282
2567,70,ราชบุรี,7080,ท้องถิ่นเทศบาลตำบลบ้านเลือก,5257,5806,11063,5287,5840,11127,5599
2567,70,ราชบุรี,7081,ท้องถิ่นเทศบาลตำบลเจ็ดเสมียน,2721,2999,5720,2752,3044,5796,2484
2567,70,ราชบุรี,7082,ท้องถิ่นเทศบาลตำบลเขาขวาง,3520,3754,7274,3528,3763,7291,2763
2567,70,ราชบุรี,7083,ท้องถิ่นเทศบาลตำบลโพหัก,5011,5346,10357,5028,5360,10388,3893
2567,70,ราชบุรี,7084,ท้องถิ่นเทศบาลตำบลบางแพ,7476,8261,15737,7546,8316,15862,6970
2567,70,ราชบุรี,7085,ท้องถิ่นเทศบาลตำบลห้วยกระบอก,770,808,1578,781,814,1595,750
2567,70,ราชบุรี,7086,ท้องถิ่นเทศบาลเมืองท่าผา,9562,10282,19844,9616,10326,19942,8822
2567,70,ราชบุรี,7087,ท้องถิ่นเทศบาลตำบลกระจับ,3633,4045,7678,3695,4087,7782,4028
2567,70,ราชบุรี,7088,ท้องถิ่นเทศบาลตำบลศรีดอนไผ่,4837,5379,10216,4870,5400,10270,3637
2567,70,ราชบุรี,7089,ท้องถิ่นเทศบาลตำบลดำเนินสะดวก,3188,3657,6845,3204,3670,6874,3361
2567,70,ราชบุรี,7090,ท้องถิ่นเทศบาลตำบลสวนผึ้ง,1691,1696,3387,1733,1730,3463,1934
2567,70,ราชบุรี,7091,ท้องถิ่นเทศบาลตำบลบ้านชัฏป่าหวาย,1816,1846,3662,1897,1901,3798,2012
2567,70,ราชบุรี,7092,ท้องถิ่นเทศบาลตำบลด่านทับตะโก,1247,1220,2467,1249,1223,2472,862
2567,70,ราชบุรี,7093,ท้องถิ่นเทศบาลตำบลจอมบึง,2202,2531,4733,2207,2536,4743,3798
2567,70,ราชบุรี,7094,ท้องถิ่นเทศบาลตำบลห้วยชินสีห์,5270,5718,10988,5301,5761,11062,4694
2567,70,ราชบุรี,7095,ท้องถิ่นเทศบาลตำบลหลักเมือง,8882,8040,16922,8940,8092,17032,7609
2567,70,ราชบุรี,7096,ท้องถิ่นเทศบาลตำบลเขางู,4380,4905,9285,4401,4930,9331,3450
2567,70,ราชบุรี,7097,ท้องถิ่นเทศบาลเมืองโพธาราม,3576,3979,7555,3770,4178,7948,3801
2567,70,ราชบุรี,7098,ท้องถิ่นเทศบาลเมืองบ้านโป่ง,6520,7568,14088,6807,7837,14644,8367
2567,70,ราชบุรี,7099,ท้องถิ่นเทศบาลเมืองราชบุรี,14301,17228,31529,14903,17801,32704,16668
2567,71,กาญจนบุรี,7101,อำเภอเมืองกาญจนบุรี,50556,41596,92152,53705,43933,97638,41020
2567,71,กาญจนบุรี,7102,อำเภอไทรโยค,22171,21791,43962,31203,29496,60699,21755
2567,71,กาญจนบุรี,7103,อำเภอบ่อพลอย,23937,24163,48100,24053,24276,48329,19491
2567,71,กาญจนบุรี,7104,อำเภอศรีสวัสดิ์,12219,11684,23903,13294,12550,25844,10672
2567,71,กาญจนบุรี,7105,อำเภอท่ามะกา,43491,46438,89929,43866,46774,90640,33417
2567,71,กาญจนบุรี,7106,อำเภอท่าม่วง,28022,29984,58006,28199,30128,58327,25626
2567,71,กาญจนบุรี,7107,อำเภอทองผาภูมิ,22051,20652,42703,35360,32903,68263,28793
2567,71,กาญจนบุรี,7108,อำเภอสังขละบุรี,11464,10849,22313,23025,21665,44690,12951
2567,71,กาญจนบุรี,7109,อำเภอพนมทวน,15649,16697,32346,15680,16736,32416,11959
2567,71,กาญจนบุรี,7110,อำเภอเลาขวัญ,26636,26946,53582,26726,27010,53736,19798
2567,71,กาญจนบุรี,7111,อำเภอด่านมะขามเตี้ย,15479,15658,31137,15566,15737,31303,11387
2567,71,กาญจนบุรี,7112,อำเภอหนองปรือ,13738,13432,27170,13847,13510,27357,10106
2567,71,กาญจนบุรี,7113,อำเภอห้วยกระเจา,16634,17382,34016,16684,17414,34098,12599
2567,71,กาญจนบุรี,7167,ท้องถิ่นเทศบาลตำบลรางหวาย,3560,3584,7144,3576,3593,7169,2701
2567,71,กาญจนบุรี,7168,ท้องถิ่นเทศบาลตำบลหนองสาหร่าย,1711,1936,3647,1727,1940,3667,1261
2567,71,กาญจนบุรี,7169,ท้องถิ่นเทศบาลเมืองปากแพรก,13271,14923,28194,13488,15102,28590,17024
2567,71,กาญจนบุรี,7170,ท้องถิ่นเทศบาลตำบลวังศาลา,5680,6039,11719,5707,6074,11781,5465
2567,71,กาญจนบุรี,7171,ท้องถิ่นเทศบาลตำบลท่าล้อ,4309,4844,9153,4357,4873,9230,4148
2567,71,กาญจนบุรี,7172,ท้องถิ่นเทศบาลตำบลวังขนาย,4364,4905,9269,4399,4932,9331,4092
2567,71,กาญจนบุรี,7173,ท้องถิ่นเทศบาลตำบลหนองปรือ,2101,2262,4363,2107,2268,4375,1899
2567,71,กาญจนบุรี,7174,ท้องถิ่นเทศบาลตำบลด่านมะขามเตี้ย,1149,1228,2377,1185,1248,2433,1333
2567,71,กาญจนบุรี,7175,ท้องถิ่นเทศบาลตำบลหนองฝ้าย,1001,1118,2119,1046,1157,2203,978
2567,71,กาญจนบุรี,7176,ท้องถิ่นเทศบาลตำบลเลาขวัญ,1310,1330,2640,1317,1331,2648,1409
2567,71,กาญจนบุรี,7177,ท้องถิ่นเทศบาลตำบลตลาดเขต,1860,2101,3961,1872,2113,3985,1879
2567,71,กาญจนบุรี,7178,ท้องถิ่นเทศบาลตำบลพนมทวน,2346,2669,5015,2389,2693,5082,2286
2567,71,กาญจนบุรี,7179,ท้องถิ่นเทศบาลตำบลวังกะ,3598,3452,7050,4974,4795,9769,2731
2567,71,กาญจนบุรี,7180,ท้องถิ่นเทศบาลตำบลทองผาภูมิ,1370,1348,2718,1547,1505,3052,1633
2567,71,กาญจนบุรี,7181,ท้องถิ่นเทศบาลตำบลหนองตากยา,1484,1553,3037,1488,1557,3045,1015
2567,71,กาญจนบุรี,7182,ท้องถิ่นเทศบาลตำบลหนองขาว,2283,2556,4839,2297,2560,4857,1637
2567,71,กาญจนบุรี,7183,ท้องถิ่นเทศบาลตำบลสำรอง,863,904,1767,872,906,1778,669
2567,71,กาญจนบุรี,7184,ท้องถิ่นเทศบาลตำบลท่าม่วง,4188,4942,9130,4305,5046,9351,5595
2567,71,กาญจนบุรี,7185,ท้องถิ่นเทศบาลตำบลหวายเหนียว,2088,2252,4340,2116,2273,4389,2056
2567,71,กาญจนบุรี,7186,ท้องถิ่นเทศบาลตำบลพระแท่น,2936,3238,6174,2949,3246,6195,2327
2567,71,กาญจนบุรี,7187,ท้องถิ่นเทศบาลตำบลท่าไม้,4235,4613,8848,4259,4625,8884,4014
2567,71,กาญจนบุรี,7188,ท้องถิ่นเทศบาลตำบลท่ามะกา,3304,3920,7224,3713,4314,8027,4803
2567,71,กาญจนบุรี,7189,ท้องถิ่นเทศบาลตำบลลูกแก,1524,1778,3302,1526,1779,3305,1530
2567,71,กาญจนบุรี,7190,ท้องถิ่นเทศบาลตำบลเอราวัณ,482,531,1013,482,531,1013,727
2567,71,กาญจนบุรี,7191,ท้องถิ่นเทศบาลตำบลหนองรี,1040,1113,2153,1042,1113,2155,856
2567,71,กาญจนบุรี,7192,ท้องถิ่นเทศบาลตำบลบ่อพลอย,3260,3315,6575,3327,3365,6692,2844
2567,71,กาญจนบุรี,7193,ท้องถิ่นเทศบาลตำบลวังโพธิ์,924,950,1874,1069,1051,2120,925
2567,71,กาญจนบุรี,7194,ท้องถิ่นเทศบาลตำบลน้ำตกไทรโยคน้อย,1903,1957,3860,1933,1981,3914,1726
2567,71,กาญจนบุรี,7195,ท้องถิ่นเทศบาลตำบลหนองบัว,3333,3742,7075,3355,3765,7120,3399
2567,71,กาญจนบุรี,7196,ท้องถิ่นเทศบาลตำบลลาดหญ้า,2587,2802,5389,2599,2814,5413,2480
2567,71,กาญจนบุรี,7197,ท้องถิ่นเทศบาลตำบลแก่งเสี้ยน,3007,3404,6411,3029,3428,6457,3967
2567,71,กาญจนบุรี,7198,ท้องถิ่นเทศบาลเมืองท่าเรือพระแท่น,4855,5404,10259,4904,5453,10357,5177
2567,71,กาญจนบุรี,7199,ท้องถิ่นเทศบาลเมืองกาญจนบุรี,11245,12929,24174,11489,13135,24624,16184
2567,72,สุพรรณบุรี,7201,อำเภอเมืองสุพรรณบุรี,50316,56170,106486,50456,56290,106746,40705
2567,72,สุพรรณบุรี,7202,อำเภอเดิมบางนางบวช,19524,20938,40462,19559,20966,40525,15842
2567,72,สุพรรณบุรี,7203,อำเภอด่านช้าง,30093,30868,60961,30223,30947,61170,24388
2567,72,สุพรรณบุรี,7204,อำเภอบางปลาม้า,27765,29136,56901,27813,29197,57010,20334
2567,72,สุพรรณบุรี,7205,อำเภอศรีประจันต์,18776,20575,39351,18804,20602,39406,15689
2567,72,สุพรรณบุรี,7206,อำเภอดอนเจดีย์,19285,20856,40141,19315,20878,40193,15607
2567,72,สุพรรณบุรี,7207,อำเภอสองพี่น้อง,53150,55437,108587,53361,55629,108990,37714
2567,72,สุพรรณบุรี,7208,อำเภอสามชุก,18608,20224,38832,18647,20253,38900,15603
2567,72,สุพรรณบุรี,7209,อำเภออู่ทอง,31233,33151,64384,31338,33245,64583,22947
2567,72,สุพรรณบุรี,7210,อำเภอหนองหญ้าไซ,22579,23724,46303,22593,23740,46333,17555
2567,72,สุพรรณบุรี,7265,ท้องถิ่นเทศบาลตำบลปากน้ำ,2098,2300,4398,2099,2302,4401,1828
2567,72,สุพรรณบุรี,7266,ท้องถิ่นเทศบาลตำบลท้าวอู่ทอง,7569,8015,15584,7595,8031,15626,6169
2567,72,สุพรรณบุรี,7267,ท้องถิ่นเทศบาลตำบลกระจัน,3563,3730,7293,3568,3733,7301,2042
2567,72,สุพรรณบุรี,7268,ท้องถิ่นเทศบาลตำบลบ้านโข้ง,4421,4526,8947,4428,4535,8963,3526
2567,72,สุพรรณบุรี,7269,ท้องถิ่นเทศบาลตำบลเดิมบาง,3095,3537,6632,3097,3544,6641,2939
2567,72,สุพรรณบุรี,7270,ท้องถิ่นเทศบาลตำบลบางกุ้ง,894,959,1853,900,961,1861,599
2567,72,สุพรรณบุรี,7271,ท้องถิ่นเทศบาลตำบลท่าระหัด,4230,5028,9258,4251,5046,9297,5656
2567,72,สุพรรณบุรี,7272,ท้องถิ่นเทศบาลตำบลตะค่า,2597,2794,5391,2600,2798,5398,1981
2567,72,สุพรรณบุรี,7273,ท้องถิ่นเทศบาลตำบลบ้านดอน,3610,3841,7451,3612,3847,7459,2116
2567,72,สุพรรณบุรี,7274,ท้องถิ่นเทศบาลตำบลต้นคราม,2512,2738,5250,2532,2756,5288,2107
2567,72,สุพรรณบุรี,7275,ท้องถิ่นเทศบาลตำบลปลายนา,3877,4240,8117,3878,4244,8122,2994
2567,72,สุพรรณบุรี,7276,ท้องถิ่นเทศบาลตำบลขุนพัดเพ็ง,2607,2657,5264,2617,2662,5279,1991
2567,72,สุพรรณบุรี,7277,ท้องถิ่นเทศบาลตำบลวังยาง,3201,3561,6762,3209,3568,6777,2877
2567,72,สุพรรณบุรี,7278,ท้องถิ่นเทศบาลตำบลเขาดิน,2893,3081,5974,2896,3082,5978,2140
2567,72,สุพรรณบุรี,7279,ท้องถิ่นเทศบาลตำบลหนองหญ้าไซ,1103,1257,2360,1103,1257,2360,1166
2567,72,สุพรรณบุรี,7280,ท้องถิ่นเทศบาลตำบลอู่ทอง,3399,3827,7226,3414,3839,7253,3699
2567,72,สุพรรณบุรี,7281,ท้องถิ่นเทศบาลตำบลสระยายโสม,1272,1437,2709,1280,1440,2720,1083
2567,72,สุพรรณบุรี,7282,ท้องถิ่นเทศบาลตำบลสามชุก,5706,6509,12215,5723,6521,12244,6947
2567,72,สุพรรณบุรี,7283,ท้องถิ่นเทศบาลตำบลทุ่งคอก,1491,1756,3247,1507,1770,3277,1336
2567,72,สุพรรณบุรี,7284,ท้องถิ่นเทศบาลตำบลสระกระโจม,1184,1158,2342,1187,1160,2347,1074
2567,72,สุพรรณบุรี,7285,ท้องถิ่นเทศบาลตำบลดอนเจดีย์,1333,1453,2786,1370,1487,2857,1425
2567,72,สุพรรณบุรี,7286,ท้องถิ่นเทศบาลตำบลศรีประจันต์,2539,2868,5407,2557,2878,5435,2699
2567,72,สุพรรณบุรี,7287,ท้องถิ่นเทศบาลตำบลไผ่กองดิน,808,855,1663,808,861,1669,619
2567,72,สุพรรณบุรี,7288,ท้องถิ่นเทศบาลตำบลบ้านแหลม,570,567,1137,571,569,1140,461
2567,72,สุพรรณบุรี,7289,ท้องถิ่นเทศบาลตำบลบางปลาม้า,846,909,1755,880,913,1793,693
2567,72,สุพรรณบุรี,7290,ท้องถิ่นเทศบาลตำบลโคกคราม,702,756,1458,709,758,1467,902
2567,72,สุพรรณบุรี,7291,ท้องถิ่นเทศบาลตำบลด่านช้าง,2569,2939,5508,2592,2956,5548,3456
2567,72,สุพรรณบุรี,7292,ท้องถิ่นเทศบาลตำบลบ่อกรุ,891,1031,1922,892,1031,1923,788
2567,72,สุพรรณบุรี,7293,ท้องถิ่นเทศบาลตำบลนางบวช,2029,2152,4181,2030,2156,4186,1721
2567,72,สุพรรณบุรี,7294,ท้องถิ่นเทศบาลตำบลเขาพระ,2469,2897,5366,2495,2918,5413,3334
2567,72,สุพรรณบุรี,7295,ท้องถิ่นเทศบาลตำบลสวนแตง,3037,3270,6307,3051,3281,6332,2387
2567,72,สุพรรณบุรี,7296,ท้องถิ่นเทศบาลตำบลโพธิ์พระยา,1460,1818,3278,1465,1820,3285,1722
2567,72,สุพรรณบุรี,7297,ท้องถิ่นเทศบาลตำบลท่าเสด็จ,6562,6998,13560,6583,7024,13607,4599
2567,72,สุพรรณบุรี,7298,ท้องถิ่นเทศบาลเมืองสองพี่น้อง,5390,6183,11573,5497,6294,11791,5380
2567,72,สุพรรณบุรี,7299,ท้องถิ่นเทศบาลเมืองสุพรรณบุรี,10452,12470,22922,10664,12653,23317,13162
2567,73,นครปฐม,7301,อำเภอเมืองนครปฐม,84039,92056,176095,84488,92481,176969,72539
2567,73,นครปฐม,7302,อำเภอกำแพงแสน,57206,60444,117650,57664,60873,118537,42452
2567,73,นครปฐม,7303,อำเภอนครชัยศรี,47918,52969,100887,48155,53201,101356,41862
2567,73,นครปฐม,7304,อำเภอดอนตูม,17399,18350,35749,17445,18389,35834,11946
2567,73,นครปฐม,7305,อำเภอบางเลน,38866,40046,78912,39587,40747,80334,31433
2567,73,นครปฐม,7306,อำเภอสามพราน,47187,52563,99750,47571,52910,100481,52185
2567,73,นครปฐม,7307,อำเภอพุทธมณฑล,10498,12357,22855,10584,12458,23042,12471
2567,73,นครปฐม,7380,ท้องถิ่นเทศบาลตำบลบ่อพลับ,4534,5067,9601,4598,5111,9709,5079
2567,73,นครปฐม,7381,ท้องถิ่นเทศบาลตำบลบางกระทึก,7177,8348,15525,7218,8384,15602,9517
2567,73,นครปฐม,7382,ท้องถิ่นเทศบาลเมืองกระทุ่มล้ม,13502,15856,29358,13578,15931,29509,19092
2567,73,นครปฐม,7383,ท้องถิ่นเทศบาลเมืองไร่ขิง,16184,18576,34760,17045,19441,36486,27294
2567,73,นครปฐม,7384,ท้องถิ่นเทศบาลเมืองคลองโยง,5137,5752,10889,5169,5783,10952,4670
2567,73,นครปฐม,7385,ท้องถิ่นเทศบาลตำบลศาลายา,6522,5259,11781,6551,5279,11830,9858
2567,73,นครปฐม,7386,ท้องถิ่นเทศบาลตำบลอ้อมใหญ่,11391,12659,24050,11551,12823,24374,22440
2567,73,นครปฐม,7387,ท้องถิ่นเทศบาลเมืองสามพราน,7986,7099,15085,8520,7587,16107,9310
2567,73,นครปฐม,7388,ท้องถิ่นเทศบาลตำบลลำพญา,902,973,1875,902,977,1879,665
2567,73,นครปฐม,7389,ท้องถิ่นเทศบาลตำบลรางกระทุ่ม,973,1019,1992,981,1024,2005,753
2567,73,นครปฐม,7390,ท้องถิ่นเทศบาลตำบลบางหลวง,972,1006,1978,976,1010,1986,738
2567,73,นครปฐม,7391,ท้องถิ่นเทศบาลตำบลบางเลน,3881,3981,7862,4169,4205,8374,4440
2567,73,นครปฐม,7392,ท้องถิ่นเทศบาลตำบลสามง่าม,6577,7223,13800,6636,7291,13927,5216
2567,73,นครปฐม,7393,ท้องถิ่นเทศบาลตำบลห้วยพลู,924,1036,1960,1015,1132,2147,943
2567,73,นครปฐม,7394,ท้องถิ่นเทศบาลตำบลนครชัยศรี,3565,4297,7862,3573,4304,7877,5210
2567,73,นครปฐม,7395,ท้องถิ่นเทศบาลตำบลกำแพงแสน,3131,3576,6707,3151,3597,6748,4369
2567,73,นครปฐม,7396,ท้องถิ่นเทศบาลตำบลโพรงมะเดื่อ,5104,5653,10757,5124,5668,10792,4471
2567,73,นครปฐม,7397,ท้องถิ่นเทศบาลตำบลธรรมศาลา,3196,3570,6766,3218,3586,6804,3082
2567,73,นครปฐม,7398,ท้องถิ่นเทศบาลตำบลดอนยายหอม,2999,3263,6262,3010,3273,6283,2278
2567,73,นครปฐม,7399,ท้องถิ่นเทศบาลนครนครปฐม,29816,33963,63779,30916,34898,65814,38169
2567,74,สมุทรสาคร,7401,อำเภอเมืองสมุทรสาคร,101558,112273,213831,103022,113467,216489,126839
2567,74,สมุทรสาคร,7402,อำเภอกระทุ่มแบน,31768,34536,66304,32519,35259,67778,40695
2567,74,สมุทรสาคร,7403,อำเภอบ้านแพ้ว,24203,26447,50650,24371,26606,50977,17232
2567,74,สมุทรสาคร,7491,ท้องถิ่นเทศบาลตำบลสวนหลวง,19154,19548,38702,19300,19707,39007,24172
2567,74,สมุทรสาคร,7492,ท้องถิ่นเทศบาลตำบลนาดี,13272,14843,28115,13395,14943,28338,17422
2567,74,สมุทรสาคร,7493,ท้องถิ่นเทศบาลตำบลหลักห้า,20455,21753,42208,20494,21802,42296,11441
2567,74,สมุทรสาคร,7494,ท้องถิ่นเทศบาลตำบลบ้านแพ้ว,1177,1236,2413,1351,1421,2772,1062
2567,74,สมุทรสาคร,7495,ท้องถิ่นเทศบาลตำบลเกษตรพัฒนา,2506,2664,5170,2533,2688,5221,1677
2567,74,สมุทรสาคร,7496,ท้องถิ่นเทศบาลตำบลบางปลา,3643,3979,7622,3660,3990,7650,4956
2567,74,สมุทรสาคร,7497,ท้องถิ่นเทศบาลนครอ้อมน้อย,25307,28248,53555,25497,28417,53914,51913
2567,74,สมุทรสาคร,7498,ท้องถิ่นเทศบาลเมืองกระทุ่มแบน,7936,8873,16809,11274,11930,23204,6688
2567,74,สมุทรสาคร,7499,ท้องถิ่นเทศบาลนครสมุทรสาคร,19912,21593,41505,26044,27177,53221,19235
2567,75,สมุทรสงคราม,7501,อำเภอเมืองสมุทรสงคราม,37217,40810,78027,37394,40985,78379,34397
2567,75,สมุทรสงคราม,7502,อำเภอบางคนที,12509,13810,26319,12533,13833,26366,10382
2567,75,สมุทรสงคราม,7503,อำเภออัมพวา,22548,24369,46917,22591,24417,47008,16641
2567,75,สมุทรสงคราม,7595,ท้องถิ่นเทศบาลตำบลเหมืองใหม่,887,956,1843,888,958,1846,810
2567,75,สมุทรสงคราม,7596,ท้องถิ่นเทศบาลตำบลบางนกแขวก,772,903,1675,780,915,1695,865
2567,75,สมุทรสงคราม,7597,ท้องถิ่นเทศบาลตำบลกระดังงา,968,1121,2089,973,1128,2101,882
2567,75,สมุทรสงคราม,7598,ท้องถิ่นเทศบาลตำบลอัมพวา,2067,2280,4347,2071,2288,4359,2028
2567,75,สมุทรสงคราม,7599,ท้องถิ่นเทศบาลเมืองสมุทรสงคราม,11314,12764,24078,11810,13220,25030,11388
2567,76,เพชรบุรี,7601,อำเภอเมืองเพชรบุรี,42346,48529,90875,42451,48646,91097,37991
2567,76,เพชรบุรี,7602,อำเภอเขาย้อย,11435,12096,23531,11493,12141,23634,11748
2567,76,เพชรบุรี,7603,อำเภอหนองหญ้าปล้อง,8211,8231,16442,8238,8265,16503,7327
2567,76,เพชรบุรี,7604,อำเภอชะอำ,11117,11287,22404,11199,11323,22522,9709
2567,76,เพชรบุรี,7605,อำเภอท่ายาง,23724,25071,48795,23768,25094,48862,20888
2567,76,เพชรบุรี,7606,อำเภอบ้านลาด,22903,25135,48038,22932,25160,48092,16808
2567,76,เพชรบุรี,7607,อำเภอบ้านแหลม,17625,18290,35915,17654,18305,35959,12322
2567,76,เพชรบุรี,7608,อำเภอแก่งกระจาน,16677,15969,32646,17592,16638,34230,16353
2567,76,เพชรบุรี,7688,ท้องถิ่นเทศบาลตำบลท่าแลง,3065,3251,6316,3069,3256,6325,2276
2567,76,เพชรบุรี,7689,ท้องถิ่นเทศบาลตำบลบ้านแหลม,5327,5708,11035,5371,5747,11118,4341
2567,76,เพชรบุรี,7690,ท้องถิ่นเทศบาลตำบลบางตะบูน,2369,2507,4876,2370,2509,4879,1919
2567,76,เพชรบุรี,7691,ท้องถิ่นเทศบาลตำบลบ้านลาด,1686,2006,3692,1689,2006,3695,1784
2567,76,เพชรบุรี,7692,ท้องถิ่นเทศบาลตำบลหนองจอก,1268,1405,2673,1272,1408,2680,1070
2567,76,เพชรบุรี,7693,ท้องถิ่นเทศบาลตำบลท่ายาง,12971,14462,27433,13035,14519,27554,12080
2567,76,เพชรบุรี,7694,ท้องถิ่นเทศบาลตำบลนายาง,9097,9896,18993,9185,9924,19109,7778
2567,76,เพชรบุรี,7695,ท้องถิ่นเทศบาลตำบลเขาย้อย,6873,7544,14417,7125,7805,14930,8918
2567,76,เพชรบุรี,7696,ท้องถิ่นเทศบาลตำบลหาดเจ้าสำราญ,2357,2568,4925,2363,2571,4934,2704
2567,76,เพชรบุรี,7697,ท้องถิ่นเทศบาลตำบลหัวสะพาน,2753,3086,5839,2754,3087,5841,2095
2567,76,เพชรบุรี,7698,ท้องถิ่นเทศบาลเมืองชะอำ,19557,22234,41791,20271,22448,42719,48985
2567,76,เพชรบุรี,7699,ท้องถิ่นเทศบาลเมืองเพชรบุรี,8854,10129,18983,9099,10363,19462,10416
2567,77,ประจวบคีรีขันธ์,7701,อำเภอเมืองประจวบคีรีขันธ์,31833,32274,64107,32319,32593,64912,28197
2567,77,ประจวบคีรีขันธ์,7702,อำเภอกุยบุรี,17003,17558,34561,17085,17635,34720,11953
2567,77,ประจวบคีรีขันธ์,7703,อำเภอทับสะแก,20232,20895,41127,21048,21550,42598,15857
2567,77,ประจวบคีรีขันธ์,7704,อำเภอบางสะพาน,29592,30232,59824,30552,31086,61638,28124
2567,77,ประจวบคีรีขันธ์,7705,อำเภอบางสะพานน้อย,17825,18062,35887,18256,18425,36681,16976
2567,77,ประจวบคีรีขันธ์,7706,อำเภอปราณบุรี,20500,22362,42862,21188,22661,43849,23077
2567,77,ประจวบคีรีขันธ์,7707,อำเภอหัวหิน,26853,30392,57245,28557,31186,59743,33943
2567,77,ประจวบคีรีขันธ์,7708,อำเภอสามร้อยยอด,15506,15963,31469,15698,16048,31746,13284
2567,77,ประจวบคีรีขันธ์,7784,ท้องถิ่นเทศบาลตำบลเขาน้อย,6687,3032,9719,6744,3073,9817,6147
2567,77,ประจวบคีรีขันธ์,7785,ท้องถิ่นเทศบาลตำบลไร่เก่า,5136,5296,10432,5193,5347,10540,4397
2567,77,ประจวบคีรีขันธ์,7786,ท้องถิ่นเทศบาลตำบลหนองพลับ,2362,2580,4942,2395,2605,5000,2993
2567,77,ประจวบคีรีขันธ์,7787,ท้องถิ่นเทศบาลตำบลปากน้ำปราณ,3769,3784,7553,3796,3809,7605,3580
2567,77,ประจวบคีรีขันธ์,7788,ท้องถิ่นเทศบาลตำบลปราณบุรี,7809,8566,16375,7882,8619,16501,9896
2567,77,ประจวบคีรีขันธ์,7789,ท้องถิ่นเทศบาลตำบลบางสะพานน้อย,1442,1482,2924,1459,1492,2951,1647
2567,77,ประจวบคีรีขันธ์,7790,ท้องถิ่นเทศบาลตำบลร่อนทอง,3743,3899,7642,3798,3929,7727,3635
2567,77,ประจวบคีรีขันธ์,7791,ท้องถิ่นเทศบาลตำบลบ้านกรูด,1928,2139,4067,1960,2153,4113,2463
2567,77,ประจวบคีรีขันธ์,7792,ท้องถิ่นเทศบาลตำบลกำเนิดนพคุณ,1213,1253,2466,1233,1272,2505,1678
2567,77,ประจวบคีรีขันธ์,7793,ท้องถิ่นเทศบาลตำบลทับสะแก,2887,3309,6196,2903,3327,6230,3639
2567,77,ประจวบคีรีขันธ์,7794,ท้องถิ่นเทศบาลตำบลไร่ใหม่,3542,3853,7395,3634,3941,7575,3032
2567,77,ประจวบคีรีขันธ์,7795,ท้องถิ่นเทศบาลตำบลกุยบุรี,4042,4388,8430,4071,4408,8479,4434
2567,77,ประจวบคีรีขันธ์,7796,ท้องถิ่นเทศบาลตำบลคลองวาฬ,2020,2172,4192,2031,2180,4211,1918
2567,77,ประจวบคีรีขันธ์,7797,ท้องถิ่นเทศบาลตำบล กม.5,1690,1833,3523,1756,1854,3610,1469
2567,77,ประจวบคีรีขันธ์,7798,ท้องถิ่นเทศบาลนครหัวหิน,26370,31975,58345,28609,32878,61487,59601
2567,77,ประจวบคีรีขันธ์,7799,ท้องถิ่นเทศบาลเมืองประจวบคีรีขันธ์,7803,9305,17108,8048,9483,17531,11390
2567,80,นครศรีธรรมราช,8001,อำเภอเมืองนครศรีธรรมราช,79474,82312,161786,79562,82345,161907,67890
2567,80,นครศรีธรรมราช,8002,อำเภอพรหมคีรี,13419,13878,27297,13425,13886,27311,9589
2567,80,นครศรีธรรมราช,8003,อำเภอลานสกา,19001,19951,38952,19006,19954,38960,15293
2567,80,นครศรีธรรมราช,8004,อำเภอฉวาง,25506,26597,52103,25571,26665,52236,19753
2567,80,นครศรีธรรมราช,8005,อำเภอพิปูน,8737,9093,17830,8743,9103,17846,7525
2567,80,นครศรีธรรมราช,8006,อำเภอเชียรใหญ่,20019,19909,39928,20028,19917,39945,15269
2567,80,นครศรีธรรมราช,8007,อำเภอชะอวด,40214,40873,81087,40246,40897,81143,31051
2567,80,นครศรีธรรมราช,8008,อำเภอท่าศาลา,55809,57537,113346,55911,57587,113498,38972
2567,80,นครศรีธรรมราช,8009,อำเภอทุ่งสง,58389,57271,115660,58596,57458,116054,50742
2567,80,นครศรีธรรมราช,8010,อำเภอนาบอน,11822,12031,23853,11863,12084,23947,8901
2567,80,นครศรีธรรมราช,8011,อำเภอทุ่งใหญ่,34468,34681,69149,34488,34694,69182,25093
2567,80,นครศรีธรรมราช,8012,อำเภอปากพนัง,38579,38062,76641,38592,38076,76668,27499
2567,80,นครศรีธรรมราช,8013,อำเภอร่อนพิบูลย์,30475,30678,61153,30501,30702,61203,21226
2567,80,นครศรีธรรมราช,8014,อำเภอสิชล,40296,41081,81377,40428,41182,81610,30774
2567,80,นครศรีธรรมราช,8015,อำเภอขนอม,10071,10498,20569,10160,10556,20716,10275
2567,80,นครศรีธรรมราช,8016,อำเภอหัวไทร,21509,21748,43257,21524,21753,43277,18583
2567,80,นครศรีธรรมราช,8017,อำเภอบางขัน,23910,23264,47174,23939,23284,47223,17409
2567,80,นครศรีธรรมราช,8018,อำเภอถ้ำพรรณรา,9522,9490,19012,9540,9505,19045,7663
2567,80,นครศรีธรรมราช,8019,อำเภอจุฬาภรณ์,15429,15865,31294,15434,15870,31304,11289
2567,80,นครศรีธรรมราช,8020,อำเภอพระพรหม,21987,22666,44653,21995,22672,44667,17455
2567,80,นครศรีธรรมราช,8021,อำเภอนบพิตำ,17061,16904,33965,17066,16910,33976,12795
2567,80,นครศรีธรรมราช,8022,อำเภอช้างกลาง,13627,14171,27798,13638,14176,27814,11314
2567,80,นครศรีธรรมราช,8023,อำเภอเฉลิมพระเกียรติ,10875,10996,21871,10880,11000,21880,8275
2567,80,นครศรีธรรมราช,8070,ท้องถิ่นเทศบาลตำบลหน้าสตน,4020,3966,7986,4027,3971,7998,3014
2567,80,นครศรีธรรมราช,8071,ท้องถิ่นเทศบาลตำบลเขาพระ,4040,4069,8109,4042,4070,8112,3433
2567,80,นครศรีธรรมราช,8072,ท้องถิ่นเทศบาลตำบลเกาะเพชร,3397,3345,6742,3399,3349,6748,2257
2567,80,นครศรีธรรมราช,8073,ท้องถิ่นเทศบาลตำบลทางพูน,4525,4279,8804,4527,4281,8808,3001
2567,80,นครศรีธรรมราช,8074,ท้องถิ่นเทศบาลตำบลที่วัง,7263,7333,14596,7270,7337,14607,6818
2567,80,นครศรีธรรมราช,8075,ท้องถิ่นเทศบาลตำบลท้องเนียน,2828,2844,5672,2853,2867,5720,3428
2567,80,นครศรีธรรมราช,8076,ท้องถิ่นเทศบาลตำบลหัวไทร,1879,2076,3955,1883,2081,3964,1928
2567,80,นครศรีธรรมราช,8077,ท้องถิ่นเทศบาลตำบลขนอม,2015,2052,4067,2163,2204,4367,2540
2567,80,นครศรีธรรมราช,8078,ท้องถิ่นเทศบาลตำบลสิชล,3135,3441,6576,3261,3538,6799,4205
2567,80,นครศรีธรรมราช,8079,ท้องถิ่นเทศบาลตำบลหินตก,4251,4213,8464,4252,4215,8467,2924
2567,80,นครศรีธรรมราช,8080,ท้องถิ่นเทศบาลตำบลร่อนพิบูลย์,3586,3931,7517,3599,3938,7537,3468
2567,80,นครศรีธรรมราช,8081,ท้องถิ่นเทศบาลตำบลเขาชุมทอง,2083,2217,4300,2085,2218,4303,1399
2567,80,นครศรีธรรมราช,8082,ท้องถิ่นเทศบาลตำบลท่ายาง,2360,2524,4884,2418,2600,5018,3140
2567,80,นครศรีธรรมราช,8083,ท้องถิ่นเทศบาลตำบลนาบอน,1007,1069,2076,1023,1086,2109,1167
2567,80,นครศรีธรรมราช,8084,ท้องถิ่นเทศบาลตำบลท่าศาลา,1302,1465,2767,1305,1466,2771,1838
2567,80,นครศรีธรรมราช,8085,ท้องถิ่นเทศบาลตำบลชะอวด,1555,1829,3384,1557,1829,3386,1687
2567,80,นครศรีธรรมราช,8086,ท้องถิ่นเทศบาลตำบลเชียรใหญ่,781,831,1612,782,831,1613,802
2567,80,นครศรีธรรมราช,8087,ท้องถิ่นเทศบาลตำบลพิปูน,1299,1396,2695,1300,1396,2696,1158
2567,80,นครศรีธรรมราช,8088,ท้องถิ่นเทศบาลตำบลไม้เรียง,1120,1164,2284,1126,1171,2297,1273
2567,80,นครศรีธรรมราช,8089,ท้องถิ่นเทศบาลตำบลฉวาง,1181,1215,2396,1183,1216,2399,1313
2567,80,นครศรีธรรมราช,8090,ท้องถิ่นเทศบาลตำบลจันดี,3400,3798,7198,3442,3832,7274,4043
2567,80,นครศรีธรรมราช,8091,ท้องถิ่นเทศบาลตำบลลานสกา,865,954,1819,866,956,1822,1051
2567,80,นครศรีธรรมราช,8092,ท้องถิ่นเทศบาลตำบลพรหมโลก,3258,3392,6650,3264,3404,6668,2856
2567,80,นครศรีธรรมราช,8093,ท้องถิ่นเทศบาลตำบลทอนหงส์,1696,1727,3423,1699,1729,3428,1172
2567,80,นครศรีธรรมราช,8094,ท้องถิ่นเทศบาลตำบลปากนคร,3110,3028,6138,3112,3030,6142,2112
2567,80,นครศรีธรรมราช,8095,ท้องถิ่นเทศบาลตำบลบางจาก,886,936,1822,886,936,1822,702
2567,80,นครศรีธรรมราช,8096,ท้องถิ่นเทศบาลตำบลท่าแพ,1823,1865,3688,1826,1868,3694,1291
2567,80,นครศรีธรรมราช,8097,ท้องถิ่นเทศบาลเมืองทุ่งสง,13234,15623,28857,13248,15629,28877,11809
2567,80,นครศรีธรรมราช,8098,ท้องถิ่นเทศบาลเมืองปากพนัง,9082,9338,18420,9111,9353,18464,8254
2567,80,นครศรีธรรมราช,8099,ท้องถิ่นเทศบาลนครนครศรีธรรมราช,44729,50342,95071,44894,50437,95331,47550
2567,81,กระบี่,8101,อำเภอเมืองกระบี่,37583,38520,76103,37954,38721,76675,42038
2567,81,กระบี่,8102,อำเภอเขาพนม,25420,25215,50635,25489,25287,50776,19101
2567,81,กระบี่,8103,อำเภอเกาะลันตา,17787,17366,35153,17891,17429,35320,15683
2567,81,กระบี่,8104,อำเภอคลองท่อม,36760,35516,72276,36838,35594,72432,26167
2567,81,กระบี่,8105,อำเภออ่าวลึก,23384,23608,46992,23420,23642,47062,17520
2567,81,กระบี่,8106,อำเภอปลายพระยา,16227,16185,32412,16244,16208,32452,11615
2567,81,กระบี่,8107,อำเภอลำทับ,10272,9991,20263,10280,9995,20275,7616
2567,81,กระบี่,8108,อำเภอเหนือคลอง,30294,30984,61278,30340,31034,61374,21765
2567,81,กระบี่,8189,ท้องถิ่นเทศบาลตำบลกระบี่น้อย,9681,10071,19752,9703,10085,19788,9878
2567,81,กระบี่,8190,ท้องถิ่นเทศบาลตำบลเหนือคลอง,2076,2260,4336,2089,2267,4356,2505
2567,81,กระบี่,8191,ท้องถิ่นเทศบาลตำบลลำทับ,2070,2247,4317,2096,2270,4366,2482
2567,81,กระบี่,8192,ท้องถิ่นเทศบาลตำบลปลายพระยา,3007,3020,6027,3012,3034,6046,2719
2567,81,กระบี่,8193,ท้องถิ่นเทศบาลตำบลอ่าวลึกใต้,2569,2798,5367,2591,2811,5402,3090
2567,81,กระบี่,8194,ท้องถิ่นเทศบาลตำบลแหลมสัก,2057,2043,4100,2057,2044,4101,1306
2567,81,กระบี่,8195,ท้องถิ่นเทศบาลตำบลคลองพน,1420,1473,2893,1421,1475,2896,1371
2567,81,กระบี่,8196,ท้องถิ่นเทศบาลตำบลคลองท่อมใต้,1490,1683,3173,1491,1683,3174,1836
2567,81,กระบี่,8197,ท้องถิ่นเทศบาลตำบลเกาะลันตาใหญ่,563,588,1151,563,589,1152,513
2567,81,กระบี่,8198,ท้องถิ่นเทศบาลตำบลเขาพนม,2559,2727,5286,2613,2773,5386,2577
2567,81,กระบี่,8199,ท้องถิ่นเทศบาลเมืองกระบี่,13859,16314,30173,14221,16601,30822,18450
2567,82,พังงา,8201,อำเภอเมืองพังงา,15161,15652,30813,15197,15685,30882,12960
2567,82,พังงา,8202,อำเภอเกาะยาว,7368,7235,14603,7423,7281,14704,6231
2567,82,พังงา,8203,อำเภอกะปง,6609,6589,13198,6682,6642,13324,6241
2567,82,พังงา,8204,อำเภอตะกั่วทุ่ง,19609,19418,39027,19706,19511,39217,16946
2567,82,พังงา,8205,อำเภอตะกั่วป่า,20257,20591,40848,20836,21091,41927,25190
2567,82,พังงา,8206,อำเภอคุระบุรี,12452,12060,24512,12642,12270,24912,10816
2567,82,พังงา,8207,อำเภอทับปุด,12411,12335,24746,12459,12375,24834,8557
2567,82,พังงา,8208,อำเภอท้ายเหมือง,22614,21945,44559,22787,22069,44856,21765
2567,82,พังงา,8291,ท้องถิ่นเทศบาลตำบลท้ายเหมือง,1466,1582,3048,1474,1586,3060,1786
2567,82,พังงา,8292,ท้องถิ่นเทศบาลตำบลทับปุด,477,492,969,480,493,973,623
2567,82,พังงา,8293,ท้องถิ่นเทศบาลตำบลคุระบุรี,1617,1648,3265,1689,1710,3399,2230
2567,82,พังงา,8294,ท้องถิ่นเทศบาลเมืองโคกกลอย,1740,1990,3730,1826,2067,3893,1772
2567,82,พังงา,8295,ท้องถิ่นเทศบาลตำบลกระโสม,852,954,1806,852,958,1810,791
2567,82,พังงา,8296,ท้องถิ่นเทศบาลตำบลท่านา,483,543,1026,488,549,1037,600
2567,82,พังงา,8297,ท้องถิ่นเทศบาลตำบลเกาะยาว,0,0,0,0,0,0,0
2567,82,พังงา,8298,ท้องถิ่นเทศบาลเมืองตะกั่วป่า,3599,4004,7603,3616,4010,7626,2841
2567,82,พังงา,8299,ท้องถิ่นเทศบาลเมืองพังงา,4360,4742,9102,4753,5089,9842,6094
2567,83,ภูเก็ต,8301,อำเภอเมืองภูเก็ต,21847,24924,46771,22166,25064,47230,32419
2567,83,ภูเก็ต,8302,อำเภอกะทู้,3292,3697,6989,3404,3760,7164,7745
2567,83,ภูเก็ต,8303,อำเภอถลาง,47805,51502,99307,48607,51911,100518,79963
2567,83,ภูเก็ต,8391,ท้องถิ่นเทศบาลตำบลวิชิต,25237,29359,54596,25810,29824,55634,36111
2567,83,ภูเก็ต,8392,ท้องถิ่นเทศบาลตำบลราไวย์,8771,10301,19072,9104,10414,19518,21246
2567,83,ภูเก็ต,8393,ท้องถิ่นเทศบาลตำบลรัษฎา,23757,26823,50580,24093,27129,51222,32097
2567,83,ภูเก็ต,8394,ท้องถิ่นเทศบาลตำบลเทพกระษัตรี,4425,4795,9220,4808,5106,9914,5270
2567,83,ภูเก็ต,8395,ท้องถิ่นเทศบาลตำบลเชิงทะเล,3020,3804,6824,3092,3864,6956,3815
2567,83,ภูเก็ต,8396,ท้องถิ่นเทศบาลเมืองกะทู้,14619,17585,32204,15048,17711,32759,22837
2567,83,ภูเก็ต,8397,ท้องถิ่นเทศบาลตำบลกะรน,3522,3966,7488,3603,4024,7627,9210
2567,83,ภูเก็ต,8398,ท้องถิ่นเทศบาลเมืองป่าตอง,8819,9842,18661,9469,10288,19757,16662
2567,83,ภูเก็ต,8399,ท้องถิ่นเทศบาลนครภูเก็ต,31038,36925,67963,32784,38500,71284,27008
2567,84,สุราษฎร์ธานี,8401,อำเภอเมืองสุราษฎร์ธานี,9120,10033,19153,9133,10044,19177,8794
2567,84,สุราษฎร์ธานี,8402,อำเภอกาญจนดิษฐ์,40916,41787,82703,41142,41970,83112,36100
2567,84,สุราษฎร์ธานี,8403,อำเภอดอนสัก,12300,12341,24641,12458,12419,24877,11061
2567,84,สุราษฎร์ธานี,8405,อำเภอเกาะพะงัน,5145,5234,10379,5937,5682,11619,14031
2567,84,สุราษฎร์ธานี,8406,อำเภอไชยา,18877,19720,38597,18939,19770,38709,17756
2567,84,สุราษฎร์ธานี,8407,อำเภอท่าชนะ,25961,25548,51509,26010,25584,51594,23599
2567,84,สุราษฎร์ธานี,8408,อำเภอคีรีรัฐนิคม,20990,21124,42114,21053,21195,42248,17704
2567,84,สุราษฎร์ธานี,8409,อำเภอบ้านตาขุน,4609,4669,9278,4613,4674,9287,4136
2567,84,สุราษฎร์ธานี,8410,อำเภอพนม,12479,12005,24484,12499,12016,24515,9865
2567,84,สุราษฎร์ธานี,8411,อำเภอท่าฉาง,14858,14698,29556,14912,14745,29657,13632
2567,84,สุราษฎร์ธานี,8412,อำเภอบ้านนาสาร,25116,25605,50721,25135,25621,50756,19007
2567,84,สุราษฎร์ธานี,8413,อำเภอบ้านนาเดิม,10278,10478,20756,10286,10484,20770,8086
2567,84,สุราษฎร์ธานี,8414,อำเภอเคียนซา,13725,13707,27432,13791,13784,27575,11781
2567,84,สุราษฎร์ธานี,8415,อำเภอเวียงสระ,8551,8831,17382,8560,8833,17393,7281
2567,84,สุราษฎร์ธานี,8416,อำเภอพระแสง,31565,31185,62750,31583,31205,62788,25331
2567,84,สุราษฎร์ธานี,8417,อำเภอพุนพิน,37481,37645,75126,37668,37830,75498,38068
2567,84,สุราษฎร์ธานี,8418,อำเภอชัยบุรี,14301,14079,28380,14313,14090,28403,12017
2567,84,สุราษฎร์ธานี,8419,อำเภอวิภาวดี,8174,7629,15803,8232,7689,15921,7667
2567,84,สุราษฎร์ธานี,8471,ท้องถิ่นเทศบาลตำบลบ้านเสด็จ,9765,9535,19300,9771,9537,19308,8130
2567,84,สุราษฎร์ธานี,8472,ท้องถิ่นเทศบาลตำบลคลองชะอุ่น,4939,4895,9834,4941,4899,9840,3573
2567,84,สุราษฎร์ธานี,8473,ท้องถิ่นเทศบาลตำบลทุ่งหลวง,5404,5716,11120,5406,5719,11125,4378
2567,84,สุราษฎร์ธานี,8474,ท้องถิ่นเทศบาลตำบลขุนทะเล,7406,9151,16557,7429,9238,16667,12007
2567,84,สุราษฎร์ธานี,8475,ท้องถิ่นเทศบาลตำบลช้างซ้าย,5581,5640,11221,5593,5648,11241,4141
2567,84,สุราษฎร์ธานี,8476,ท้องถิ่นเทศบาลตำบลเขานิพันธ์,3391,3429,6820,3392,3430,6822,3104
2567,84,สุราษฎร์ธานี,8477,ท้องถิ่นเทศบาลตำบลวัดประดู่,9925,11136,21061,9950,11146,21096,13336
2567,84,สุราษฎร์ธานี,8478,ท้องถิ่นเทศบาลตำบลบ้านส้อง,8725,9010,17735,8727,9015,17742,7417
2567,84,สุราษฎร์ธานี,8479,ท้องถิ่นเทศบาลตำบลย่านดินแดง,1089,1131,2220,1111,1146,2257,1103
2567,84,สุราษฎร์ธานี,8480,ท้องถิ่นเทศบาลตำบลบางสวรรค์,2076,2147,4223,2077,2147,4224,2093
2567,84,สุราษฎร์ธานี,8481,ท้องถิ่นเทศบาลเมืองเวียงสระ,4340,4911,9251,4430,4993,9423,5983
2567,84,สุราษฎร์ธานี,8482,ท้องถิ่นเทศบาลตำบลเคียนซา,846,801,1647,849,802,1651,762
2567,84,สุราษฎร์ธานี,8483,ท้องถิ่นเทศบาลตำบลบ้านนา,1537,1676,3213,1550,1684,3234,1755
2567,84,สุราษฎร์ธานี,8484,ท้องถิ่นเทศบาลตำบลท่าฉาง,2210,2408,4618,2235,2425,4660,2018
2567,84,สุราษฎร์ธานี,8485,ท้องถิ่นเทศบาลตำบลพนม,2439,2453,4892,2451,2469,4920,2083
2567,84,สุราษฎร์ธานี,8486,ท้องถิ่นเทศบาลตำบลบ้านตาขุน,1161,1245,2406,1164,1249,2413,1921
2567,84,สุราษฎร์ธานี,8487,ท้องถิ่นเทศบาลตำบลบ้านเชี่ยวหลาน,2280,2295,4575,2282,2295,4577,2091
2567,84,สุราษฎร์ธานี,8488,ท้องถิ่นเทศบาลตำบลท่าขนอน,918,887,1805,924,892,1816,1120
2567,84,สุราษฎร์ธานี,8489,ท้องถิ่นเทศบาลตำบลท่าชนะ,1355,1505,2860,1357,1509,2866,1837
2567,84,สุราษฎร์ธานี,8490,ท้องถิ่นเทศบาลตำบลพุมเรียง,3827,3997,7824,3827,3999,7826,2972
2567,84,สุราษฎร์ธานี,8491,ท้องถิ่นเทศบาลตำบลตลาดไชยา,2196,2526,4722,2347,2669,5016,3045
2567,84,สุราษฎร์ธานี,8492,ท้องถิ่นเทศบาลตำบลเกาะพะงัน,3688,3941,7629,4059,4121,8180,6452
2567,84,สุราษฎร์ธานี,8493,ท้องถิ่นเทศบาลนครเกาะสมุย,31118,34888,66006,33390,36299,69689,61602
2567,84,สุราษฎร์ธานี,8494,ท้องถิ่นเทศบาลเมืองดอนสัก,5886,6166,12052,5919,6199,12118,6109
2567,84,สุราษฎร์ธานี,8495,ท้องถิ่นเทศบาลตำบลท่าทองใหม่,3568,3630,7198,3575,3633,7208,3336
2567,84,สุราษฎร์ธานี,8496,ท้องถิ่นเทศบาลตำบลกาญจนดิษฐ์,4444,4831,9275,4452,4836,9288,4989
2567,84,สุราษฎร์ธานี,8497,ท้องถิ่นเทศบาลเมืองท่าข้าม,8438,9075,17513,8526,9166,17692,9232
2567,84,สุราษฎร์ธานี,8498,ท้องถิ่นเทศบาลเมืองนาสาร,9228,9712,18940,9254,9729,18983,8609
2567,84,สุราษฎร์ธานี,8499,ท้องถิ่นเทศบาลนครสุราษฎร์ธานี,61072,68437,129509,61825,69060,130885,79259
2567,85,ระนอง,8501,อำเภอเมืองระนอง,32750,32675,65425,35589,35295,70884,40595
2567,85,ระนอง,8502,อำเภอละอุ่น,6352,6180,12532,6413,6238,12651,5838
2567,85,ระนอง,8503,อำเภอกะเปอร์,10232,9988,20220,10441,10188,20629,8463
2567,85,ระนอง,8504,อำเภอกระบุรี,22284,21555,43839,22683,21923,44606,23388
2567,85,ระนอง,8505,อำเภอสุขสำราญ,7126,7218,14344,7389,7461,14850,4845
2567,85,ระนอง,8594,ท้องถิ่นเทศบาลตำบลน้ำจืด,1549,1639,3188,1697,1744,3441,2010
2567,85,ระนอง,8595,ท้องถิ่นเทศบาลตำบลกะเปอร์,760,793,1553,765,798,1563,687
2567,85,ระนอง,8596,ท้องถิ่นเทศบาลตำบลละอุ่น,1253,1205,2458,1344,1287,2631,1244
2567,85,ระนอง,8597,ท้องถิ่นเทศบาลตำบลหงาว,1110,1203,2313,1159,1259,2418,1131
2567,85,ระนอง,8598,ท้องถิ่นเทศบาลตำบลปากน้ำ,1180,1065,2245,1220,1125,2345,1836
2567,85,ระนอง,8599,ท้องถิ่นเทศบาลเมืองระนอง,5707,6271,11978,8244,8665,16909,8333
2567,86,ชุมพร,8601,อำเภอเมืองชุมพร,46178,47253,93431,46282,47336,93618,47513
2567,86,ชุมพร,8602,อำเภอท่าแซะ,40898,41126,82024,41279,41506,82785,37440
2567,86,ชุมพร,8603,อำเภอปะทิว,19530,20061,39591,19659,20161,39820,19062
2567,86,ชุมพร,8604,อำเภอหลังสวน,27377,28537,55914,27594,28722,56316,26186
2567,86,ชุมพร,8605,อำเภอละแม,12860,12851,25711,12994,12964,25958,12433
2567,86,ชุมพร,8606,อำเภอพะโต๊ะ,11820,11414,23234,11829,11426,23255,11354
2567,86,ชุมพร,8607,อำเภอสวี,34617,35021,69638,34696,35098,69794,33712
2567,86,ชุมพร,8608,อำเภอทุ่งตะโก,10849,10821,21670,10881,10855,21736,10400
2567,86,ชุมพร,8685,ท้องถิ่นเทศบาลเมืองท่ายาง,5023,5306,10329,5037,5312,10349,4985
2567,86,ชุมพร,8686,ท้องถิ่นเทศบาลตำบลปากตะโก,2024,1985,4009,2027,1986,4013,1719
2567,86,ชุมพร,8687,ท้องถิ่นเทศบาลตำบลนาโพธิ์,1344,1534,2878,1348,1535,2883,1726
2567,86,ชุมพร,8688,ท้องถิ่นเทศบาลตำบลพะโต๊ะ,755,749,1504,760,753,1513,717
2567,86,ชุมพร,8689,ท้องถิ่นเทศบาลตำบลละแม,1571,1689,3260,1582,1701,3283,2038
2567,86,ชุมพร,8690,ท้องถิ่นเทศบาลตำบลปากน้ำหลังสวน,3073,3170,6243,3105,3201,6306,3210
2567,86,ชุมพร,8691,ท้องถิ่นเทศบาลตำบลสะพลี,1021,1101,2122,1030,1101,2131,1212
2567,86,ชุมพร,8692,ท้องถิ่นเทศบาลตำบลมาบอำมฤต,1631,1678,3309,1740,1810,3550,2307
2567,86,ชุมพร,8693,ท้องถิ่นเทศบาลตำบลปะทิว,538,610,1148,582,657,1239,908
2567,86,ชุมพร,8694,ท้องถิ่นเทศบาลตำบลเนินสันติ,917,953,1870,920,959,1879,1346
2567,86,ชุมพร,8695,ท้องถิ่นเทศบาลตำบลท่าแซะ,938,1044,1982,938,1046,1984,1439
2567,86,ชุมพร,8696,ท้องถิ่นเทศบาลตำบลวังไผ่,3175,3508,6683,3184,3513,6697,4920
2567,86,ชุมพร,8697,ท้องถิ่นเทศบาลตำบลปากน้ำชุมพร,2723,2886,5609,2894,3044,5938,3466
2567,86,ชุมพร,8698,ท้องถิ่นเทศบาลเมืองหลังสวน,5030,5796,10826,5050,5808,10858,7243
2567,86,ชุมพร,8699,ท้องถิ่นเทศบาลเมืองชุมพร,14437,16932,31369,14856,17292,32148,20812
2567,90,สงขลา,9001,อำเภอเมืองสงขลา,7257,7924,15181,7272,7930,15202,5918
2567,90,สงขลา,9002,อำเภอสทิงพระ,21437,22442,43879,21446,22447,43893,14551
2567,90,สงขลา,9003,อำเภอจะนะ,50829,51419,102248,50876,51458,102334,29763
2567,90,สงขลา,9004,อำเภอนาทวี,31744,31126,62870,31791,31167,62958,20460
2567,90,สงขลา,9005,อำเภอเทพา,30924,29457,60381,30974,29515,60489,17541
2567,90,สงขลา,9006,อำเภอสะบ้าย้อย,40421,39787,80208,40468,39840,80308,20407
2567,90,สงขลา,9007,อำเภอระโนด,23465,23939,47404,23485,23966,47451,20201
2567,90,สงขลา,9008,อำเภอกระแสสินธุ์,7149,7450,14599,7156,7453,14609,5499
2567,90,สงขลา,9009,อำเภอรัตภูมิ,33520,34114,67634,33783,34135,67918,23493
2567,90,สงขลา,9010,อำเภอสะเดา,29404,29168,58572,29594,29333,58927,22395
2567,90,สงขลา,9011,อำเภอหาดใหญ่,15583,16983,32566,15637,17032,32669,15251
2567,90,สงขลา,9012,อำเภอนาหม่อม,11084,11952,23036,11101,11964,23065,9810
2567,90,สงขลา,9013,อำเภอควนเนียง,14762,15280,30042,14787,15300,30087,10564
2567,90,สงขลา,9014,อำเภอบางกล่ำ,5098,5253,10351,5161,5299,10460,3991
2567,90,สงขลา,9015,อำเภอสิงหนคร,21406,22384,43790,21415,22386,43801,15721
2567,90,สงขลา,9016,อำเภอคลองหอยโข่ง,5853,5836,11689,5898,5888,11786,5470
2567,90,สงขลา,9066,ท้องถิ่นเทศบาลเมืองทุ่งตำเสา,8426,8937,17363,8439,8946,17385,6860
2567,90,สงขลา,9067,ท้องถิ่นเทศบาลตำบลโคกม่วง,4104,3494,7598,4107,3502,7609,2938
2567,90,สงขลา,9068,ท้องถิ่นเทศบาลตำบลทุ่งลาน,3724,4011,7735,3737,4013,7750,2822
2567,90,สงขลา,9069,ท้องถิ่นเทศบาลตำบลเกาะแต้ว,5639,5980,11619,5644,5982,11626,4057
2567,90,สงขลา,9070,ท้องถิ่นเทศบาลตำบลคูเต่า,5897,6016,11913,5904,6017,11921,3473
2567,90,สงขลา,9071,ท้องถิ่นเทศบาลตำบลท่าช้าง,11757,11846,23603,11781,11869,23650,11027
2567,90,สงขลา,9072,ท้องถิ่นเทศบาลตำบลน้ำน้อย,7278,8194,15472,7300,8200,15500,6875
2567,90,สงขลา,9073,ท้องถิ่นเทศบาลตำบลลำไพล,7803,8037,15840,7835,8057,15892,4841
2567,90,สงขลา,9074,ท้องถิ่นเทศบาลตำบลบ้านไร่,4032,4307,8339,4047,4312,8359,3689
2567,90,สงขลา,9075,ท้องถิ่นเทศบาลตำบลพะวง,16653,18403,35056,17014,18749,35763,16945
2567,90,สงขลา,9076,ท้องถิ่นเทศบาลเมืองเขารูปช้าง,20356,22739,43095,20410,22757,43167,22492
2567,90,สงขลา,9077,ท้องถิ่นเทศบาลตำบลสำนักขาม,6322,7380,13702,6394,7429,13823,9493
2567,90,สงขลา,9078,ท้องถิ่นเทศบาลเมืองคลองแห,20873,23816,44689,20931,23852,44783,23597
2567,90,สงขลา,9079,ท้องถิ่นเทศบาลเมืองควนลัง,24570,28113,52683,24657,28190,52847,28678
2567,90,สงขลา,9080,ท้องถิ่นเทศบาลเมืองคอหงส์,21452,24389,45841,21610,24487,46097,30251
2567,90,สงขลา,9081,ท้องถิ่นเทศบาลเมืองสิงหนคร,19833,20273,40106,19852,20281,40133,14173
2567,90,สงขลา,9082,ท้องถิ่นเทศบาลตำบลควนเนียง,1865,2121,3986,1872,2132,4004,1831
2567,90,สงขลา,9083,ท้องถิ่นเทศบาลตำบลพะตง,3616,4059,7675,3660,4094,7754,4992
2567,90,สงขลา,9084,ท้องถิ่นเทศบาลตำบลคลองแงะ,3847,4092,7939,3916,4154,8070,3252
2567,90,สงขลา,9085,ท้องถิ่นเทศบาลเมืองปาดังเบซาร์,7668,8133,15801,7703,8163,15866,6450
2567,90,สงขลา,9086,ท้องถิ่นเทศบาลตำบลปริก,3127,3320,6447,3138,3322,6460,2170
2567,90,สงขลา,9087,ท้องถิ่นเทศบาลตำบลนาสีทอง,1387,1550,2937,1388,1551,2939,1190
2567,90,สงขลา,9088,ท้องถิ่นเทศบาลตำบลกำแพงเพชร,2282,2520,4802,2315,2554,4869,2704
2567,90,สงขลา,9089,ท้องถิ่นเทศบาลตำบลระโนด,2005,2206,4211,2006,2208,4214,2029
2567,90,สงขลา,9090,ท้องถิ่นเทศบาลตำบลบ่อตรุ,5238,5480,10718,5240,5480,10720,3648
2567,90,สงขลา,9091,ท้องถิ่นเทศบาลตำบลสะบ้าย้อย,640,688,1328,640,688,1328,809
2567,90,สงขลา,9092,ท้องถิ่นเทศบาลตำบลเทพา,1363,1321,2684,1370,1329,2699,1125
2567,90,สงขลา,9093,ท้องถิ่นเทศบาลตำบลนาทวี,2819,2884,5703,2939,2991,5930,3858
2567,90,สงขลา,9094,ท้องถิ่นเทศบาลตำบลจะนะ,3243,3390,6633,3291,3418,6709,3478
2567,90,สงขลา,9095,ท้องถิ่นเทศบาลตำบลสทิงพระ,1351,1477,2828,1353,1477,2830,1336
2567,90,สงขลา,9096,ท้องถิ่นเทศบาลเมืองบ้านพรุ,13396,14851,28247,13456,14894,28350,13986
2567,90,สงขลา,9097,ท้องถิ่นเทศบาลเมืองสะเดา,10138,10751,20889,10347,10949,21296,9238
2567,90,สงขลา,9098,ท้องถิ่นเทศบาลนครหาดใหญ่,63049,74416,137465,64864,75987,140851,70703
2567,90,สงขลา,9099,ท้องถิ่นเทศบาลนครสงขลา,25716,28106,53822,25798,28158,53956,27878
2567,91,สตูล,9101,อำเภอเมืองสตูล,32787,33602,66389,32816,33625,66441,19610
2567,91,สตูล,9102,อำเภอควนโดน,11059,11160,22219,11067,11161,22228,6347
2567,91,สตูล,9103,อำเภอควนกาหลง,17759,17708,35467,17766,17717,35483,12380
2567,91,สตูล,9104,อำเภอท่าแพ,14859,15066,29925,14873,15070,29943,9197
2567,91,สตูล,9105,อำเภอละงู,34282,34650,68932,34386,34751,69137,22266
2567,91,สตูล,9106,อำเภอทุ่งหว้า,10748,10590,21338,10770,10601,21371,7074
2567,91,สตูล,9107,อำเภอมะนัง,9526,9169,18695,9531,9171,18702,6715
2567,91,สตูล,9193,ท้องถิ่นเทศบาลตำบลคลองขุด,10518,9957,20475,10529,9964,20493,9640
2567,91,สตูล,9194,ท้องถิ่นเทศบาลตำบลทุ่งหว้า,1602,1626,3228,1603,1626,3229,1271
2567,91,สตูล,9195,ท้องถิ่นเทศบาลตำบลกำแพง,2321,2567,4888,2326,2570,4896,2953
2567,91,สตูล,9196,ท้องถิ่นเทศบาลตำบลควนโดน,2682,2779,5461,2684,2783,5467,2028
2567,91,สตูล,9197,ท้องถิ่นเทศบาลตำบลฉลุง,1094,1221,2315,1094,1221,2315,1046
2567,91,สตูล,9198,ท้องถิ่นเทศบาลตำบลเจ๊ะบิลัง,1999,2021,4020,2007,2030,4037,1041
2567,91,สตูล,9199,ท้องถิ่นเทศบาลเมืองสตูล,10159,10879,21038,10215,10922,21137,10207
2567,92,ตรัง,9201,อำเภอเมืองตรัง,46338,50291,96629,46421,50340,96761,43309
2567,92,ตรัง,9202,อำเภอกันตัง,37273,38032,75305,37295,38060,75355,25257
2567,92,ตรัง,9203,อำเภอย่านตาขาว,27673,28615,56288,27718,28645,56363,18750
2567,92,ตรัง,9204,อำเภอปะเหลียน,30616,31352,61968,30666,31394,62060,22375
2567,92,ตรัง,9205,อำเภอสิเกา,17619,17207,34826,17651,17239,34890,13112
2567,92,ตรัง,9206,อำเภอห้วยยอด,38226,39359,77585,38286,39412,77698,27826
2567,92,ตรัง,9207,อำเภอวังวิเศษ,19988,20255,40243,20002,20267,40269,14381
2567,92,ตรัง,9208,อำเภอนาโยง,19827,21047,40874,19839,21050,40889,14157
2567,92,ตรัง,9209,อำเภอรัษฎา,13151,13495,26646,13174,13518,26692,10197
2567,92,ตรัง,9210,อำเภอหาดสำราญ,8413,8324,16737,8420,8331,16751,5144
2567,92,ตรัง,9286,ท้องถิ่นเทศบาลตำบลคลองปาง,1155,1271,2426,1155,1272,2427,1379
2567,92,ตรัง,9287,ท้องถิ่นเทศบาลตำบลนาโยงเหนือ,1607,1803,3410,1611,1806,3417,1618
2567,92,ตรัง,9288,ท้องถิ่นเทศบาลตำบลวังวิเศษ,1451,1469,2920,1466,1488,2954,1411
2567,92,ตรัง,9289,ท้องถิ่นเทศบาลตำบลลำภูรา,1779,1457,3236,1780,1457,3237,1476
2567,92,ตรัง,9290,ท้องถิ่นเทศบาลตำบลนาวง,1920,2049,3969,1927,2049,3976,1888
2567,92,ตรัง,9291,ท้องถิ่นเทศบาลตำบลสิเกา,604,669,1273,619,683,1302,664
2567,92,ตรัง,9292,ท้องถิ่นเทศบาลตำบลควนกุน,1013,1067,2080,1013,1068,2081,790
2567,92,ตรัง,9293,ท้องถิ่นเทศบาลตำบลทุ่งยาว,1090,1236,2326,1096,1238,2334,1117
2567,92,ตรัง,9294,ท้องถิ่นเทศบาลตำบลท่าข้าม,643,653,1296,645,655,1300,670
2567,92,ตรัง,9295,ท้องถิ่นเทศบาลตำบลย่านตาขาว,3416,3968,7384,3432,3987,7419,3874
2567,92,ตรัง,9296,ท้องถิ่นเทศบาลตำบลคลองเต็ง,1841,2007,3848,1848,2009,3857,1819
2567,92,ตรัง,9297,ท้องถิ่นเทศบาลตำบลห้วยยอด,3681,4097,7778,3691,4103,7794,4232
2567,92,ตรัง,9298,ท้องถิ่นเทศบาลเมืองกันตัง,5436,5664,11100,5483,5705,11188,5143
2567,92,ตรัง,9299,ท้องถิ่นเทศบาลนครตรัง,24576,28926,53502,24807,29138,53945,26264
2567,93,พัทลุง,9301,อำเภอเมืองพัทลุง,42566,46913,89479,42603,46931,89534,36125
2567,93,พัทลุง,9302,อำเภอกงหรา,14687,14877,29564,14689,14882,29571,9934
2567,93,พัทลุง,9303,อำเภอเขาชัยสน,15065,15759,30824,15074,15762,30836,12083
2567,93,พัทลุง,9304,อำเภอตะโหมด,7117,7213,14330,7123,7215,14338,4992
2567,93,พัทลุง,9305,อำเภอควนขนุน,37617,40835,78452,37631,40840,78471,31374
2567,93,พัทลุง,9306,อำเภอปากพะยูน,16038,16637,32675,16042,16641,32683,11544
2567,93,พัทลุง,9307,อำเภอศรีบรรพต,8988,9017,18005,8993,9026,18019,7138
2567,93,พัทลุง,9308,อำเภอป่าบอน,21384,21809,43193,21390,21810,43200,16564
2567,93,พัทลุง,9309,อำเภอบางแก้ว,8920,9104,18024,8928,9106,18034,6797
2567,93,พัทลุง,9310,อำเภอป่าพะยอม,13117,13658,26775,13126,13667,26793,11251
2567,93,พัทลุง,9311,อำเภอศรีนครินทร์,5120,5267,10387,5122,5270,10392,3790
2567,93,พัทลุง,9382,ท้องถิ่นเทศบาลตำบลเขาหัวช้าง,3603,3582,7185,3603,3583,7186,2281
2567,93,พัทลุง,9383,ท้องถิ่นเทศบาลตำบลชะรัด,3630,3687,7317,3632,3688,7320,2390
2567,93,พัทลุง,9384,ท้องถิ่นเทศบาลตำบลหารเทา,4876,5084,9960,4881,5085,9966,3624
2567,93,พัทลุง,9385,ท้องถิ่นเทศบาลตำบลบางแก้ว,1891,1944,3835,1892,1945,3837,1498
2567,93,พัทลุง,9386,ท้องถิ่นเทศบาลตำบลอ่าวพะยูน,2245,2323,4568,2249,2325,4574,1729
2567,93,พัทลุง,9387,ท้องถิ่นเทศบาลตำบลชุมพล,4777,4138,8915,4781,4138,8919,3688
2567,93,พัทลุง,9388,ท้องถิ่นเทศบาลตำบลโคกม่วง,5045,5292,10337,5045,5294,10339,3784
2567,93,พัทลุง,9389,ท้องถิ่นเทศบาลตำบลบ้านนา,3684,3781,7465,3687,3782,7469,3288
2567,93,พัทลุง,9390,ท้องถิ่นเทศบาลตำบลลานข่อย,4227,4459,8686,4233,4459,8692,3081
2567,93,พัทลุง,9391,ท้องถิ่นเทศบาลตำบลท่ามะเดื่อ,1899,2088,3987,1900,2090,3990,1934
2567,93,พัทลุง,9392,ท้องถิ่นเทศบาลตำบลป่าบอน,2013,2087,4100,2015,2087,4102,1828
2567,93,พัทลุง,9393,ท้องถิ่นเทศบาลตำบลปากพะยูน,1443,1609,3052,1447,1610,3057,1546
2567,93,พัทลุง,9394,ท้องถิ่นเทศบาลตำบลมะกอกเหนือ,1007,1150,2157,1009,1153,2162,811
2567,93,พัทลุง,9395,ท้องถิ่นเทศบาลตำบลควนขนุน,886,1070,1956,890,1072,1962,1212
2567,93,พัทลุง,9396,ท้องถิ่นเทศบาลตำบลแม่ขรี,2943,3223,6166,2949,3227,6176,3579
2567,93,พัทลุง,9397,ท้องถิ่นเทศบาลตำบลตะโหมด,2051,2187,4238,2051,2187,4238,1609
2567,93,พัทลุง,9398,ท้องถิ่นเทศบาลตำบลเขาชัยสน,1620,1785,3405,1623,1788,3411,1678
2567,93,พัทลุง,9399,ท้องถิ่นเทศบาลเมืองพัทลุง,13801,16265,30066,13852,16317,30169,16615
2567,94,ปัตตานี,9401,อำเภอเมืองปัตตานี,44537,46736,91273,44632,46805,91437,33717
2567,94,ปัตตานี,9402,อำเภอโคกโพธิ์,30802,32282,63084,30823,32294,63117,18698
2567,94,ปัตตานี,9403,อำเภอหนองจิก,30468,30897,61365,30475,30901,61376,14493
2567,94,ปัตตานี,9404,อำเภอปะนาเระ,18354,19025,37379,18363,19031,37394,10039
2567,94,ปัตตานี,9405,อำเภอมายอ,28813,29380,58193,28830,29394,58224,13685
2567,94,ปัตตานี,9406,อำเภอทุ่งยางแดง,12901,13301,26202,12906,13306,26212,6218
2567,94,ปัตตานี,9407,อำเภอสายบุรี,28551,29783,58334,28555,29784,58339,14331
2567,94,ปัตตานี,9408,อำเภอไม้แก่น,6506,6745,13251,6506,6746,13252,3645
2567,94,ปัตตานี,9409,อำเภอยะหริ่ง,36351,36827,73178,36391,36861,73252,17067
2567,94,ปัตตานี,9410,อำเภอยะรัง,46417,46747,93164,46438,46759,93197,22771
2567,94,ปัตตานี,9411,อำเภอกะพ้อ,9656,9881,19537,9658,9883,19541,4678
2567,94,ปัตตานี,9412,อำเภอแม่ลาน,8904,9082,17986,8910,9088,17998,4803
2567,94,ปัตตานี,9488,ท้องถิ่นเทศบาลตำบลยะรัง,2518,2671,5189,2519,2671,5190,1453
2567,94,ปัตตานี,9489,ท้องถิ่นเทศบาลตำบลยะหริ่ง,3180,3062,6242,3182,3064,6246,2016
2567,94,ปัตตานี,9490,ท้องถิ่นเทศบาลตำบลบางปู,5252,5355,10607,5255,5356,10611,2468
2567,94,ปัตตานี,9491,ท้องถิ่นเทศบาลตำบลตันหยง,1358,1540,2898,1362,1541,2903,759
2567,94,ปัตตานี,9492,ท้องถิ่นเทศบาลตำบลมายอ,2497,2526,5023,2500,2526,5026,1308
2567,94,ปัตตานี,9493,ท้องถิ่นเทศบาลตำบลปะนาเระ,5516,5532,11048,5517,5533,11050,2915
2567,94,ปัตตานี,9494,ท้องถิ่นเทศบาลตำบลหนองจิก,3107,3128,6235,3112,3132,6244,2101
2567,94,ปัตตานี,9495,ท้องถิ่นเทศบาลตำบลบ่อทอง,9395,6614,16009,9400,6618,16018,6152
2567,94,ปัตตานี,9496,ท้องถิ่นเทศบาลตำบลนาประดู่,1466,1601,3067,1469,1603,3072,1469
2567,94,ปัตตานี,9497,ท้องถิ่นเทศบาลตำบลโคกโพธิ์,1592,1824,3416,1593,1825,3418,1933
2567,94,ปัตตานี,9498,ท้องถิ่นเทศบาลเมืองตะลุบัน,7134,7358,14492,7156,7378,14534,4727
2567,94,ปัตตานี,9499,ท้องถิ่นเทศบาลเมืองปัตตานี,20457,21773,42230,20980,22273,43253,16563
2567,95,ยะลา,9501,อำเภอเมืองยะลา,38787,39780,78567,38800,39786,78586,20212
2567,95,ยะลา,9502,อำเภอเบตง,18508,17419,35927,18751,17716,36467,16253
2567,95,ยะลา,9503,อำเภอบันนังสตา,29427,28529,57956,29480,28578,58058,16646
2567,95,ยะลา,9504,อำเภอธารโต,12880,11910,24790,12941,11953,24894,9444
2567,95,ยะลา,9505,อำเภอยะหา,31848,31692,63540,31859,31696,63555,15280
2567,95,ยะลา,9506,อำเภอรามัน,43624,44596,88220,43642,44607,88249,21827
2567,95,ยะลา,9507,อำเภอกาบัง,13401,12789,26190,13416,12801,26217,7475
2567,95,ยะลา,9508,อำเภอกรงปินัง,15749,15469,31218,15754,15469,31223,6703
2567,95,ยะลา,9590,ท้องถิ่นเทศบาลเมืองสะเตงนอก,18289,19773,38062,18302,19783,38085,17414
2567,95,ยะลา,9591,ท้องถิ่นเทศบาลตำบลเขื่อนบางลาง,2451,2209,4660,2451,2209,4660,2076
2567,95,ยะลา,9592,ท้องถิ่นเทศบาลตำบลโกตาบารู,2947,3076,6023,2949,3076,6025,1811
2567,95,ยะลา,9593,ท้องถิ่นเทศบาลตำบลเมืองรามันห์,2532,2593,5125,2537,2594,5131,1960
2567,95,ยะลา,9594,ท้องถิ่นเทศบาลตำบลยะหา,1245,1215,2460,1246,1215,2461,812
2567,95,ยะลา,9595,ท้องถิ่นเทศบาลตำบลคอกช้าง,719,706,1425,719,706,1425,603
2567,95,ยะลา,9596,ท้องถิ่นเทศบาลตำบลบันนังสตา,1266,1274,2540,1268,1275,2543,1060
2567,95,ยะลา,9597,ท้องถิ่นเทศบาลตำบลลำใหม่,514,527,1041,514,527,1041,393
2567,95,ยะลา,9598,ท้องถิ่นเทศบาลเมืองเบตง,12348,13367,25715,12437,13467,25904,11651
2567,95,ยะลา,9599,ท้องถิ่นเทศบาลนครยะลา,27365,30534,57899,27635,30815,58450,29664
2567,96,นราธิวาส,9601,อำเภอเมืองนราธิวาส,44370,44175,88545,44411,44203,88614,28297
2567,96,นราธิวาส,9602,อำเภอตากใบ,27356,28106,55462,27379,28121,55500,12788
2567,96,นราธิวาส,9603,อำเภอบาเจาะ,20795,21487,42282,20807,21493,42300,9876
2567,96,นราธิวาส,9604,อำเภอยี่งอ,22345,22957,45302,22357,22972,45329,11101
2567,96,นราธิวาส,9605,อำเภอระแงะ,39241,40595,79836,39255,40607,79862,18377
2567,96,นราธิวาส,9606,อำเภอรือเสาะ,34274,34304,68578,34281,34309,68590,16441
2567,96,นราธิวาส,9607,อำเภอศรีสาคร,19191,18668,37859,19201,18678,37879,10045
2567,96,นราธิวาส,9608,อำเภอแว้ง,22175,22601,44776,22201,22633,44834,10977
2567,96,นราธิวาส,9609,อำเภอสุคิริน,11780,11343,23123,11786,11357,23143,7666
2567,96,นราธิวาส,9610,อำเภอสุไหงโกลก,19035,20197,39232,19057,20215,39272,11845
2567,96,นราธิวาส,9611,อำเภอสุไหงปาดี,24312,24974,49286,24342,24998,49340,12786
2567,96,นราธิวาส,9612,อำเภอจะแนะ,20522,19979,40501,20540,19989,40529,10159
2567,96,นราธิวาส,9613,อำเภอเจาะไอร้อง,20764,20939,41703,20774,20945,41719,10241
2567,96,นราธิวาส,9686,ท้องถิ่นเทศบาลตำบลปะลุรู,3386,3566,6952,3400,3578,6978,2172
2567,96,นราธิวาส,9687,ท้องถิ่นเทศบาลตำบลสุคิริน,1749,1674,3423,1754,1685,3439,1650
2567,96,นราธิวาส,9688,ท้องถิ่นเทศบาลตำบลแว้ง,2560,2706,5266,2561,2708,5269,1731
2567,96,นราธิวาส,9689,ท้องถิ่นเทศบาลตำบลบูเก๊ะตา,2551,2715,5266,2553,2716,5269,1484
2567,96,นราธิวาส,9690,ท้องถิ่นเทศบาลตำบลศรีสาคร,2622,2557,5179,2635,2565,5200,1924
2567,96,นราธิวาส,9691,ท้องถิ่นเทศบาลตำบลรือเสาะ,3652,3812,7464,3672,3817,7489,3753
2567,96,นราธิวาส,9692,ท้องถิ่นเทศบาลตำบลมะรือโบตก,4398,4280,8678,4399,4280,8679,1842
2567,96,นราธิวาส,9693,ท้องถิ่นเทศบาลตำบลตันหยงมัส,3223,3485,6708,3251,3501,6752,3920
2567,96,นราธิวาส,9694,ท้องถิ่นเทศบาลตำบลยี่งอ,1546,1537,3083,1549,1538,3087,1148
2567,96,นราธิวาส,9695,ท้องถิ่นเทศบาลตำบลบาเจาะ,4852,4857,9709,4857,4863,9720,2380
2567,96,นราธิวาส,9696,ท้องถิ่นเทศบาลตำบลต้นไทร,2471,2696,5167,2472,2696,5168,1501
2567,96,นราธิวาส,9697,ท้องถิ่นเทศบาลเมืองตากใบ,9804,10364,20168,9814,10377,20191,6005
2567,96,นราธิวาส,9698,ท้องถิ่นเทศบาลเมืองสุไหงโกลก,18576,20704,39280,18723,20858,39581,15884
2567,96,นราธิวาส,9699,ท้องถิ่นเทศบาลเมืองนราธิวาส,19454,20545,39999,19601,20662,40263,16671
